合约,日期,前收盘,前结算,开盘价,最高价,最低价,收盘价,结算价,涨跌1,涨跌2,成交量,持仓量
ag1501,20150105,3455,3465,3436,3455,3398,3448,3441,-17,-24,1352,5020
20150106,3448,3441,3430,3490,3412,3485,3455,44,14,3284,4752
20150107,3485,3455,3491,3530,3472,3493,3489,38,34,564,4820
20150108,3493,3489,3489,3510,3484,3487,3496,-2,7,804,4956
20150109,3487,3496,3502,3511,3490,3490,3495,-6,-1,308,4840
20150112,3490,3495,3490,3542,3490,3535,3522,40,27,644,4404
20150113,3535,3522,3522,3624,3520,3568,3571,46,49,712,4484
20150114,3568,3571,3530,3535,3520,3535,3526,-36,-45,160,4364
20150115,3535,3526,3470,3580,3430,3580,3512,54,-14,212,4320
ag1502,20150105,3467,3467,3454,3471,3448,3466,3456,-1,-11,54,886
20150106,3466,3456,3442,3520,3418,3520,3480,64,24,168,864
20150107,3520,3480,3498,3536,3492,3507,3507,27,27,94,876
20150108,3507,3507,3504,3532,3494,3518,3518,11,11,118,854
20150109,3518,3518,3513,3547,3497,3497,3526,-21,8,22,860
20150112,3497,3526,3515,3566,3501,3557,3540,31,14,38,850
20150113,3557,3540,3540,3577,3535,3554,3557,14,17,228,938
20150114,3554,3557,3579,3599,3518,3552,3554,-5,-3,496,918
20150115,3552,3554,3544,3588,3530,3530,3556,-24,2,112,952
20150116,3530,3556,3637,3637,3555,3570,3577,14,21,280,982
20150119,3570,3577,3593,3712,3593,3699,3685,122,108,764,1122
20150120,3699,3685,3718,3735,3712,3715,3721,30,36,118,1084
20150121,3715,3721,3765,3855,3745,3838,3762,117,41,250,1010
20150122,3838,3762,3855,3870,3760,3760,3806,-2,44,246,1140
20150123,3760,3806,3821,3828,3795,3809,3811,3,5,408,1358
20150126,3809,3811,3816,3831,3767,3784,3814,-27,3,294,1376
20150127,3784,3814,3762,3780,3715,3763,3737,-51,-77,158,1454
20150128,3763,3737,3757,3770,3734,3762,3753,25,16,54,1432
20150129,3762,3753,3763,3777,3702,3704,3715,-49,-38,246,1360
20150130,3704,3715,3652,3661,3526,3526,3599,-189,-116,418,1388
20150202,3526,3599,3530,3639,3530,3612,3604,13,5,568,1428
20150203,3612,3604,3617,3617,3617,3617,3617,13,13,40,1428
20150204,3617,3617,3630,3655,3568,3590,3616,-27,-1,68,1384
20150205,3590,3616,3666,3667,3572,3645,3644,29,28,568,1548
20150206,3645,3644,3578,3578,3578,3578,3578,-66,-66,4,1552
20150209,3578,3578,3577,3577,3550,3550,3554,-28,-24,180,1440
20150210,3550,3554,3600,3600,3580,3580,3585,26,31,80,1432
ag1503,20150105,3479,3462,3474,3478,3459,3469,3470,7,8,10,866
20150106,3469,3470,3452,3526,3452,3526,3484,56,14,34,850
20150107,3526,3484,3508,3540,3508,3515,3534,31,50,256,850
20150108,3515,3534,3519,3541,3519,3522,3532,-12,-2,136,824
20150109,3522,3532,3530,3556,3520,3532,3536,0,4,94,866
20150112,3532,3536,3524,3570,3524,3570,3559,34,23,34,866
20150113,3570,3559,3547,3601,3547,3573,3573,14,14,50,860
20150114,3573,3573,3629,3629,3550,3566,3579,-7,6,286,842
20150115,3566,3579,3580,3599,3572,3572,3583,-7,4,6,842
20150116,3572,3583,3608,3608,3583,3596,3600,13,17,30,830
20150119,3596,3600,3617,3720,3599,3695,3674,95,74,14,830
20150120,3695,3674,3730,3736,3730,3731,3732,57,58,6,828
20150121,3731,3732,3766,3872,3758,3861,3813,129,81,86,798
20150122,3861,3813,3805,3805,3790,3793,3794,-20,-19,62,796
20150123,3793,3794,3817,3850,3805,3828,3825,34,31,28,802
20150126,3828,3825,3823,3836,3793,3832,3825,7,0,22,786
20150127,3832,3825,3796,3801,3745,3750,3765,-75,-60,20,778
20150128,3750,3765,3750,3806,3750,3783,3765,18,0,166,750
20150129,3783,3765,3772,3772,3730,3739,3738,-26,-27,28,762
20150130,3739,3738,3675,3675,3551,3565,3583,-173,-155,66,748
20150202,3565,3583,3550,3649,3550,3610,3601,27,18,38,756
20150203,3610,3601,3614,3653,3610,3653,3630,52,29,32,744
20150204,3653,3630,3632,3632,3608,3619,3616,-11,-14,58,744
20150205,3619,3616,3638,3672,3633,3657,3655,41,39,170,742
20150206,3657,3655,3642,3648,3623,3648,3643,-7,-12,68,746
20150209,3648,3643,3578,3593,3553,3559,3576,-84,-67,336,966
20150210,3559,3576,3579,3599,3568,3598,3590,22,14,20,962
20150211,3598,3590,3575,3594,3575,3594,3588,4,-2,64,978
20150212,3594,3588,3577,3580,3532,3532,3566,-56,-22,28,980
20150213,3532,3566,3558,3598,3558,3598,3580,32,14,6,980
20150216,3598,3580,3640,3646,3615,3645,3634,65,54,356,910
20150217,3645,3634,3675,3675,3622,3630,3635,-4,1,146,878
20150225,3630,3635,3553,3553,3535,3535,3545,-100,-90,170,766
20150226,3535,3545,3545,3606,3545,3570,3587,25,42,88,710
20150227,3570,3587,3618,3618,3521,3588,3558,1,-29,76,708
20150302,3588,3558,3578,3599,3578,3590,3591,32,33,740,1204
20150303,3590,3591,3487,3555,3486,3552,3496,-39,-95,340,1204
20150304,3552,3496,3521,3537,3521,3522,3529,26,33,100,1204
20150305,3522,3529,3490,3499,3490,3498,3497,-31,-32,88,1204
20150306,3498,3497,3498,3499,3484,3485,3493,-12,-4,28,1200
20150309,3485,3493,3417,3447,3391,3408,3404,-85,-89,448,1332
20150310,3408,3404,3411,3411,3371,3376,3383,-28,-21,76,1272
20150311,3376,3383,3439,3439,3386,3415,3404,32,21,180,1236
20150312,3415,3404,3355,3400,3355,3400,3359,-4,-45,240,1224
20150313,3400,3359,3400,3440,3400,3440,3426,81,67,12,1224
20150316,3440,3426,3340,3445,3340,3445,3429,19,3,140,1348
ag1504,20150105,3503,3527,3473,3493,3473,3485,3484,-42,-43,8,272
20150106,3485,3484,3488,3488,3488,3488,3488,4,4,2,272
20150107,3488,3488,3518,3550,3518,3550,3539,62,51,22,270
20150108,3550,3539,3544,3547,3511,3547,3540,8,1,44,252
20150109,3547,3540,3540,3540,3540,3540,3540,0,0,4,252
20150112,3540,3540,,,,3573,3573,33,33,0,252
20150113,3573,3573,3573,3604,3558,3604,3591,31,18,32,242
20150114,3604,3591,3572,3575,3563,3575,3571,-16,-20,12,236
20150115,3575,3571,3560,3560,3546,3546,3553,-25,-18,4,234
20150116,3546,3553,3630,3630,3610,3610,3620,57,67,8,230
20150119,3610,3620,3634,3757,3618,3715,3649,95,29,54,230
20150120,3715,3649,3760,3760,3727,3749,3738,100,89,206,290
20150121,3749,3738,3792,3882,3776,3876,3834,138,96,36,274
20150122,3876,3834,,,,3815,3815,-19,-19,0,274
20150123,3815,3815,3808,3862,3808,3831,3835,16,20,78,246
20150126,3831,3835,3806,3855,3792,3813,3813,-22,-22,50,244
20150127,3813,3813,3799,3799,3726,3748,3771,-65,-42,578,184
20150128,3748,3771,3796,3796,3777,3777,3779,6,8,14,184
20150129,3777,3779,3767,3790,3767,3790,3775,11,-4,42,180
20150130,3790,3775,3686,3696,3563,3563,3611,-212,-164,44,150
20150202,3563,3611,3533,3629,3533,3615,3591,4,-20,34,156
20150203,3615,3591,3605,3640,3603,3634,3623,43,32,36,144
20150204,3634,3623,3637,3637,3637,3637,3637,14,14,2,142
20150205,3637,3637,3640,3679,3640,3679,3665,42,28,24,130
20150206,3679,3665,3632,3660,3616,3660,3644,-5,-21,38,124
20150209,3660,3644,3645,3645,3573,3580,3599,-64,-45,62,136
20150210,3580,3599,3598,3604,3598,3604,3598,5,-1,36,132
20150211,3604,3598,3584,3624,3583,3603,3603,5,5,120,154
20150212,3603,3603,3595,3595,3559,3567,3576,-36,-27,226,164
20150213,3567,3576,3586,3620,3583,3612,3615,36,39,44,162
20150216,3612,3615,3649,3666,3635,3642,3650,27,35,96,160
20150217,3642,3650,3648,3651,3619,3638,3646,-12,-4,58,148
20150225,3638,3646,3565,3604,3560,3560,3566,-86,-80,42,146
20150226,3560,3566,3605,3605,3559,3571,3567,5,1,40,142
20150227,3571,3567,3551,3590,3551,3590,3579,23,12,10,142
20150302,3590,3579,3622,3622,3542,3608,3594,29,15,36,132
20150303,3608,3594,3521,3581,3490,3581,3519,-13,-75,60,156
20150304,3581,3519,3568,3568,3516,3545,3553,26,34,52,164
20150305,3545,3553,3521,3521,3485,3508,3507,-45,-46,112,180
20150306,3508,3507,3515,3523,3515,3517,3517,10,10,8,176
20150309,3517,3517,3500,3500,3446,3446,3461,-71,-56,8,178
20150310,3446,3461,3441,3441,3415,3415,3418,-46,-43,34,196
20150311,3415,3418,3424,3430,3407,3428,3419,10,1,26,196
20150312,3428,3419,3398,3440,3365,3408,3415,-11,-4,172,318
20150313,3408,3415,3425,3428,3419,3428,3427,13,12,56,322
20150316,3428,3427,3435,3437,3435,3437,3435,10,8,194,306
20150317,3437,3435,3450,3451,3413,3425,3439,-10,4,60,278
20150318,3425,3439,3437,3439,3395,3395,3404,-44,-35,116,374
20150319,3395,3404,3398,3496,3387,3475,3451,71,47,100,396
20150320,3475,3451,3477,3498,3468,3495,3485,44,34,50,400
20150323,3495,3485,3575,3691,3566,3590,3585,105,100,810,1068
20150324,3590,3585,3650,3650,3585,3642,3618,57,33,254,1126
20150325,3642,3618,3623,3623,3603,3616,3616,-2,-2,22,1136
20150326,3616,3616,3668,3668,3604,3637,3636,21,20,250,1194
20150327,3637,3636,3622,3639,3602,3613,3625,-23,-11,34,1194
20150330,3613,3625,3658,3685,3569,3574,3616,-51,-9,156,1150
20150331,3574,3616,3525,3555,3472,3519,3509,-97,-107,262,1132
20150401,3519,3509,3511,3544,3498,3525,3529,16,20,148,1240
20150402,3525,3529,3570,3585,3570,3585,3579,56,50,168,1336
20150403,3585,3579,,,,3575,3575,-4,-4,0,1336
20150407,3575,3575,3669,3669,3567,3573,3589,-2,14,28,1324
20150408,3573,3589,3575,3577,3568,3568,3573,-21,-16,84,1304
20150409,3568,3573,3575,3575,3468,3475,3521,-98,-52,348,1328
20150410,3475,3521,3462,3462,3462,3462,3462,-59,-59,4,1328
20150413,3462,3462,3485,3500,3466,3466,3483,4,21,20,1328
20150414,3466,3483,3519,3519,3425,3425,3456,-58,-27,60,1380
20150415,3425,3456,3500,3500,3452,3500,3465,44,9,56,1424
ag1505,20150105,3508,3507,3483,3507,3474,3498,3492,-9,-15,1632,2086
20150106,3498,3492,3472,3550,3458,3544,3504,52,12,5090,2014
20150107,3544,3504,3539,3580,3520,3545,3545,41,41,3126,1898
20150108,3545,3545,3355,3649,3355,3538,3546,-7,1,3506,1936
20150109,3538,3546,3555,3576,3539,3549,3555,3,9,1862,1724
20150112,3549,3555,3551,3598,3516,3588,3565,33,10,4010,1634
20150113,3588,3565,3566,3631,3564,3608,3598,43,33,2716,1640
20150114,3608,3598,3630,3653,3564,3601,3624,3,26,4396,1674
20150115,3601,3624,3588,3631,3552,3562,3596,-62,-28,4808,1612
20150116,3562,3596,3605,3648,3605,3632,3627,36,31,3048,1608
20150119,3632,3627,3590,3769,3590,3754,3713,127,86,7744,1674
20150120,3754,3713,3753,3785,3740,3762,3760,49,47,3828,1732
20150121,3762,3760,3810,3907,3781,3879,3828,119,68,4504,1424
20150122,3879,3828,3841,3924,3793,3810,3861,-18,33,5448,1456
20150123,3810,3861,3816,3878,3816,3848,3852,-13,-9,5136,1458
20150126,3848,3852,3859,3877,3808,3839,3844,-13,-8,2316,1456
20150127,3839,3844,3819,3830,3757,3806,3797,-38,-47,2570,1440
20150128,3806,3797,3807,3829,3787,3803,3806,6,9,1804,1474
20150129,3803,3806,3809,3813,3746,3760,3780,-46,-26,1964,1392
20150130,3760,3780,3715,3715,3561,3566,3623,-214,-157,5198,1592
20150202,3566,3623,3585,3663,3547,3627,3598,4,-25,2728,1542
20150203,3627,3598,3606,3670,3600,3663,3646,65,48,6134,1328
20150204,3663,3646,3657,3668,3609,3641,3640,-5,-6,3622,1344
20150205,3641,3640,3654,3704,3645,3669,3672,29,32,2408,1316
20150206,3669,3672,3638,3668,3623,3664,3648,-8,-24,1920,1340
20150209,3664,3648,3667,3680,3572,3590,3612,-58,-36,7504,1722
20150210,3590,3612,3604,3624,3591,3615,3606,3,-6,2414,1516
20150211,3615,3606,3599,3630,3588,3613,3609,7,3,1200,1556
20150212,3613,3609,3606,3613,3557,3579,3587,-30,-22,944,1574
20150213,3579,3587,3591,3636,3577,3622,3604,35,17,1746,1742
20150216,3622,3604,3611,3684,3611,3675,3663,71,59,2660,1652
20150217,3675,3663,3667,3681,3645,3654,3659,-9,-4,712,1672
20150225,3654,3659,3562,3586,3557,3580,3575,-79,-84,652,1298
20150226,3580,3575,3580,3599,3570,3593,3582,18,7,660,1248
20150227,3593,3582,3606,3615,3582,3596,3595,14,13,742,1190
20150302,3596,3595,3586,3630,3575,3618,3609,23,14,848,1124
20150303,3618,3609,3606,3619,3480,3578,3565,-31,-44,1060,1080
20150304,3578,3565,3586,3594,3543,3549,3563,-16,-2,1204,1056
20150305,3549,3563,3522,3554,3510,3527,3532,-36,-31,746,1158
20150306,3527,3532,3542,3546,3506,3521,3525,-11,-7,398,1028
20150309,3521,3525,3520,3520,3427,3460,3464,-65,-61,1568,956
20150310,3460,3464,3455,3455,3414,3414,3441,-50,-23,740,896
20150311,3414,3441,3431,3444,3427,3441,3436,0,-5,326,818
20150312,3441,3436,3410,3449,3373,3444,3402,8,-34,652,768
20150313,3444,3402,3448,3455,3418,3432,3438,30,36,350,712
20150316,3432,3438,3436,3462,3415,3458,3436,20,-2,370,680
20150317,3458,3436,3454,3460,3423,3435,3444,-1,8,372,734
20150318,3435,3444,3413,3450,3392,3412,3428,-32,-16,796,706
20150319,3412,3428,3420,3525,3405,3494,3470,66,42,660,658
20150320,3494,3470,3489,3519,3484,3500,3504,30,34,184,654
20150323,3500,3504,3516,3640,3516,3614,3591,110,87,2362,806
20150324,3614,3591,3646,3685,3638,3656,3661,65,70,554,756
20150325,3656,3661,3666,3677,3622,3638,3643,-23,-18,632,822
20150326,3638,3643,3679,3690,3643,3670,3667,27,24,636,1014
20150327,3670,3667,3669,3669,3629,3645,3644,-22,-23,290,1028
20150330,3645,3644,3655,3655,3598,3606,3609,-38,-35,1040,948
20150331,3606,3609,3585,3592,3537,3537,3563,-72,-46,202,930
20150401,3537,3563,3563,3571,3532,3546,3552,-17,-11,102,918
20150402,3546,3552,3581,3601,3557,3598,3583,46,31,200,936
20150403,3598,3583,3579,3579,3550,3575,3563,-8,-20,80,930
20150407,3575,3563,3595,3606,3592,3595,3594,32,31,116,908
20150408,3595,3594,3682,3682,3579,3595,3594,1,0,686,916
20150409,3595,3594,3586,3588,3477,3489,3504,-105,-90,266,934
20150410,3489,3504,3689,3689,3410,3482,3482,-22,-22,216,872
20150413,3482,3482,3530,3544,3503,3514,3517,32,35,378,900
20150414,3514,3517,3518,3518,3457,3471,3484,-46,-33,82,910
20150415,3471,3484,3467,3511,3467,3482,3494,-2,10,238,968
20150416,3482,3494,3482,3542,3482,3527,3522,33,28,220,1014
20150417,3527,3522,3534,3546,3491,3507,3506,-15,-16,244,1072
20150420,3507,3506,3509,3528,3504,3528,3513,22,7,312,1190
20150421,3528,3513,3528,3528,3450,3468,3470,-45,-43,484,1086
20150422,3468,3470,3470,3500,3468,3480,3476,10,6,444,1020
20150423,3480,3476,3479,3484,3432,3443,3450,-33,-26,746,922
20150424,3443,3450,3450,3469,3444,3458,3451,8,1,292,890
20150427,3458,3451,3436,3471,3421,3457,3436,6,-15,334,870
20150428,3457,3436,3457,3579,3457,3574,3539,138,103,1430,1464
20150429,3574,3539,3597,3626,3510,3570,3591,31,52,648,1634
20150430,3570,3591,3597,3796,3500,3578,3601,-13,10,756,1612
20150504,3578,3601,3502,3550,3502,3533,3528,-68,-73,88,1644
20150505,3533,3528,3570,3615,3544,3563,3576,35,48,396,1828
20150506,3563,3576,3570,3582,3561,3568,3575,-8,-1,352,2108
20150507,3568,3575,3574,3587,3531,3550,3543,-25,-32,148,2136
20150508,3550,3543,3543,3549,3533,3549,3540,6,-3,268,2156
20150511,3549,3540,3565,3575,3541,3556,3558,16,18,72,2172
20150512,3556,3558,3566,3570,3485,3528,3518,-30,-40,380,2104
20150513,3528,3518,3550,3555,3550,3555,3552,37,34,88,2100
20150514,3555,3552,,,,3562,3562,10,10,0,2100
20150515,3562,3562,3760,3760,3535,3700,3682,138,120,68,2136
ag1506,20150105,3522,3524,3498,3516,3478,3507,3500,-17,-24,513798,410420
20150106,3507,3500,3490,3566,3462,3554,3517,54,17,2199972,450158
20150107,3554,3517,3544,3596,3530,3554,3556,37,39,1865876,401974
20150108,3554,3556,3540,3578,3537,3548,3558,-8,2,1434122,412464
20150109,3548,3558,3568,3586,3544,3555,3562,-3,4,1415890,400170
20150112,3555,3562,3545,3609,3520,3601,3577,39,15,2522336,407230
20150113,3601,3577,3577,3645,3571,3616,3608,39,31,1816952,396296
20150114,3616,3608,3635,3664,3570,3608,3627,0,19,2630104,381950
20150115,3608,3627,3592,3642,3556,3573,3604,-54,-23,2546564,405240
20150116,3573,3604,3635,3660,3613,3642,3635,38,31,2161856,387826
20150119,3642,3635,3638,3783,3633,3767,3725,132,90,3544420,472114
20150120,3767,3725,3770,3800,3745,3770,3770,45,45,1461346,479754
20150121,3770,3770,3822,3919,3787,3890,3836,120,66,2675070,506162
20150122,3890,3836,3887,3934,3798,3819,3865,-17,29,3079184,517020
20150123,3819,3865,3843,3886,3822,3859,3859,-6,-6,2627510,502324
20150126,3859,3859,3865,3888,3814,3849,3849,-10,-10,1834432,515488
20150127,3849,3849,3836,3841,3763,3815,3803,-34,-46,1982320,522960
20150128,3815,3803,3815,3837,3793,3806,3812,3,9,1463626,513360
20150129,3806,3812,3817,3820,3750,3766,3792,-46,-20,1446720,511160
20150130,3766,3792,3713,3721,3564,3573,3633,-219,-159,2849430,491344
20150202,3573,3633,3593,3671,3551,3632,3618,-1,-15,2755340,459730
20150203,3632,3618,3620,3681,3603,3669,3638,51,20,1905866,441120
20150204,3669,3638,3668,3675,3612,3645,3645,7,7,2230030,456476
20150205,3645,3645,3654,3710,3649,3675,3680,30,35,2235044,430468
20150206,3675,3680,3655,3677,3628,3673,3652,-7,-28,1745320,415498
20150209,3673,3652,3675,3687,3566,3595,3606,-57,-46,2979798,438030
20150210,3595,3606,3606,3630,3593,3618,3613,12,7,1248764,419950
20150211,3618,3613,3607,3638,3590,3618,3613,5,0,1462208,388998
20150212,3618,3613,3615,3621,3557,3585,3593,-28,-20,1601470,388184
20150213,3585,3593,3599,3650,3582,3631,3606,38,13,1544114,361214
20150216,3631,3606,3623,3700,3620,3686,3674,80,68,1663548,326706
20150217,3686,3674,3676,3695,3655,3672,3676,-2,2,590260,311484
20150225,3672,3676,3563,3603,3562,3590,3585,-86,-91,392598,309022
20150226,3590,3585,3588,3612,3578,3601,3592,16,7,795474,339218
20150227,3601,3592,3617,3628,3590,3606,3608,14,16,956158,373818
20150302,3606,3608,3592,3647,3580,3631,3616,23,8,1381658,383840
20150303,3631,3616,3624,3633,3488,3586,3577,-30,-39,2033996,386932
20150304,3586,3577,3591,3608,3548,3558,3573,-19,-4,1798608,416432
20150305,3558,3573,3560,3569,3516,3539,3543,-34,-30,1485834,418416
20150306,3539,3543,3535,3560,3513,3532,3539,-11,-4,1089368,413392
20150309,3532,3539,3524,3531,3434,3470,3472,-69,-67,2174538,473530
20150310,3470,3472,3462,3468,3422,3424,3449,-48,-23,1283922,493624
20150311,3424,3449,3443,3461,3433,3450,3446,1,-3,1099402,498282
20150312,3450,3446,3433,3460,3375,3453,3407,7,-39,2324538,563910
20150313,3453,3407,3439,3470,3425,3442,3444,35,37,1316696,563064
20150316,3442,3444,3448,3479,3417,3469,3442,25,-2,1360990,580236
20150317,3469,3442,3455,3472,3428,3443,3451,1,9,1220700,586844
20150318,3443,3451,3428,3458,3398,3420,3431,-31,-20,1741986,593452
20150319,3420,3431,3418,3537,3410,3502,3467,71,36,1783026,573254
20150320,3502,3467,3492,3535,3491,3516,3514,49,47,1391082,556166
20150323,3516,3514,3525,3655,3523,3634,3610,120,96,2610940,567348
20150324,3634,3610,3649,3699,3646,3670,3673,60,63,1815344,542542
20150325,3670,3673,3681,3692,3633,3652,3661,-21,-12,1427656,521234
20150326,3652,3661,3690,3710,3651,3692,3676,31,15,1511626,526078
20150327,3692,3676,3680,3686,3646,3667,3671,-9,-5,1225598,480856
20150330,3667,3671,3669,3676,3612,3615,3637,-56,-34,1551364,494348
20150331,3615,3637,3605,3615,3548,3556,3588,-81,-49,1392912,487696
20150401,3556,3588,3580,3596,3543,3565,3573,-23,-15,1166888,483224
20150402,3565,3573,3580,3630,3575,3619,3604,46,31,1493140,448852
20150403,3619,3604,3592,3607,3563,3595,3584,-9,-20,1151628,412946
20150407,3595,3584,3596,3630,3591,3613,3618,29,34,336968,416596
20150408,3613,3618,3611,3624,3598,3616,3613,-2,-5,677522,419448
20150409,3616,3613,3606,3616,3489,3504,3558,-109,-55,1520726,463038
20150410,3504,3558,3496,3515,3470,3498,3488,-60,-70,1064078,462546
20150413,3498,3488,3526,3565,3516,3537,3539,49,51,1199680,464074
20150414,3537,3539,3533,3542,3478,3501,3514,-38,-25,1048738,476672
20150415,3501,3514,3485,3536,3483,3510,3515,-4,1,1106310,465072
20150416,3510,3515,3508,3562,3503,3551,3531,36,16,998014,448234
20150417,3551,3531,3560,3570,3510,3523,3531,-8,0,1217854,476076
20150420,3523,3531,3520,3555,3517,3553,3530,22,-1,814654,460514
20150421,3553,3530,3506,3513,3460,3486,3484,-44,-46,1204686,488146
20150422,3486,3484,3493,3518,3481,3506,3497,22,13,876500,482784
20150423,3506,3497,3497,3498,3443,3452,3463,-45,-34,1418428,489886
20150424,3452,3463,3458,3488,3451,3475,3469,12,6,1024546,450406
20150427,3475,3469,3465,3484,3427,3472,3456,3,-13,1321720,428316
20150428,3472,3456,3482,3609,3480,3598,3566,142,110,2171488,444146
20150429,3598,3566,3626,3654,3583,3599,3621,33,55,1607256,381880
20150430,3599,3621,3617,3648,3591,3599,3619,-22,-2,1471756,346510
20150504,3599,3619,3540,3577,3515,3564,3548,-55,-71,455382,324062
20150505,3564,3548,3580,3655,3566,3580,3602,32,54,928228,321812
20150506,3580,3602,3617,3626,3590,3597,3606,-5,4,872114,286582
20150507,3597,3606,3609,3618,3558,3571,3591,-35,-15,794696,273648
20150508,3571,3591,3551,3585,3538,3574,3564,-17,-27,570650,262926
20150511,3574,3564,3580,3605,3563,3577,3581,13,17,701450,260218
20150512,3577,3581,3588,3598,3522,3551,3562,-30,-19,660034,243192
20150513,3551,3562,3580,3605,3560,3604,3578,42,16,556904,223952
20150514,3604,3578,3688,3697,3651,3680,3668,102,90,611166,172912
20150515,3680,3668,3691,3718,3680,3704,3699,36,31,421254,150436
20150518,3704,3699,3705,3776,3689,3761,3723,62,24,296178,139688
20150519,3761,3723,3758,3770,3701,3711,3736,-12,13,234906,119514
20150520,3711,3736,3686,3689,3547,3624,3614,-112,-122,445668,93296
20150521,3624,3614,3630,3662,3623,3646,3644,32,30,146524,87846
20150522,3646,3644,3622,3658,3614,3649,3641,5,-3,102198,86422
20150525,3649,3641,3631,3643,3600,3625,3623,-16,-18,104802,76928
20150526,3625,3623,3612,3653,3583,3585,3623,-38,0,84560,68746
20150527,3585,3623,3565,3603,3558,3589,3585,-34,-38,81768,62028
20150528,3589,3585,3577,3594,3565,3582,3581,-3,-4,49160,56042
20150529,3582,3581,3613,3613,3553,3569,3571,-12,-10,61990,35638
20150601,3569,3571,3590,3591,3546,3563,3567,-8,-4,14054,31536
20150602,3563,3567,3565,3631,3560,3576,3590,9,23,16256,25832
20150603,3576,3590,3579,3600,3560,3586,3587,-4,-3,4492,24360
20150604,3586,3587,3557,3582,3530,3540,3548,-47,-39,7908,19684
20150605,3540,3548,3540,3540,3483,3484,3500,-64,-48,6044,17844
20150608,3484,3500,3499,3499,3430,3488,3480,-12,-20,5036,15956
20150609,3488,3480,3489,3489,3465,3489,3480,9,0,3668,14208
20150610,3489,3480,3482,3489,3472,3480,3478,0,-2,5596,13324
20150611,3480,3478,3492,3495,3476,3480,3483,2,5,220,13280
20150612,3480,3483,3472,3496,3450,3476,3479,-7,-4,544,12900
20150615,3476,3479,3476,3478,3450,3469,3464,-10,-15,2232,13408
ag1507,20150105,3501,3528,3510,3518,3495,3518,3505,-10,-23,48,956
20150106,3518,3505,3499,3569,3499,3567,3531,62,26,114,898
20150107,3567,3531,3556,3595,3547,3561,3559,30,28,152,854
20150108,3561,3559,3552,3578,3524,3564,3560,5,1,22,854
20150109,3564,3560,3572,3576,3559,3566,3561,6,1,214,666
20150112,3566,3561,3555,3612,3554,3612,3594,51,33,32,662
20150113,3612,3594,3604,3633,3603,3633,3627,39,33,24,664
20150114,3633,3627,3658,3670,3592,3601,3636,-26,9,36,656
20150115,3601,3636,3598,3638,3594,3594,3606,-42,-30,18,654
20150116,3594,3606,3662,3662,3637,3639,3653,33,47,28,652
20150119,3639,3653,3657,3779,3657,3779,3743,126,90,140,618
20150120,3779,3743,3772,3799,3733,3772,3773,29,30,174,654
20150121,3772,3773,3824,3916,3737,3895,3838,122,65,180,620
20150122,3895,3838,3920,3921,3845,3851,3855,13,17,118,630
20150123,3851,3855,3849,3884,3849,3858,3865,3,10,34,616
20150126,3858,3865,3876,3876,3843,3843,3861,-22,-4,56,632
20150127,3843,3861,3809,3809,3771,3807,3778,-54,-83,86,656
20150128,3807,3778,3826,3838,3811,3811,3828,33,50,36,652
20150129,3811,3828,3828,3828,3762,3767,3784,-61,-44,66,644
20150130,3767,3784,3717,3717,3591,3602,3615,-182,-169,146,624
20150202,3602,3615,3587,3666,3563,3635,3632,20,17,112,650
20150203,3635,3632,3620,3677,3620,3673,3655,41,23,50,636
20150204,3673,3655,3554,3675,3554,3662,3663,7,8,132,648
20150205,3662,3663,3673,3708,3665,3685,3695,22,32,252,714
20150206,3685,3695,3650,3677,3639,3672,3653,-23,-42,108,708
20150209,3672,3653,3664,3664,3584,3595,3609,-58,-44,42,682
20150210,3595,3609,3627,3627,3616,3620,3620,11,11,16,682
20150211,3620,3620,3614,3640,3600,3629,3633,9,13,138,758
20150212,3629,3633,3619,3619,3571,3577,3598,-56,-35,50,754
20150213,3577,3598,3605,3633,3591,3633,3618,35,20,36,744
20150216,3633,3618,3637,3695,3637,3690,3676,72,58,18,740
20150217,3690,3676,3694,3694,3666,3677,3680,1,4,44,736
20150225,3677,3680,3587,3608,3584,3590,3593,-90,-87,20,732
20150226,3590,3593,3604,3604,3600,3600,3600,7,7,42,734
20150227,3600,3600,3617,3617,3612,3612,3614,12,14,12,736
20150302,3612,3614,3604,3652,3604,3646,3643,32,29,152,830
20150303,3646,3643,3627,3628,3512,3609,3580,-34,-63,376,792
20150304,3609,3580,3600,3600,3576,3576,3588,-4,8,76,776
20150305,3576,3588,3559,3564,3547,3547,3551,-41,-37,32,770
20150306,3547,3551,3554,3560,3535,3535,3544,-16,-7,22,766
20150309,3535,3544,3499,3505,3458,3481,3490,-63,-54,104,792
20150310,3481,3490,3470,3473,3436,3436,3461,-54,-29,16,794
20150311,3436,3461,3463,3463,3454,3454,3457,-7,-4,72,836
20150312,3454,3457,3396,3458,3396,3458,3412,1,-45,204,684
20150313,3458,3412,3448,3459,3448,3459,3454,47,42,8,690
20150316,3459,3454,3440,3506,3432,3485,3476,31,22,268,750
20150317,3485,3476,3469,3478,3446,3446,3455,-30,-21,516,750
20150318,3446,3455,3411,3458,3411,3436,3438,-19,-17,46,760
20150319,3436,3438,3449,3525,3439,3520,3484,82,46,118,724
20150320,3520,3484,3520,3535,3517,3524,3527,40,43,50,718
20150323,3524,3527,3560,3660,3560,3635,3625,108,98,246,650
20150324,3635,3625,3689,3698,3659,3674,3679,49,54,170,592
20150325,3674,3679,3675,3677,3654,3660,3665,-19,-14,30,582
20150326,3660,3665,3701,3705,3667,3695,3691,30,26,80,582
20150327,3695,3691,3681,3681,3673,3677,3678,-14,-13,10,582
20150330,3677,3678,3660,3663,3587,3635,3634,-43,-44,110,578
20150331,3635,3634,3588,3620,3564,3564,3600,-70,-34,116,582
20150401,3564,3600,3596,3596,3570,3575,3575,-25,-25,94,576
20150402,3575,3575,3597,3625,3594,3625,3613,50,38,42,584
20150403,3625,3613,3604,3611,3580,3594,3599,-19,-14,102,598
20150407,3594,3599,3625,3634,3625,3630,3628,31,29,20,596
20150408,3630,3628,3597,3633,3597,3627,3621,-1,-7,58,604
20150409,3627,3621,3578,3581,3510,3517,3540,-104,-81,100,640
20150410,3517,3540,3488,3518,3488,3518,3513,-22,-27,12,648
20150413,3518,3513,3543,3570,3542,3547,3553,34,40,60,660
20150414,3547,3553,3517,3518,3505,3516,3513,-37,-40,64,640
20150415,3516,3513,3519,3551,3514,3522,3527,9,14,176,566
20150416,3522,3527,3524,3570,3524,3558,3549,31,22,88,536
20150417,3558,3549,3580,3580,3525,3535,3545,-14,-4,100,540
20150420,3535,3545,3541,3555,3528,3555,3542,10,-3,44,536
20150421,3555,3542,3517,3517,3479,3496,3493,-46,-49,140,538
20150422,3496,3493,3503,3519,3499,3516,3506,23,13,126,538
20150423,3516,3506,3500,3500,3451,3468,3468,-38,-38,48,542
20150424,3468,3468,3470,3484,3470,3480,3477,12,9,24,544
20150427,3480,3477,3480,3496,3448,3476,3475,-1,-2,266,704
20150428,3476,3475,3494,3619,3494,3594,3570,119,95,1420,890
20150429,3594,3570,3615,3672,3595,3595,3643,25,73,1672,1084
20150430,3595,3643,3614,3647,3600,3602,3621,-41,-22,256,1040
20150504,3602,3621,3523,3577,3523,3566,3551,-55,-70,236,1058
20150505,3566,3551,3616,3650,3580,3582,3624,31,73,628,1142
20150506,3582,3624,3611,3630,3595,3595,3608,-29,-16,412,1104
20150507,3595,3608,3608,3618,3571,3573,3594,-35,-14,226,1112
20150508,3573,3594,3533,3581,3533,3576,3566,-18,-28,176,1088
20150511,3576,3566,3590,3604,3571,3577,3586,11,20,162,1092
20150512,3577,3586,3582,3598,3540,3562,3574,-24,-12,122,1084
20150513,3562,3574,3581,3616,3565,3615,3586,41,12,456,1070
20150514,3615,3586,3689,3721,3653,3693,3679,107,93,1158,1044
20150515,3693,3679,3700,3733,3697,3718,3711,39,32,410,1006
20150518,3718,3711,3706,3787,3706,3776,3761,65,50,910,984
20150519,3776,3761,3762,3785,3713,3731,3751,-30,-10,212,966
20150520,3731,3751,3683,3693,3588,3629,3624,-122,-127,1380,1292
20150521,3629,3624,3645,3673,3641,3658,3661,34,37,722,938
20150522,3658,3661,3644,3677,3634,3665,3656,4,-5,412,832
20150525,3665,3656,3624,3662,3615,3647,3638,-9,-18,360,824
20150526,3647,3638,3647,3667,3600,3600,3636,-38,-2,196,858
20150527,3600,3636,3551,3615,3551,3603,3596,-33,-40,170,814
20150528,3603,3596,3599,3609,3587,3595,3597,-1,1,124,816
20150529,3595,3597,3609,3629,3566,3589,3591,-8,-6,408,860
20150601,3589,3591,3592,3606,3575,3577,3585,-14,-6,266,854
20150602,3577,3585,3587,3651,3587,3601,3618,16,33,1472,1166
20150603,3601,3618,3600,3626,3592,3598,3609,-20,-9,216,1212
20150604,3598,3609,3582,3597,3550,3555,3574,-54,-35,430,1336
20150605,3555,3574,3543,3545,3501,3509,3520,-65,-54,370,1268
20150608,3509,3520,3482,3517,3482,3503,3500,-17,-20,228,1268
20150609,3503,3500,3531,3531,3492,3504,3503,4,3,638,1536
20150610,3504,3503,3515,3520,3493,3509,3503,6,0,488,1736
20150611,3509,3503,3520,3526,3500,3500,3513,-3,10,168,1744
20150612,3500,3513,3491,3508,3474,3493,3497,-20,-16,380,1724
20150615,3493,3497,3487,3510,3450,3483,3492,-14,-5,484,1958
20150616,3483,3492,3493,3521,3486,3506,3504,14,12,192,1892
20150617,3506,3504,3485,3496,3470,3483,3484,-21,-20,208,1948
20150618,3483,3484,3494,3528,3476,3512,3507,28,23,434,1844
20150619,3512,3507,3552,3552,3477,3511,3520,4,13,346,1750
20150623,3511,3520,3529,3529,3473,3485,3484,-35,-36,320,1778
20150624,3485,3484,3476,3489,3430,3439,3438,-45,-46,1484,1718
20150625,3439,3438,3422,3447,3422,3435,3436,-3,-2,300,1594
20150626,3435,3436,3421,3470,3406,3406,3429,-30,-7,398,1612
20150629,3406,3429,3421,3468,3394,3436,3417,7,-12,810,1620
20150630,3436,3417,3484,3484,3360,3400,3386,-17,-31,982,1660
20150701,3400,3386,3361,3413,3360,3390,3388,4,2,60,1636
20150702,3390,3388,3381,3386,3364,3364,3377,-24,-11,92,1644
20150703,3364,3377,3425,3425,3379,3397,3398,20,21,488,1632
20150706,3397,3398,3350,3438,3350,3380,3397,-18,-1,264,1560
20150707,3380,3397,3384,3411,3367,3381,3393,-16,-4,752,1580
20150708,3381,3393,3596,3596,3189,3189,3254,-204,-139,1416,1744
20150709,3189,3254,3124,3448,3124,3310,3319,56,65,380,1564
20150710,3310,3319,3412,3412,3303,3325,3348,6,29,384,1468
20150713,3325,3348,3310,3347,3310,3347,3343,-1,-5,928,2228
20150714,3347,3343,3290,3320,3290,3300,3301,-43,-42,52,2224
20150715,3300,3301,3330,3330,3310,3310,3320,9,19,40,2224
ag1508,20150105,3508,3532,3509,3518,3507,3518,3511,-14,-21,6,262
20150106,3518,3511,3500,3536,3500,3536,3522,25,11,46,258
20150107,3536,3522,3549,3592,3546,3564,3577,42,55,58,258
20150108,3564,3577,3564,3571,3564,3565,3565,-12,-12,24,260
20150109,3565,3565,3582,3583,3561,3561,3575,-4,10,6,258
20150112,3561,3575,3559,3612,3559,3612,3595,37,20,52,248
20150113,3612,3595,3597,3639,3597,3618,3626,23,31,180,238
20150114,3618,3626,3652,3666,3590,3605,3627,-21,1,98,242
20150115,3605,3627,3602,3624,3602,3624,3609,-3,-18,14,244
20150116,3624,3609,3645,3650,3645,3650,3647,41,38,4,242
20150119,3650,3647,3662,3745,3662,3744,3721,97,74,28,244
20150120,3744,3721,3769,3775,3768,3775,3770,54,49,22,242
20150121,3775,3770,3840,3924,3840,3918,3864,148,94,26,242
20150122,3918,3864,3925,3926,3850,3850,3878,-14,14,30,248
20150123,3850,3878,3862,3904,3700,3859,3850,-19,-28,5396,246
20150126,3859,3850,3873,3888,3822,3849,3858,-1,8,188,252
20150127,3849,3858,3820,3840,3774,3804,3806,-54,-52,76,246
20150128,3804,3806,3823,3839,3815,3815,3833,9,27,18,240
20150129,3815,3833,3808,3808,3771,3771,3777,-62,-56,38,242
20150130,3771,3777,3714,3714,3594,3607,3634,-170,-143,34,244
20150202,3607,3634,3624,3675,3584,3631,3637,-3,3,60,252
20150203,3631,3637,3630,3662,3630,3662,3651,25,14,16,252
20150204,3662,3651,3666,3669,3644,3669,3659,18,8,6,254
20150205,3669,3659,3675,3683,3675,3680,3678,21,19,8,254
20150206,3680,3678,3680,3685,3646,3685,3674,7,-4,18,256
20150209,3685,3674,3675,3675,3595,3613,3617,-61,-57,66,258
20150210,3613,3617,3615,3633,3615,3625,3626,8,9,26,242
20150211,3625,3626,3628,3632,3628,3632,3630,6,4,4,242
20150212,3632,3630,,,,3630,3630,0,0,0,242
20150213,3630,3630,3600,3614,3600,3614,3609,-16,-21,6,240
20150216,3614,3609,3694,3694,3676,3692,3689,83,80,22,232
20150217,3692,3689,3676,3684,3627,3675,3675,-14,-14,28,238
20150225,3675,3675,3596,3606,3555,3600,3591,-75,-84,650,432
20150226,3600,3591,3605,3605,3605,3605,3605,14,14,6,438
20150227,3605,3605,3621,3621,3621,3621,3621,16,16,2,440
20150302,3621,3621,3618,3650,3618,3649,3630,28,9,32,438
20150303,3649,3630,3608,3617,3532,3614,3580,-16,-50,44,450
20150304,3614,3580,3603,3603,3591,3591,3598,11,18,6,450
20150305,3591,3598,3563,3563,3545,3552,3557,-46,-41,10,444
20150306,3552,3557,3558,3560,3540,3553,3551,-4,-6,24,446
20150309,3553,3551,3535,3535,3475,3481,3483,-70,-68,110,446
20150310,3481,3483,,,,3450,3450,-33,-33,0,446
20150311,3450,3450,3474,3474,3462,3466,3465,16,15,44,446
20150312,3466,3465,3484,3498,3412,3483,3426,18,-39,102,454
20150313,3483,3426,3466,3477,3465,3475,3471,49,45,46,460
20150316,3475,3471,3446,3491,3446,3491,3468,20,-3,12,456
20150317,3491,3468,3478,3479,3452,3452,3469,-16,1,12,452
20150318,3452,3469,3439,3439,3437,3437,3438,-32,-31,4,452
20150319,3437,3438,3444,3543,3444,3524,3515,86,77,42,450
20150320,3524,3515,3517,3544,3517,3534,3537,19,22,18,444
20150323,3534,3537,3565,3660,3563,3641,3616,104,79,110,464
20150324,3641,3616,3688,3692,3679,3681,3681,65,65,86,394
20150325,3681,3681,3697,3697,3664,3688,3679,7,-2,14,392
20150326,3688,3679,3675,3706,3675,3698,3695,19,16,8,390
20150327,3698,3695,3699,3699,3680,3684,3689,-11,-6,16,394
20150330,3684,3689,3658,3665,3648,3648,3658,-41,-31,42,390
20150331,3648,3658,3611,3611,3603,3603,3607,-55,-51,4,390
20150401,3603,3607,3595,3595,3570,3586,3581,-21,-26,12,392
20150402,3586,3581,3629,3651,3620,3646,3638,65,57,26,392
20150403,3646,3638,3606,3606,3564,3605,3594,-33,-44,64,396
20150407,3605,3594,,,,3594,3594,0,0,0,396
20150408,3594,3594,3640,3640,3623,3640,3638,46,44,52,384
20150409,3640,3638,3633,3633,3554,3555,3572,-83,-66,18,388
20150410,3555,3572,3510,3533,3508,3518,3513,-54,-59,16,394
20150413,3518,3513,3558,3563,3558,3563,3560,50,47,4,390
20150414,3563,3560,3550,3570,3548,3548,3554,-12,-6,10,390
20150415,3548,3554,3550,3550,3532,3537,3543,-17,-11,14,390
20150416,3537,3543,3538,3586,3536,3571,3560,28,17,18,386
20150417,3571,3560,3541,3542,3514,3536,3535,-24,-25,16,382
20150420,3536,3535,3548,3556,3537,3550,3544,15,9,16,382
20150421,3550,3544,3528,3528,3473,3503,3502,-41,-42,32,386
20150422,3503,3502,3507,3520,3507,3520,3513,18,11,4,382
20150423,3520,3513,3500,3500,3472,3477,3479,-36,-34,18,392
20150424,3477,3479,3474,3498,3474,3487,3486,8,7,68,392
20150427,3487,3486,3476,3502,3456,3491,3484,5,-2,88,378
20150428,3491,3484,3538,3624,3538,3605,3610,121,126,196,372
20150429,3605,3610,3630,3694,3623,3628,3632,18,22,78,370
20150430,3628,3632,3629,3658,3612,3612,3635,-20,3,72,398
20150504,3612,3635,3551,3585,3548,3577,3559,-58,-76,82,414
20150505,3577,3559,3637,3638,3594,3594,3605,35,46,74,404
20150506,3594,3605,3635,3635,3606,3610,3616,5,11,58,424
20150507,3610,3616,3629,3629,3580,3583,3600,-33,-16,38,418
20150508,3583,3600,3576,3592,3568,3582,3578,-18,-22,36,402
20150511,3582,3578,3582,3602,3582,3596,3593,18,15,14,406
20150512,3596,3593,3612,3612,3567,3571,3571,-22,-22,212,454
20150513,3571,3571,3583,3623,3581,3623,3601,52,30,2168,784
20150514,3623,3601,3699,3720,3672,3708,3695,107,94,462,850
20150515,3708,3695,3723,3753,3712,3733,3734,38,39,250,898
20150518,3733,3734,3721,3804,3721,3792,3757,58,23,248,928
20150519,3792,3757,3785,3787,3727,3747,3760,-10,3,214,870
20150520,3747,3760,3698,3721,3602,3652,3662,-108,-98,236,824
20150521,3652,3662,3674,3683,3668,3680,3675,18,13,96,816
20150522,3680,3675,3654,3689,3654,3679,3673,4,-2,220,750
20150525,3679,3673,3650,3662,3645,3654,3655,-19,-18,84,724
20150526,3654,3655,3662,3682,3615,3615,3662,-40,7,100,734
20150527,3615,3662,3601,3633,3601,3623,3614,-39,-48,402,568
20150528,3623,3614,3612,3649,3581,3636,3608,22,-6,88,590
20150529,3636,3608,3585,3616,3578,3610,3602,2,-6,164,594
20150601,3610,3602,3617,3620,3599,3602,3612,0,10,64,610
20150602,3602,3612,3605,3669,3605,3617,3631,5,19,260,546
20150603,3617,3631,3618,3618,3615,3615,3616,-16,-15,4,544
20150604,3615,3616,3615,3630,3557,3567,3576,-49,-40,78,502
20150605,3567,3576,3558,3558,3521,3529,3536,-47,-40,24,508
20150608,3529,3536,,,,3536,3536,0,0,0,508
20150609,3536,3536,3519,3530,3510,3528,3520,-8,-16,98,520
20150610,3528,3520,3524,3531,3517,3517,3526,-3,6,70,528
20150611,3517,3526,3544,3546,3527,3527,3533,1,7,72,536
20150612,3527,3533,3523,3527,3491,3515,3509,-18,-24,26,532
20150615,3515,3509,3514,3515,3489,3505,3505,-4,-4,64,546
20150616,3505,3505,3515,3548,3507,3528,3517,23,12,102,520
20150617,3528,3517,3522,3522,3492,3492,3506,-25,-11,118,560
20150618,3492,3506,3510,3541,3503,3530,3517,24,11,120,530
20150619,3530,3517,3592,3592,3517,3517,3535,0,18,168,510
20150623,3517,3535,3501,3516,3500,3500,3505,-35,-30,24,508
20150624,3500,3505,3478,3478,3438,3451,3454,-54,-51,200,484
20150625,3451,3454,3447,3459,3447,3455,3455,1,1,220,454
20150626,3455,3455,3444,3484,3426,3426,3450,-29,-5,86,470
20150629,3426,3450,3428,3471,3400,3447,3423,-3,-27,120,456
20150630,3447,3423,3452,3452,3400,3408,3427,-15,4,110,488
20150701,3408,3427,3398,3430,3384,3423,3403,-4,-24,194,536
20150702,3423,3403,3408,3411,3388,3391,3396,-12,-7,74,558
20150703,3391,3396,3413,3423,3404,3418,3412,22,16,82,560
20150706,3418,3412,3423,3423,3387,3387,3409,-25,-3,14,560
20150707,3387,3409,3387,3424,3387,3403,3403,-6,-6,70,552
20150708,3403,3403,3330,3330,3198,3200,3225,-203,-178,248,462
20150709,3200,3225,3202,3406,3177,3338,3277,113,52,348,510
20150710,3338,3277,3360,3376,3331,3347,3350,70,73,68,474
20150713,3347,3350,3350,3350,3324,3339,3338,-11,-12,36,472
20150714,3339,3338,3333,3333,3293,3310,3315,-28,-23,114,468
20150715,3310,3315,3322,3338,3309,3320,3324,5,9,26,464
20150716,3320,3324,3282,3282,3247,3260,3260,-64,-64,214,520
20150717,3260,3260,3198,3271,3196,3254,3246,-6,-14,178,496
20150720,3254,3246,3246,3260,3175,3205,3216,-41,-30,136,512
20150721,3205,3216,3209,3268,3209,3221,3227,5,11,196,518
20150722,3221,3227,3245,3254,3163,3212,3218,-15,-9,156,542
20150723,3212,3218,3207,3229,3163,3216,3198,-2,-20,232,636
20150724,3216,3198,3161,3230,3161,3188,3194,-10,-4,1572,546
20150727,3188,3194,3161,3206,3146,3204,3176,10,-18,136,520
20150728,3204,3176,3193,3205,3176,3193,3187,17,11,160,528
20150729,3193,3187,3197,3239,3180,3211,3206,24,19,98,462
20150730,3211,3206,3200,3230,3190,3190,3212,-16,6,452,436
20150731,3190,3212,3222,3222,3170,3170,3198,-42,-14,236,348
20150803,3170,3198,,,,3198,3198,0,0,0,348
20150804,3198,3198,3177,3177,3148,3165,3150,-33,-48,132,344
20150805,3165,3150,3166,3170,3166,3170,3169,20,19,68,320
20150806,3170,3169,3189,3189,3171,3173,3174,4,5,104,320
20150807,3173,3174,3175,3235,3175,3185,3196,11,22,72,312
20150810,3185,3196,3205,3213,3205,3213,3211,17,15,28,296
20150811,3213,3211,3240,3337,3240,3326,3295,115,84,200,324
20150812,3326,3295,3380,3475,3377,3467,3444,172,149,216,520
20150813,3467,3444,,,,3444,3444,0,0,0,520
20150814,3444,3444,3640,3640,3465,3465,3550,21,106,88,476
20150817,3465,3550,3657,3657,3415,3420,3518,-130,-32,236,540
ag1509,20150105,3518,3510,3518,3521,3513,3521,3517,11,7,8,874
20150106,3521,3517,3499,3571,3499,3567,3539,50,22,48,870
20150107,3567,3539,3562,3602,3562,3581,3579,42,40,34,872
20150108,3581,3579,3564,3595,3564,3571,3574,-8,-5,508,870
20150109,3571,3574,3570,3604,3570,3575,3581,1,7,152,910
20150112,3575,3581,3572,3627,3560,3627,3603,46,22,138,826
20150113,3627,3603,3600,3654,3600,3645,3633,42,30,62,824
20150114,3645,3633,3658,3676,3592,3620,3621,-13,-12,116,798
20150115,3620,3621,3610,3639,3582,3582,3608,-39,-13,38,788
20150116,3582,3608,3644,3658,3644,3658,3651,50,43,12,792
20150119,3658,3651,3659,3772,3659,3760,3740,109,89,154,754
20150120,3760,3740,3777,3793,3759,3783,3778,43,38,60,756
20150121,3783,3778,3811,3922,3800,3911,3866,133,88,126,788
20150122,3911,3866,3920,3928,3814,3814,3862,-52,-4,68,776
20150123,3814,3862,3873,3884,3866,3868,3876,6,14,18,772
20150126,3868,3876,3859,3895,3839,3851,3866,-25,-10,66,782
20150127,3851,3866,3847,3855,3800,3813,3820,-53,-46,74,784
20150128,3813,3820,3818,3837,3817,3817,3821,-3,1,40,778
20150129,3817,3821,3790,3796,3779,3780,3785,-41,-36,56,760
20150130,3780,3785,3730,3731,3586,3586,3633,-199,-152,90,778
20150202,3586,3633,3575,3668,3572,3645,3615,12,-18,50,776
20150203,3645,3615,3641,3688,3626,3688,3652,73,37,72,784
20150204,3688,3652,3683,3683,3640,3656,3661,4,9,30,784
20150205,3656,3661,3669,3712,3669,3702,3700,41,39,52,788
20150206,3702,3700,3658,3687,3657,3687,3676,-13,-24,48,774
20150209,3687,3676,3650,3658,3574,3610,3620,-66,-56,124,778
20150210,3610,3620,3636,3646,3636,3643,3640,23,20,24,776
20150211,3643,3640,3625,3643,3624,3638,3629,-2,-11,46,796
20150212,3638,3629,3626,3627,3584,3599,3601,-30,-28,18,792
20150213,3599,3601,3599,3646,3599,3642,3609,41,8,82,760
20150216,3642,3609,3681,3702,3662,3695,3692,86,83,34,742
20150217,3695,3692,3701,3757,3687,3688,3710,-4,18,48,748
20150225,3688,3710,3614,3614,3570,3610,3602,-100,-108,70,738
20150226,3610,3602,3611,3628,3611,3627,3619,25,17,8,736
20150227,3627,3619,3635,3644,3620,3622,3627,3,8,34,738
20150302,3622,3627,3611,3673,3611,3653,3648,26,21,34,734
20150303,3653,3648,3669,3669,3525,3612,3593,-36,-55,128,776
20150304,3612,3593,3626,3627,3587,3593,3602,0,9,36,762
20150305,3593,3602,3586,3586,3564,3564,3575,-38,-27,22,770
20150306,3564,3575,3560,3560,3547,3553,3553,-22,-22,48,776
20150309,3553,3553,3538,3538,3471,3493,3503,-60,-50,68,782
20150310,3493,3503,3492,3492,3446,3452,3468,-51,-35,88,792
20150311,3452,3468,3465,3485,3465,3467,3470,-1,2,18,786
20150312,3467,3470,3459,3491,3424,3475,3447,5,-23,184,796
20150313,3475,3447,3488,3491,3470,3473,3477,26,30,40,792
20150316,3473,3477,3472,3489,3449,3489,3467,12,-10,94,768
20150317,3489,3467,3484,3485,3468,3470,3476,3,9,48,762
20150318,3470,3476,3430,3480,3430,3447,3453,-29,-23,28,762
20150319,3447,3453,3451,3557,3443,3527,3506,74,53,56,756
20150320,3527,3506,3522,3546,3517,3534,3535,28,29,60,764
20150323,3534,3535,3569,3660,3568,3660,3634,125,99,70,788
20150324,3660,3634,3680,3716,3676,3694,3694,60,60,104,768
20150325,3694,3694,3694,3694,3641,3675,3670,-19,-24,56,764
20150326,3675,3670,3675,3718,3675,3695,3696,25,26,40,760
20150327,3695,3696,3698,3707,3678,3694,3696,-2,0,54,762
20150330,3694,3696,3680,3681,3647,3652,3664,-44,-32,312,770
20150331,3652,3664,3609,3634,3576,3576,3618,-88,-46,152,814
20150401,3576,3618,3591,3620,3586,3606,3601,-12,-17,50,816
20150402,3606,3601,3605,3661,3605,3650,3636,49,35,246,780
20150403,3650,3636,3590,3636,3590,3617,3607,-19,-29,458,792
20150407,3617,3607,3641,3662,3641,3645,3652,38,45,44,782
20150408,3645,3652,3644,3651,3629,3649,3641,-3,-11,86,790
20150409,3649,3641,3647,3650,3537,3570,3582,-71,-59,150,760
20150410,3570,3582,3560,3560,3512,3534,3530,-48,-52,134,742
20150413,3534,3530,3553,3589,3550,3568,3567,38,37,138,768
20150414,3568,3567,3571,3572,3515,3530,3550,-37,-17,110,782
20150415,3530,3550,3549,3568,3528,3547,3550,-3,0,72,788
20150416,3547,3550,3555,3586,3547,3579,3565,29,15,94,762
20150417,3579,3565,3591,3594,3542,3557,3565,-8,0,162,760
20150420,3557,3565,3562,3584,3555,3584,3563,19,-2,28,748
20150421,3584,3563,3523,3526,3499,3514,3512,-49,-51,248,796
20150422,3514,3512,3520,3551,3506,3520,3519,8,7,154,768
20150423,3520,3519,3516,3516,3455,3470,3476,-49,-43,246,808
20150424,3470,3476,3474,3514,3458,3510,3486,34,10,292,874
20150427,3510,3486,3484,3511,3459,3495,3489,9,3,184,888
20150428,3495,3489,3518,3650,3518,3650,3606,161,117,758,862
20150429,3650,3606,3660,3660,3606,3620,3634,14,28,566,836
20150430,3620,3634,3648,3654,3610,3621,3637,-13,3,150,860
20150504,3621,3637,3537,3599,3537,3585,3567,-52,-70,434,822
20150505,3585,3567,3636,3652,3597,3601,3624,34,57,706,890
20150506,3601,3624,3659,3659,3618,3619,3629,-5,5,912,926
20150507,3619,3629,3643,3643,3585,3596,3616,-33,-13,284,894
20150508,3596,3616,3582,3604,3574,3593,3587,-23,-29,468,826
20150511,3593,3587,3610,3623,3590,3603,3606,16,19,498,902
20150512,3603,3606,3611,3620,3554,3576,3584,-30,-22,184,920
20150513,3576,3584,3576,3640,3576,3640,3609,56,25,564,954
20150514,3640,3609,3736,3773,3686,3717,3709,108,100,984,960
20150515,3717,3709,3733,3761,3717,3739,3738,30,29,884,914
20150518,3739,3738,3729,3817,3728,3804,3777,66,39,758,990
20150519,3804,3777,3834,3834,3748,3756,3781,-21,4,912,1088
20150520,3756,3781,3749,3749,3606,3655,3657,-126,-124,922,1178
20150521,3655,3657,3684,3700,3666,3690,3686,33,29,338,1172
20150522,3690,3686,3682,3700,3653,3697,3686,11,0,250,1172
20150525,3697,3686,3658,3685,3648,3670,3667,-16,-19,392,1222
20150526,3670,3667,3673,3704,3628,3628,3675,-39,8,974,900
20150527,3628,3675,3615,3668,3587,3631,3628,-44,-47,672,1046
20150528,3631,3628,3626,3638,3600,3619,3619,-9,-9,348,1024
20150529,3619,3619,3642,3642,3587,3623,3612,4,-7,380,944
20150601,3623,3612,3625,3635,3605,3619,3622,7,10,260,982
20150602,3619,3622,3614,3690,3604,3631,3643,9,21,636,988
20150603,3631,3643,3641,3652,3627,3634,3641,-9,-2,178,984
20150604,3634,3641,3624,3628,3577,3585,3604,-56,-37,324,998
20150605,3585,3604,3580,3580,3522,3522,3541,-82,-63,534,1168
20150608,3522,3541,3529,3550,3482,3544,3528,3,-13,834,1224
20150609,3544,3528,3544,3550,3523,3540,3538,12,10,812,1194
20150610,3540,3538,3547,3551,3524,3536,3541,-2,3,302,1152
20150611,3536,3541,3559,3559,3528,3532,3534,-9,-7,286,1160
20150612,3532,3534,3535,3536,3500,3529,3523,-5,-11,232,1168
20150615,3529,3523,3513,3525,3502,3520,3512,-3,-11,138,1166
20150616,3520,3512,3519,3551,3519,3544,3534,32,22,626,1158
20150617,3544,3534,3533,3533,3490,3498,3507,-36,-27,832,1214
20150618,3498,3507,3512,3557,3498,3539,3521,32,14,1382,1176
20150619,3539,3521,3578,3615,3525,3537,3551,16,30,944,1142
20150623,3537,3551,3530,3537,3505,3506,3525,-45,-26,198,1130
20150624,3506,3525,3496,3496,3443,3468,3459,-57,-66,642,1160
20150625,3468,3459,3442,3473,3442,3466,3462,7,3,496,974
20150626,3466,3462,3600,3600,3430,3430,3466,-32,4,904,894
20150629,3430,3466,3440,3481,3425,3430,3452,-36,-14,974,872
20150630,3430,3452,3453,3465,3372,3413,3417,-39,-35,634,858
20150701,3413,3417,3391,3462,3364,3412,3416,-5,-1,442,836
20150702,3412,3416,3436,3436,3385,3401,3404,-15,-12,376,800
20150703,3401,3404,3437,3464,3414,3464,3426,60,22,382,790
20150706,3464,3426,3433,3440,3399,3411,3423,-15,-3,258,774
20150707,3411,3423,3402,3448,3396,3414,3415,-9,-8,196,814
20150708,3414,3415,3368,3368,3210,3223,3249,-192,-166,900,738
20150709,3223,3249,3187,3394,3180,3350,3286,101,37,748,634
20150710,3350,3286,3362,3386,3320,3358,3359,72,73,726,640
20150713,3358,3359,3351,3391,3338,3348,3355,-11,-4,250,598
20150714,3348,3355,3348,3370,3244,3318,3316,-37,-39,712,636
20150715,3318,3316,3338,3341,3310,3320,3324,4,8,172,616
20150716,3320,3324,3280,3286,3246,3266,3273,-58,-51,1170,672
20150717,3266,3273,3250,3289,3238,3252,3259,-21,-14,214,630
20150720,3252,3259,3252,3252,3166,3230,3210,-29,-49,394,664
20150721,3230,3210,3230,3282,3202,3232,3244,22,34,290,638
20150722,3232,3244,3240,3263,3203,3226,3237,-18,-7,248,666
20150723,3226,3237,3226,3240,3202,3229,3224,-8,-13,138,638
20150724,3229,3224,3233,3237,3162,3193,3205,-31,-19,204,638
20150727,3193,3205,3160,3217,3132,3207,3187,2,-18,196,574
20150728,3207,3187,3194,3212,3190,3196,3199,9,12,84,584
20150729,3196,3199,3207,3217,3203,3209,3211,10,12,348,660
20150730,3209,3211,3211,3238,3194,3194,3220,-17,9,222,588
20150731,3194,3220,3220,3232,3200,3205,3211,-15,-9,174,612
20150803,3205,3211,3233,3254,3213,3217,3234,6,23,124,582
20150804,3217,3234,3230,3230,3150,3185,3178,-49,-56,242,620
20150805,3185,3178,3190,3197,3174,3180,3189,2,11,176,680
20150806,3180,3189,3197,3200,3140,3184,3188,-5,-1,250,606
20150807,3184,3188,3190,3214,3182,3214,3193,26,5,130,598
20150810,3214,3193,3191,3248,3191,3230,3228,37,35,212,594
20150811,3230,3228,3241,3357,3238,3331,3324,103,96,796,646
20150812,3331,3324,3342,3504,3342,3496,3442,172,118,756,714
20150813,3496,3442,3519,3541,3465,3479,3492,37,50,1238,758
20150814,3479,3492,3477,3486,3456,3464,3467,-28,-25,1106,1034
20150817,3464,3467,3483,3501,3402,3419,3424,-48,-43,320,1012
20150818,3419,3424,3458,3458,3406,3406,3421,-18,-3,130,1012
20150819,3406,3421,3359,3384,3330,3377,3350,-44,-71,208,1006
20150820,3377,3350,3370,3459,3370,3433,3416,83,66,420,1020
20150821,3433,3416,3416,3495,3416,3454,3466,38,50,244,1020
20150824,3454,3466,3479,3479,3374,3374,3405,-92,-61,326,1040
20150825,3374,3405,3319,3389,3312,3333,3350,-72,-55,666,1092
20150826,3333,3350,3357,3366,3288,3288,3317,-62,-33,566,1106
20150827,3288,3317,3236,3250,3211,3241,3232,-76,-85,310,1072
20150828,3241,3232,3223,3331,3223,3308,3292,76,60,464,1066
20150831,3308,3292,3277,3328,3261,3270,3291,-22,-1,696,1428
20150901,3270,3291,3270,3319,3269,3298,3305,7,14,100,1428
20150902,3298,3305,3285,3289,3280,3280,3284,-25,-21,48,1428
20150907,3280,3284,3290,3290,3280,3280,3289,-4,5,480,1784
20150908,3280,3289,3270,3275,3261,3275,3272,-14,-17,336,1996
20150909,3275,3272,3308,3367,3280,3280,3320,8,48,1620,3476
20150910,3280,3320,3220,3270,3220,3270,3223,-50,-97,560,3476
20150911,3270,3223,3270,3270,3270,3270,3270,47,47,8,3476
20150914,3270,3270,3275,3299,3260,3260,3272,-10,2,220,3596
20150915,3260,3272,3236,3260,3236,3236,3244,-36,-28,44,3596
ag1510,20150105,3523,3547,3450,3529,3450,3529,3502,-18,-45,30,2014
20150106,3529,3502,3500,3588,3500,3588,3544,86,42,180,2110
20150107,3588,3544,3585,3611,3564,3577,3580,33,36,36,2122
20150108,3577,3580,3575,3587,3571,3571,3582,-9,2,490,1644
20150109,3571,3582,3588,3607,3577,3577,3592,-5,10,12,1636
20150112,3577,3592,3605,3627,3589,3620,3612,28,20,34,1626
20150113,3620,3612,3611,3662,3607,3644,3632,32,20,62,1632
20150114,3644,3632,3670,3683,3600,3637,3645,5,13,84,1644
20150115,3637,3645,3621,3655,3591,3591,3625,-54,-20,28,1648
20150116,3591,3625,3686,3686,3647,3658,3661,33,36,26,1646
20150119,3658,3661,3671,3799,3671,3775,3759,114,98,178,1616
20150120,3775,3759,3786,3800,3771,3786,3785,27,26,28,1616
20150121,3786,3785,3838,3935,3808,3921,3860,136,75,78,1600
20150122,3921,3860,3924,3924,3830,3830,3877,-30,17,62,1602
20150123,3830,3877,3861,3901,3844,3882,3871,5,-6,310,1614
20150126,3882,3871,3847,3898,3847,3866,3886,-5,15,184,1618
20150127,3866,3886,3855,3855,3782,3828,3807,-58,-79,46,1612
20150128,3828,3807,3830,3836,3823,3827,3827,20,20,20,1604
20150129,3827,3827,3833,3835,3790,3798,3814,-29,-13,20,1600
20150130,3798,3814,3734,3735,3588,3595,3637,-219,-177,288,1704
20150202,3595,3637,3630,3693,3630,3658,3687,21,50,230,1820
20150203,3658,3687,3649,3700,3631,3692,3660,5,-27,64,1824
20150204,3692,3660,3689,3692,3643,3668,3670,8,10,32,1818
20150205,3668,3670,3684,3710,3684,3705,3705,35,35,406,1650
20150206,3705,3705,3670,3695,3659,3695,3673,-10,-32,240,1650
20150209,3695,3673,3687,3687,3603,3614,3628,-59,-45,120,1656
20150210,3614,3628,3632,3651,3627,3646,3639,18,11,22,1654
20150211,3646,3639,3629,3647,3617,3645,3637,6,-2,16,1650
20150212,3645,3637,3592,3610,3588,3610,3595,-27,-42,14,1648
20150213,3610,3595,3636,3655,3614,3649,3632,54,37,22,1648
20150216,3649,3632,3688,3720,3685,3697,3697,65,65,14,1646
20150217,3697,3697,3699,3710,3690,3702,3707,5,10,212,1818
20150225,3702,3707,3612,3627,3609,3622,3616,-85,-91,72,1816
20150226,3622,3616,3626,3631,3615,3631,3620,15,4,56,1822
20150227,3631,3620,3645,3656,3627,3642,3639,22,19,18,1826
20150302,3642,3639,3633,3670,3618,3666,3646,27,7,36,1824
20150303,3666,3646,3666,3856,3535,3636,3689,-10,43,782,1904
20150304,3636,3689,3636,3636,3594,3596,3603,-93,-86,146,1898
20150305,3596,3603,3584,3597,3564,3564,3586,-39,-17,90,1934
20150306,3564,3586,3573,3587,3562,3562,3571,-24,-15,16,1938
20150309,3562,3571,3551,3559,3470,3497,3509,-74,-62,174,1914
20150310,3497,3509,3497,3497,3461,3461,3491,-48,-18,234,2078
20150311,3461,3491,3483,3485,3470,3481,3480,-10,-11,64,2074
20150312,3481,3480,3458,3470,3424,3470,3444,-10,-36,64,2072
20150313,3470,3444,3496,3501,3473,3482,3484,38,40,92,2060
20150316,3482,3484,3477,3506,3456,3496,3488,12,4,284,2248
20150317,3496,3488,3487,3501,3470,3470,3485,-18,-3,16,2248
20150318,3470,3485,3445,3487,3439,3473,3462,-12,-23,36,2238
20150319,3473,3462,3462,3566,3454,3538,3520,76,58,64,2236
20150320,3538,3520,3546,3546,3546,3546,3546,26,26,2,2238
20150323,3546,3546,3574,3670,3573,3658,3648,112,102,212,2248
20150324,3658,3648,3686,3725,3682,3708,3701,60,53,112,2232
20150325,3708,3701,3713,3717,3672,3672,3694,-29,-7,30,2224
20150326,3672,3694,3728,3728,3686,3712,3713,18,19,42,2216
20150327,3712,3713,3684,3704,3680,3704,3695,-9,-18,18,2214
20150330,3704,3695,3678,3682,3652,3661,3665,-34,-30,110,2148
20150331,3661,3665,3624,3641,3590,3590,3619,-75,-46,68,2118
20150401,3590,3619,3592,3608,3588,3605,3605,-14,-14,70,2068
20150402,3605,3605,3622,3657,3622,3652,3641,47,36,70,2030
20150403,3652,3641,3630,3638,3620,3634,3629,-7,-12,84,2028
20150407,3634,3629,3663,3669,3658,3661,3661,32,32,72,1988
20150408,3661,3661,3653,3653,3653,3653,3653,-8,-8,2,1988
20150409,3653,3653,3607,3607,3538,3564,3572,-89,-81,54,2016
20150410,3564,3572,3532,3532,3524,3529,3529,-43,-43,36,2016
20150413,3529,3529,3604,3604,3568,3580,3587,51,58,20,2006
20150414,3580,3587,3576,3576,3542,3542,3561,-45,-26,46,2020
20150415,3542,3561,3560,3577,3540,3549,3563,-12,2,144,2046
20150416,3549,3563,3547,3595,3547,3580,3574,17,11,60,2034
20150417,3580,3574,3596,3596,3552,3564,3567,-10,-7,36,2022
20150420,3564,3567,3570,3570,3560,3567,3566,0,-1,86,2016
20150421,3567,3566,3546,3546,3506,3515,3517,-51,-49,148,2114
20150422,3515,3517,3520,3553,3518,3538,3527,21,10,80,2136
20150423,3538,3527,3523,3523,3475,3484,3488,-43,-39,104,2142
20150424,3484,3488,3493,3518,3493,3501,3500,13,12,18,2140
20150427,3501,3500,3505,3555,3469,3555,3499,55,-1,296,2096
20150428,3555,3499,3496,3646,3495,3630,3601,131,102,552,2108
20150429,3630,3601,3651,3676,3629,3630,3658,29,57,638,2004
20150430,3630,3658,3642,3676,3624,3627,3658,-31,0,168,1990
20150504,3627,3658,3558,3596,3554,3592,3573,-66,-85,416,2140
20150505,3592,3573,3600,3660,3600,3608,3621,35,48,264,2114
20150506,3608,3621,3645,3655,3625,3629,3638,8,17,152,2130
20150507,3629,3638,3640,3650,3596,3601,3635,-37,-3,320,2112
20150508,3601,3635,3590,3608,3588,3601,3595,-34,-40,84,2092
20150511,3601,3595,3624,3638,3601,3610,3610,15,15,130,2072
20150512,3610,3610,3621,3629,3557,3591,3607,-19,-3,296,2128
20150513,3591,3607,3607,3649,3600,3644,3617,37,10,364,2060
20150514,3644,3617,3729,3823,3697,3735,3718,118,101,1170,1998
20150515,3735,3718,3739,3773,3734,3755,3748,37,30,236,2000
20150518,3755,3748,3748,3829,3748,3815,3806,67,58,380,1978
20150519,3815,3806,3822,3822,3766,3771,3794,-35,-12,206,2012
20150520,3771,3794,3734,3740,3619,3649,3667,-145,-127,272,1988
20150521,3649,3667,3682,3697,3682,3694,3693,27,26,42,1982
20150522,3694,3693,3670,3697,3670,3697,3688,4,-5,102,2008
20150525,3697,3688,3671,3726,3670,3682,3693,-6,5,100,2024
20150526,3682,3693,3696,3699,3638,3638,3674,-55,-19,158,1976
20150527,3638,3674,3608,3659,3608,3643,3637,-31,-37,82,1976
20150528,3643,3637,3634,3646,3626,3626,3637,-11,0,84,1970
20150529,3626,3637,3633,3639,3610,3631,3629,-6,-8,82,1966
20150601,3631,3629,3643,3645,3601,3627,3626,-2,-3,74,1958
20150602,3627,3626,3640,3699,3630,3636,3664,10,38,58,1974
20150603,3636,3664,3648,3679,3621,3642,3652,-22,-12,134,2000
20150604,3642,3652,3649,3649,3593,3598,3616,-54,-36,188,1988
20150605,3598,3616,3582,3591,3547,3547,3561,-69,-55,232,2064
20150608,3547,3561,3524,3554,3519,3551,3540,-10,-21,38,2058
20150609,3551,3540,3539,3554,3539,3549,3543,9,3,208,2022
20150610,3549,3543,3554,3554,3534,3553,3545,10,2,78,1992
20150611,3553,3545,3550,3550,3541,3541,3543,-4,-2,8,1992
20150612,3541,3543,3526,3542,3508,3527,3527,-16,-16,68,1992
20150615,3527,3527,3525,3531,3511,3526,3521,-1,-6,66,1994
20150616,3526,3521,3532,3556,3530,3540,3541,19,20,106,1982
20150617,3540,3541,3530,3530,3505,3521,3523,-20,-18,54,1980
20150618,3521,3523,3537,3568,3523,3555,3540,32,17,52,1982
20150619,3555,3540,3585,3594,3534,3541,3557,1,17,158,1988
20150623,3541,3557,3528,3537,3528,3528,3532,-29,-25,58,1976
20150624,3528,3532,3505,3505,3458,3475,3476,-57,-56,88,1986
20150625,3475,3476,3462,3485,3462,3473,3476,-3,0,378,1718
20150626,3473,3476,3463,3481,3452,3452,3465,-24,-11,642,1538
20150629,3452,3465,3457,3500,3444,3467,3465,2,0,1534,998
20150630,3467,3465,3472,3476,3385,3419,3417,-46,-48,608,894
20150701,3419,3417,3405,3460,3399,3440,3428,23,11,130,858
20150702,3440,3428,3419,3423,3399,3404,3411,-24,-17,56,850
20150703,3404,3411,3440,3448,3420,3434,3431,23,20,38,858
20150706,3434,3431,3431,3438,3419,3419,3429,-12,-2,44,854
20150707,3419,3429,3404,3448,3404,3412,3422,-17,-7,152,856
20150708,3412,3422,3378,3378,3216,3216,3280,-206,-142,218,890
20150709,3216,3280,3222,3391,3177,3359,3272,79,-8,402,852
20150710,3359,3272,3369,3391,3350,3370,3375,98,103,256,952
20150713,3370,3375,3368,3378,3354,3354,3369,-21,-6,74,918
20150714,3354,3369,3350,3354,3312,3342,3333,-27,-36,98,930
20150715,3342,3333,3352,3361,3326,3335,3336,2,3,56,924
20150716,3335,3336,3301,3301,3274,3279,3282,-57,-54,110,930
20150717,3279,3282,3265,3290,3262,3265,3272,-17,-10,108,898
20150720,3265,3272,3241,3251,3179,3225,3205,-47,-67,92,904
20150721,3225,3205,3228,3282,3225,3231,3265,26,60,2380,1378
20150722,3231,3265,3249,3263,3200,3216,3235,-49,-30,180,1384
20150723,3216,3235,3230,3250,3209,3250,3226,15,-9,62,1376
20150724,3250,3226,3245,3245,3177,3202,3198,-24,-28,60,1384
20150727,3202,3198,3198,3228,3159,3228,3195,30,-3,98,1378
20150728,3228,3195,3213,3219,3196,3204,3204,9,9,14,1372
20150729,3204,3204,3210,3230,3204,3230,3217,26,13,66,1318
20150730,3230,3217,3220,3247,3220,3236,3231,19,14,14,1310
20150731,3236,3231,3221,3221,3190,3204,3210,-27,-21,78,1302
20150803,3204,3210,3237,3261,3222,3232,3229,22,19,130,1302
20150804,3232,3229,3190,3191,3171,3191,3180,-38,-49,24,1310
20150805,3191,3180,3199,3199,3184,3184,3192,4,12,42,1288
20150806,3184,3192,3195,3211,3189,3190,3197,-2,5,64,1252
20150807,3190,3197,3187,3208,3187,3201,3198,4,1,152,1152
20150810,3201,3198,3225,3242,3225,3239,3233,41,35,86,1074
20150811,3239,3233,3248,3363,3248,3340,3323,107,90,210,964
20150812,3340,3323,3358,3506,3347,3497,3429,174,106,206,892
20150813,3497,3429,3228,3539,3228,3486,3504,57,75,246,818
20150814,3486,3504,3486,3488,3470,3470,3472,-34,-32,154,776
20150817,3470,3472,3500,3508,3416,3431,3427,-41,-45,150,694
20150818,3431,3427,3435,3440,3431,3431,3437,4,10,36,684
20150819,3431,3437,3372,3380,3350,3380,3360,-57,-77,68,656
20150820,3380,3360,3416,3468,3416,3459,3440,99,80,130,646
20150821,3459,3440,3476,3517,3470,3470,3489,30,49,142,650
20150824,3470,3489,3464,3464,3392,3396,3428,-93,-61,56,640
20150825,3396,3428,3335,3404,3335,3350,3384,-78,-44,98,636
20150826,3350,3384,3338,3359,3303,3303,3330,-81,-54,238,580
20150827,3303,3330,3235,3281,3235,3255,3249,-75,-81,74,592
20150828,3255,3249,3353,3353,3240,3324,3291,75,42,256,596
20150831,3324,3291,3324,3326,3305,3305,3312,14,21,134,592
20150901,3305,3312,3328,3328,3293,3319,3323,7,11,42,594
20150902,3319,3323,3323,3323,3296,3296,3300,-27,-23,32,592
20150907,3296,3300,3308,3311,3300,3300,3308,0,8,66,610
20150908,3300,3308,3287,3298,3285,3296,3294,-12,-14,74,678
20150909,3296,3294,3296,3368,3296,3304,3343,10,49,260,668
20150910,3304,3343,3305,3306,3284,3300,3297,-43,-46,46,644
20150911,3300,3297,3328,3328,3299,3309,3314,12,17,10,646
20150914,3309,3314,3295,3295,3248,3275,3274,-39,-40,54,622
20150915,3275,3274,3269,3269,3269,3269,3269,-5,-5,2,620
20150916,3269,3269,3266,3271,3251,3260,3263,-9,-6,72,604
20150917,3260,3263,3333,3343,3308,3330,3329,67,66,186,612
20150918,3330,3329,3333,3399,3156,3374,3337,45,8,200,602
20150921,3374,3337,3417,3417,3363,3379,3395,42,58,418,686
20150922,3379,3395,3380,3380,3370,3370,3373,-25,-22,136,752
20150923,3370,3373,3345,3345,3308,3322,3331,-51,-42,1154,824
20150924,3322,3331,3337,3345,3328,3332,3331,1,0,758,1368
20150925,3332,3331,3345,3370,3345,3367,3359,36,28,60,1360
20150928,3367,3359,3350,3350,3335,3335,3346,-24,-13,186,1502
20150929,3335,3346,3280,3298,3246,3259,3274,-87,-72,36,1504
20150930,3259,3274,3281,3281,3220,3230,3264,-44,-10,266,1612
20151008,3230,3264,3525,3525,3433,3433,3463,169,199,244,1660
20151009,3433,3463,3415,3440,3415,3430,3426,-33,-37,1096,2344
20151012,3430,3426,3442,3460,3332,3440,3420,14,-6,160,2344
20151013,3440,3420,3379,3416,3379,3414,3410,-6,-10,468,2708
20151014,3414,3410,3401,3454,3401,3440,3445,30,35,2796,5488
20151015,3440,3445,3268,3460,3268,3420,3439,-25,-6,364,5584
ag1511,20150105,3527,3561,3523,3545,3523,3530,3530,-31,-31,16,264
20150106,3530,3530,3493,3585,3493,3579,3535,49,5,36,264
20150107,3579,3535,3571,3605,3569,3580,3580,45,45,54,254
20150108,3580,3580,3575,3580,3575,3580,3576,0,-4,12,252
20150109,3580,3576,3590,3602,3583,3593,3589,17,13,20,256
20150112,3593,3589,3566,3635,3565,3635,3607,46,18,18,254
20150113,3635,3607,3624,3670,3620,3654,3641,47,34,24,262
20150114,3654,3641,3688,3688,3608,3608,3647,-33,6,32,244
20150115,3608,3647,3660,3660,3620,3620,3640,-27,-7,4,244
20150116,3620,3640,3682,3682,3657,3662,3669,22,29,14,246
20150119,3662,3669,3667,3788,3667,3788,3755,119,86,92,248
20150120,3788,3755,3786,3793,3786,3792,3790,37,35,10,244
20150121,3792,3790,3846,3940,3833,3932,3847,142,57,112,236
20150122,3932,3847,3942,3942,3847,3847,3869,0,22,80,234
20150123,3847,3869,3878,3939,3871,3903,3895,34,26,28,236
20150126,3903,3895,3873,3918,3851,3878,3888,-17,-7,28,244
20150127,3878,3888,3820,3844,3809,3844,3820,-44,-68,10,246
20150128,3844,3820,3845,3869,3830,3839,3846,19,26,36,246
20150129,3839,3846,3801,3801,3801,3801,3801,-45,-45,2,244
20150130,3801,3801,3700,3700,3595,3604,3625,-197,-176,128,240
20150202,3604,3625,3615,3706,3603,3673,3665,48,40,16,240
20150203,3673,3665,3644,3682,3644,3682,3657,17,-8,6,240
20150204,3682,3657,3676,3676,3676,3676,3676,19,19,4,240
20150205,3676,3676,3732,3732,3732,3732,3732,56,56,2,242
20150206,3732,3732,3694,3704,3694,3700,3699,-32,-33,8,246
20150209,3700,3699,3615,3618,3615,3618,3615,-81,-84,94,320
20150210,3618,3615,3655,3655,3645,3645,3648,30,33,22,306
20150211,3645,3648,,,,3648,3648,0,0,0,306
20150212,3648,3648,3638,3638,3602,3605,3615,-43,-33,6,306
20150213,3605,3615,3622,3655,3622,3655,3635,40,20,8,304
20150216,3655,3635,3704,3713,3703,3705,3706,70,71,20,296
20150217,3705,3706,3714,3714,3699,3700,3706,-6,0,24,276
20150225,3700,3706,3615,3622,3615,3622,3618,-84,-88,8,276
20150226,3622,3618,3624,3624,3624,3624,3624,6,6,14,280
20150227,3624,3624,3654,3654,3632,3646,3645,22,21,14,272
20150302,3646,3645,3653,3672,3650,3672,3661,27,16,22,256
20150303,3672,3661,3663,3663,3540,3628,3604,-33,-57,28,260
20150304,3628,3604,3640,3640,3592,3600,3608,-4,4,8,258
20150305,3600,3608,3585,3585,3558,3579,3576,-29,-32,24,262
20150306,3579,3576,3568,3572,3551,3551,3564,-25,-12,8,260
20150309,3551,3564,3540,3545,3468,3488,3506,-76,-58,24,262
20150310,3488,3506,3500,3500,3463,3463,3482,-43,-24,14,250
20150311,3463,3482,3476,3476,3476,3476,3476,-6,-6,2,248
20150312,3476,3476,3458,3458,3432,3447,3446,-29,-30,48,246
20150313,3447,3446,3472,3472,3472,3472,3472,26,26,2,246
20150316,3472,3472,3466,3503,3464,3503,3480,31,8,10,244
20150317,3503,3480,3497,3503,3473,3473,3485,-7,5,18,242
20150318,3473,3485,3451,3481,3451,3463,3465,-22,-20,6,244
20150319,3463,3465,3461,3567,3455,3546,3502,81,37,32,242
20150320,3546,3502,3556,3556,3556,3556,3556,54,54,2,242
20150323,3556,3556,3581,3674,3573,3674,3627,118,71,44,240
20150324,3674,3627,3691,3731,3691,3711,3701,84,74,26,242
20150325,3711,3701,3702,3716,3697,3697,3702,-4,1,34,258
20150326,3697,3702,3730,3730,3697,3716,3722,14,20,32,232
20150327,3716,3722,,,,3722,3722,0,0,0,232
20150330,3722,3722,3673,3685,3670,3670,3675,-52,-47,22,236
20150331,3670,3675,3645,3645,3634,3634,3639,-41,-36,6,236
20150401,3634,3639,,,,3639,3639,0,0,0,236
20150402,3639,3639,3640,3666,3639,3655,3644,16,5,58,238
20150403,3655,3644,3635,3641,3624,3641,3633,-3,-11,6,238
20150407,3641,3633,3678,3678,3678,3678,3678,45,45,2,240
20150408,3678,3678,3679,3679,3662,3669,3668,-9,-10,16,244
20150409,3669,3668,3623,3629,3559,3560,3578,-108,-90,34,256
20150410,3560,3578,3558,3558,3535,3549,3546,-29,-32,66,250
20150413,3549,3546,3622,3622,3622,3622,3622,76,76,6,244
20150414,3622,3622,3583,3583,3543,3543,3573,-79,-49,32,244
20150415,3543,3573,3578,3578,3558,3558,3570,-15,-3,24,252
20150416,3558,3570,3558,3598,3551,3590,3576,20,6,14,252
20150417,3590,3576,3585,3585,3557,3564,3566,-12,-10,12,252
20150420,3564,3566,3571,3593,3571,3593,3585,27,19,10,252
20150421,3593,3585,3524,3524,3516,3517,3518,-68,-67,14,252
20150422,3517,3518,3522,3542,3522,3538,3531,20,13,8,252
20150423,3538,3531,3500,3500,3482,3488,3491,-43,-40,16,252
20150424,3488,3491,3505,3519,3501,3506,3506,15,15,68,270
20150427,3506,3506,3500,3522,3477,3522,3501,16,-5,42,270
20150428,3522,3501,3544,3660,3530,3627,3616,126,115,98,262
20150429,3627,3616,3628,3697,3628,3657,3653,41,37,102,262
20150430,3657,3653,3663,3676,3628,3633,3641,-20,-12,20,254
20150504,3633,3641,3563,3601,3563,3601,3574,-40,-67,18,258
20150505,3601,3574,3642,3670,3617,3617,3643,43,69,20,256
20150506,3617,3643,3668,3671,3609,3640,3642,-3,-1,1808,300
20150507,3640,3642,3656,3661,3606,3613,3646,-29,4,72,252
20150508,3613,3646,3615,3837,3596,3614,3615,-32,-31,66,236
20150511,3614,3615,3636,3636,3615,3615,3622,0,7,18,236
20150512,3615,3622,3641,3641,3572,3600,3595,-22,-27,62,242
20150513,3600,3595,3625,3663,3622,3658,3643,63,48,112,248
20150514,3658,3643,3768,3768,3717,3747,3735,104,92,78,242
20150515,3747,3735,3767,3794,3747,3763,3771,28,36,416,250
20150518,3763,3771,3760,3832,3760,3832,3779,61,8,108,284
20150519,3832,3779,3833,3844,3780,3791,3829,12,50,1128,260
20150520,3791,3829,3733,3733,3645,3684,3684,-145,-145,42,270
20150521,3684,3684,3699,3711,3699,3705,3704,21,20,8,270
20150522,3705,3704,3704,3709,3692,3704,3702,0,-2,8,270
20150525,3704,3702,3693,3693,3693,3693,3693,-9,-9,2,270
20150526,3693,3693,3693,3705,3692,3692,3695,-1,2,12,272
20150527,3692,3695,3626,3668,3624,3656,3648,-39,-47,30,268
20150528,3656,3648,3639,3660,3639,3642,3648,-6,0,36,274
20150529,3642,3648,3623,3653,3613,3644,3637,-4,-11,20,270
20150601,3644,3637,3652,3654,3650,3653,3652,16,15,8,272
20150602,3653,3652,3704,3704,3652,3652,3666,0,14,10,276
20150603,3652,3666,3677,3678,3653,3667,3668,1,2,32,284
20150604,3667,3668,3649,3649,3602,3618,3619,-50,-49,56,292
20150605,3618,3619,3594,3594,3558,3564,3566,-55,-53,56,270
20150608,3564,3566,3555,3567,3552,3556,3558,-10,-8,14,272
20150609,3556,3558,3566,3566,3547,3558,3553,0,-5,166,202
20150610,3558,3553,3567,3567,3561,3561,3565,8,12,10,194
20150611,3561,3565,,,,3565,3565,0,0,0,194
20150612,3565,3565,3565,3565,3543,3552,3554,-13,-11,28,192
20150615,3552,3554,3530,3538,3528,3532,3531,-22,-23,16,184
20150616,3532,3531,3550,3563,3544,3563,3553,32,22,14,188
20150617,3563,3553,3552,3552,3529,3533,3538,-20,-15,14,192
20150618,3533,3538,3544,3544,3544,3544,3544,6,6,28,212
20150619,3544,3544,3626,3626,3558,3558,3601,14,57,16,212
20150623,3558,3601,3559,3562,3544,3544,3556,-57,-45,40,230
20150624,3544,3556,3518,3518,3463,3493,3487,-63,-69,82,220
20150625,3493,3487,,,,3487,3487,0,0,0,220
20150626,3487,3487,3481,3481,3457,3457,3468,-30,-19,12,218
20150629,3457,3468,3461,3488,3438,3465,3459,-3,-9,54,214
20150630,3465,3459,3477,3477,3440,3440,3451,-19,-8,22,208
20150701,3440,3451,3415,3471,3408,3439,3431,-12,-20,42,212
20150702,3439,3431,3440,3442,3431,3439,3438,8,7,20,218
20150703,3439,3438,3442,3442,3438,3438,3440,0,2,18,226
20150706,3438,3440,3449,3453,3421,3421,3429,-19,-11,48,250
20150707,3421,3429,3419,3465,3411,3465,3435,36,6,22,256
20150708,3465,3435,3355,3358,3228,3235,3247,-200,-188,236,228
20150709,3235,3247,3198,3410,3190,3373,3328,126,81,80,206
20150710,3373,3328,3373,3389,3355,3382,3373,54,45,160,220
20150713,3382,3373,3383,3417,3363,3365,3373,-8,0,154,312
20150714,3365,3373,3336,3357,3326,3351,3344,-22,-29,50,312
20150715,3351,3344,3360,3360,3350,3350,3354,6,10,12,314
20150716,3350,3354,3310,3310,3276,3295,3285,-59,-69,124,352
20150717,3295,3285,3270,3274,3270,3274,3273,-11,-12,34,366
20150720,3274,3273,3258,3258,3195,3257,3232,-16,-41,148,374
20150721,3257,3232,3252,3296,3244,3256,3264,24,32,64,390
20150722,3256,3264,3273,3275,3217,3245,3243,-19,-21,804,454
20150723,3245,3243,,,,3243,3243,0,0,0,454
20150724,3243,3243,3242,3247,3188,3208,3226,-35,-17,110,444
20150727,3208,3226,3181,3233,3180,3233,3202,7,-24,40,454
20150728,3233,3202,3220,3222,3220,3220,3220,18,18,6,456
20150729,3220,3220,3225,3230,3223,3227,3226,7,6,54,442
20150730,3227,3226,3244,3244,3240,3240,3242,14,16,4,444
20150731,3240,3242,3224,3224,3217,3217,3221,-25,-21,8,446
20150803,3217,3221,3232,3232,3228,3228,3230,7,9,10,446
20150804,3228,3230,3181,3200,3181,3200,3187,-30,-43,18,452
20150805,3200,3187,3208,3209,3184,3190,3196,3,9,44,428
20150806,3190,3196,3215,3220,3195,3201,3204,5,8,12,430
20150807,3201,3204,3204,3215,3204,3215,3209,11,5,4,428
20150810,3215,3209,3244,3256,3233,3245,3246,36,37,44,420
20150811,3245,3246,3254,3357,3254,3337,3318,91,72,88,372
20150812,3337,3318,3383,3517,3369,3517,3464,199,146,98,372
20150813,3517,3464,3536,3550,3480,3504,3524,40,60,72,380
20150814,3504,3524,3485,3485,3481,3483,3482,-41,-42,34,372
20150817,3483,3482,3498,3520,3433,3436,3466,-46,-16,22,370
20150818,3436,3466,3445,3445,3440,3440,3443,-26,-23,14,374
20150819,3440,3443,3405,3406,3370,3406,3389,-37,-54,28,380
20150820,3406,3389,3398,3484,3398,3484,3455,95,66,58,390
20150821,3484,3455,3507,3524,3488,3524,3506,69,51,110,416
20150824,3524,3506,3487,3487,3412,3412,3457,-94,-49,82,418
20150825,3412,3457,3355,3422,3355,3368,3408,-89,-49,230,488
20150826,3368,3408,3380,3380,3331,3333,3360,-75,-48,50,506
20150827,3333,3360,3269,3271,3244,3268,3256,-92,-104,160,474
20150828,3268,3256,3256,3353,3252,3350,3306,94,50,158,392
20150831,3350,3306,3323,3326,3315,3320,3320,14,14,24,382
20150901,3320,3320,3295,3339,3291,3332,3300,12,-20,250,338
20150902,3332,3300,3337,3443,3307,3307,3335,7,35,168,376
20150907,3307,3335,3317,3317,3315,3315,3316,-20,-19,16,378
20150908,3315,3316,3290,3304,3290,3300,3295,-16,-21,16,378
20150909,3300,3295,3334,3368,3314,3337,3340,42,45,82,382
20150910,3337,3340,3317,3317,3299,3299,3308,-41,-32,24,386
20150911,3299,3308,3328,3328,3312,3312,3323,4,15,34,384
20150914,3312,3323,3312,3312,3283,3283,3297,-40,-26,4,386
20150915,3283,3297,,,,3297,3297,0,0,0,386
20150916,3297,3297,3260,3284,3260,3280,3267,-17,-30,260,386
20150917,3280,3267,3331,3360,3331,3351,3348,84,81,14,386
20150918,3351,3348,3366,3389,3366,3380,3384,32,36,44,376
20150921,3380,3384,3404,3404,3378,3390,3386,6,2,128,342
20150922,3390,3386,3390,3390,3390,3390,3390,4,4,2,340
20150923,3390,3390,3343,3368,3335,3340,3342,-50,-48,62,308
20150924,3340,3342,3349,3354,3316,3354,3341,12,-1,52,302
20150925,3354,3341,3345,3394,3345,3385,3379,44,38,26,294
20150928,3385,3379,3385,3385,3343,3346,3370,-33,-9,28,296
20150929,3346,3370,3488,3488,3272,3272,3298,-98,-72,46,304
20150930,3272,3298,3284,3284,3284,3284,3284,-14,-14,2,302
20151008,3284,3284,3466,3466,3456,3456,3460,172,176,60,292
20151009,3456,3460,3429,3459,3429,3450,3451,-10,-9,218,292
20151012,3450,3451,3448,3476,3447,3469,3455,18,4,144,364
20151013,3469,3455,3459,3470,3421,3430,3445,-25,-10,222,488
20151014,3430,3445,3435,3470,3435,3462,3453,17,8,590,850
20151015,3462,3453,3480,3480,3466,3473,3473,20,20,260,1028
20151016,3473,3473,3447,3465,3399,3442,3440,-31,-33,854,1634
20151019,3442,3440,3448,3455,3415,3421,3426,-19,-14,902,2210
20151020,3421,3426,3406,3420,3406,3420,3413,-6,-13,114,2324
20151021,3420,3413,3438,3448,3408,3408,3428,-5,15,342,2454
20151022,3408,3428,3392,3409,3390,3409,3396,-19,-32,298,2678
20151023,3409,3396,3403,3449,3398,3444,3425,48,29,486,3038
20151026,3444,3425,3439,3439,3405,3412,3411,-13,-14,734,3654
20151027,3412,3411,3414,3424,3405,3420,3418,9,7,738,4176
20151028,3420,3418,3421,3442,3261,3435,3423,17,5,1202,5034
20151029,3435,3423,3478,3480,3415,3415,3425,-8,2,406,5370
20151030,3415,3425,3402,3402,3380,3396,3389,-29,-36,538,5700
20151102,3396,3389,3372,3377,3369,3376,3373,-13,-16,188,5848
20151103,3376,3373,3362,3375,3355,3375,3369,2,-4,1432,6984
20151104,3375,3369,3347,3350,3347,3350,3348,-19,-21,12,6988
20151105,3350,3348,3335,3335,3300,3303,3309,-45,-39,668,6976
20151106,3303,3309,3294,3307,3294,3307,3296,-2,-13,20,6980
20151109,3307,3296,3304,3314,3265,3272,3272,-24,-24,384,7096
20151110,3272,3272,3245,3250,3242,3244,3246,-28,-26,244,7036
20151111,3244,3246,3225,3266,3225,3260,3230,14,-16,168,6896
20151112,3260,3230,3239,3243,3237,3240,3242,10,12,364,6564
20151113,3240,3242,3230,3235,3230,3235,3234,-7,-8,52,6568
20151116,3235,3234,3254,3283,3254,3283,3255,49,21,144,6568
ag1512,20150105,3552,3548,3517,3539,3517,3533,3529,-15,-19,296,860
20150106,3533,3529,3699,3699,3490,3586,3540,57,11,988,1204
20150107,3586,3540,3577,3621,3561,3588,3587,48,47,702,1234
20150108,3588,3587,3576,3608,3572,3580,3589,-7,2,582,1354
20150109,3580,3589,3600,3615,3580,3590,3591,1,2,472,1480
20150112,3590,3591,3567,3638,3553,3632,3610,41,19,866,1620
20150113,3632,3610,3608,3676,3601,3649,3637,39,27,886,1642
20150114,3649,3637,3675,3700,3606,3637,3651,0,14,1952,2366
20150115,3637,3651,3552,3666,3552,3600,3631,-51,-20,1168,2314
20150116,3600,3631,3675,3690,3645,3673,3662,42,31,1592,2660
20150119,3673,3662,3667,3805,3667,3786,3763,124,101,3492,4106
20150120,3786,3763,3791,3819,3771,3795,3795,32,32,1804,4450
20150121,3795,3795,3820,3955,3820,3932,3861,137,66,9610,8414
20150122,3932,3861,3920,3969,3838,3854,3887,-7,26,12958,14326
20150123,3854,3887,3873,3918,3854,3896,3895,9,8,4594,15712
20150126,3896,3895,3898,3932,3856,3897,3905,2,10,1660,15910
20150127,3897,3905,3883,3890,3811,3859,3838,-46,-67,2684,16360
20150128,3859,3838,3875,3875,3838,3858,3851,20,13,1748,16844
20150129,3858,3851,3860,3865,3792,3800,3817,-51,-34,8664,16808
20150130,3800,3817,3765,3765,3606,3613,3648,-204,-169,9316,16968
20150202,3613,3648,3620,3710,3596,3668,3651,20,3,5120,17024
20150203,3668,3651,3661,3718,3645,3711,3678,60,27,3764,17334
20150204,3711,3678,3711,3713,3655,3688,3685,10,7,4234,18338
20150205,3688,3685,3710,3749,3694,3716,3721,31,36,3310,18396
20150206,3716,3721,3696,3718,3674,3709,3699,-12,-22,3858,18110
20150209,3709,3699,3712,3728,3604,3630,3638,-69,-61,11502,17878
20150210,3630,3638,3637,3666,3632,3652,3648,14,10,2468,17884
20150211,3652,3648,3639,3670,3632,3657,3650,9,2,2276,18008
20150212,3657,3650,3650,3655,3598,3624,3623,-26,-27,5668,18422
20150213,3624,3623,3632,3683,3615,3672,3643,49,20,4790,18514
20150216,3672,3643,3658,3736,3658,3727,3712,84,69,5050,18242
20150217,3727,3712,3727,3729,3698,3716,3715,4,3,2532,18290
20150225,3716,3715,3651,3651,3614,3625,3628,-90,-87,5048,18212
20150226,3625,3628,3622,3650,3617,3642,3634,14,6,6922,19812
20150227,3642,3634,3654,3667,3627,3645,3646,11,12,7964,19086
20150302,3645,3646,3636,3684,3625,3673,3657,27,11,7220,20278
20150303,3673,3657,3663,3675,3535,3625,3607,-32,-50,15960,20962
20150304,3625,3607,3634,3642,3592,3597,3610,-10,3,11158,22284
20150305,3597,3610,3600,3605,3554,3571,3580,-39,-30,15838,24572
20150306,3571,3580,3568,3597,3552,3567,3572,-13,-8,8414,25656
20150309,3567,3572,3577,3577,3470,3505,3506,-67,-66,20360,27752
20150310,3505,3506,3500,3505,3462,3464,3486,-42,-20,11534,29748
20150311,3464,3486,3477,3500,3473,3487,3486,1,0,8756,30678
20150312,3487,3486,3474,3497,3416,3490,3450,4,-36,24158,33878
20150313,3490,3450,3480,3509,3465,3480,3488,30,38,16546,31834
20150316,3480,3488,3485,3514,3460,3506,3483,18,-5,20396,31146
20150317,3506,3483,3487,3509,3467,3480,3486,-3,3,11524,31818
20150318,3480,3486,3467,3498,3438,3457,3469,-29,-17,18830,32550
20150319,3457,3469,3457,3573,3400,3543,3521,74,52,29486,33218
20150320,3543,3521,3522,3572,3522,3553,3550,32,29,19028,35902
20150323,3553,3550,3559,3686,3559,3675,3641,125,91,50768,36518
20150324,3675,3641,3680,3737,3680,3716,3711,75,70,32952,42422
20150325,3716,3711,3729,3734,3679,3695,3700,-16,-11,25420,44412
20150326,3695,3700,3729,3749,3693,3736,3719,36,19,25984,46862
20150327,3736,3719,3721,3729,3691,3717,3713,-2,-6,30596,49924
20150330,3717,3713,3724,3724,3663,3669,3685,-44,-28,30918,53808
20150331,3669,3685,3650,3663,3605,3610,3638,-75,-47,25852,57894
20150401,3610,3638,3625,3649,3602,3626,3629,-12,-9,19172,57830
20150402,3626,3629,3636,3692,3631,3685,3667,56,38,39170,58854
20150403,3685,3667,3660,3668,3629,3657,3648,-10,-19,19604,60656
20150407,3657,3648,3661,3692,3660,3680,3681,32,33,9532,61578
20150408,3680,3681,3662,3686,3662,3679,3675,-2,-6,12494,62692
20150409,3679,3675,3666,3679,3552,3567,3607,-108,-68,44652,71998
20150410,3567,3607,3566,3578,3533,3566,3554,-41,-53,29774,74784
20150413,3566,3554,3580,3637,3580,3606,3608,52,54,43308,74418
20150414,3606,3608,3602,3610,3545,3569,3576,-39,-32,38722,74988
20150415,3569,3576,3550,3603,3550,3561,3573,-15,-3,55908,89452
20150416,3561,3573,3559,3610,3553,3598,3583,25,10,52438,94706
20150417,3598,3583,3608,3617,3552,3564,3572,-19,-11,60734,104014
20150420,3564,3572,3565,3607,3564,3606,3580,34,8,39532,102362
20150421,3606,3580,3563,3564,3514,3519,3529,-61,-51,77110,122868
20150422,3519,3529,3527,3560,3519,3542,3532,13,3,68028,136936
20150423,3542,3532,3528,3529,3470,3484,3493,-48,-39,113186,170230
20150424,3484,3493,3493,3527,3488,3518,3507,25,14,109112,194964
20150427,3518,3507,3503,3542,3478,3522,3513,15,6,194074,251734
20150428,3522,3513,3536,3655,3530,3648,3619,135,106,266538,263524
20150429,3648,3619,3663,3682,3628,3644,3657,25,38,255112,269626
20150430,3644,3657,3650,3692,3636,3647,3659,-10,2,198308,289166
20150504,3647,3659,3591,3625,3567,3612,3592,-47,-67,163804,304628
20150505,3612,3592,3632,3690,3608,3623,3645,31,53,261840,310670
20150506,3623,3645,3660,3678,3642,3651,3659,6,14,354700,349198
20150507,3651,3659,3670,3674,3609,3615,3643,-44,-16,360026,352860
20150508,3615,3643,3593,3639,3583,3627,3614,-16,-29,314788,370332
20150511,3627,3614,3633,3660,3609,3630,3634,16,20,429510,375486
20150512,3630,3634,3635,3657,3572,3604,3615,-30,-19,564326,377052
20150513,3604,3615,3635,3687,3612,3680,3641,65,26,808636,456018
20150514,3680,3641,3788,3790,3722,3768,3754,127,113,1579674,530332
20150515,3768,3754,3780,3808,3755,3784,3782,30,28,1363988,477284
20150518,3784,3782,3781,3867,3770,3852,3810,70,28,1328736,546596
20150519,3852,3810,3852,3859,3782,3802,3825,-8,15,1219326,481676
20150520,3802,3825,3770,3775,3644,3687,3704,-138,-121,1786804,363076
20150521,3687,3704,3695,3734,3690,3716,3713,12,9,1035726,356510
20150522,3716,3713,3691,3737,3683,3721,3713,8,0,906614,377088
20150525,3721,3713,3705,3717,3670,3704,3696,-9,-17,857864,374590
20150526,3704,3696,3700,3745,3654,3657,3704,-39,8,960868,411440
20150527,3657,3704,3634,3684,3625,3665,3659,-39,-45,905320,409152
20150528,3665,3659,3643,3674,3633,3657,3656,-2,-3,816096,420546
20150529,3657,3656,3661,3665,3621,3655,3648,-1,-8,906320,418478
20150601,3655,3648,3660,3675,3641,3647,3659,-1,11,746350,429702
20150602,3647,3659,3654,3732,3648,3664,3690,5,31,1595452,434062
20150603,3664,3690,3654,3695,3654,3668,3678,-22,-12,898340,440310
20150604,3668,3678,3648,3664,3608,3619,3640,-59,-38,1052946,463276
20150605,3619,3640,3605,3615,3560,3564,3584,-76,-56,1178526,513888
20150608,3564,3584,3550,3582,3537,3572,3560,-12,-24,1141656,551358
20150609,3572,3560,3564,3577,3550,3566,3564,6,4,713624,585978
20150610,3566,3564,3572,3585,3553,3574,3569,10,5,733544,616680
20150611,3574,3569,3595,3596,3556,3558,3574,-11,5,682574,634448
20150612,3558,3574,3569,3575,3520,3562,3556,-12,-18,954912,624804
20150615,3562,3556,3540,3561,3532,3554,3549,-2,-7,732592,629868
20150616,3554,3549,3548,3591,3545,3577,3568,28,19,938338,618256
20150617,3577,3568,3567,3571,3526,3543,3549,-25,-19,796382,625158
20150618,3543,3549,3550,3602,3537,3586,3565,37,16,1195098,604526
20150619,3586,3565,3620,3630,3564,3573,3598,8,33,1170000,569242
20150623,3573,3598,3573,3582,3545,3547,3563,-51,-35,336396,589392
20150624,3547,3563,3530,3540,3470,3505,3502,-58,-61,1156272,640602
20150625,3505,3502,3501,3513,3485,3494,3501,-8,-1,764046,627222
20150626,3494,3501,3490,3502,3449,3456,3485,-45,-16,716220,645746
20150629,3456,3485,3465,3511,3438,3480,3472,-5,-13,858156,602846
20150630,3480,3472,3489,3495,3393,3446,3446,-26,-26,1020996,611362
20150701,3446,3446,3436,3491,3408,3437,3444,-9,-2,1202886,622706
20150702,3437,3444,3438,3466,3417,3429,3436,-15,-8,766544,628262
20150703,3429,3436,3456,3479,3438,3464,3455,28,19,799520,607458
20150706,3464,3455,3473,3474,3423,3439,3448,-16,-7,594826,607654
20150707,3439,3448,3439,3482,3415,3439,3443,-9,-5,756348,589178
20150708,3439,3443,3416,3418,3236,3236,3284,-207,-159,1890404,587930
20150709,3236,3284,3222,3428,3200,3381,3313,97,29,1837522,429516
20150710,3381,3313,3390,3418,3363,3385,3387,72,74,1114704,435878
20150713,3385,3387,3387,3425,3364,3384,3393,-3,6,951406,439522
20150714,3384,3393,3375,3383,3264,3348,3355,-45,-38,1126164,474902
20150715,3348,3355,3355,3378,3339,3350,3358,-5,3,609924,469360
20150716,3350,3358,3330,3330,3274,3299,3296,-59,-62,1076814,517138
20150717,3299,3296,3260,3330,3248,3282,3287,-14,-9,834966,514584
20150720,3282,3287,3250,3274,3182,3259,3236,-28,-51,1450470,551644
20150721,3259,3236,3238,3308,3225,3255,3263,19,27,1513836,551180
20150722,3255,3263,3260,3290,3216,3241,3259,-22,-4,1096848,564870
20150723,3241,3259,3235,3269,3227,3256,3250,-3,-9,1013276,580014
20150724,3256,3250,3255,3267,3188,3219,3231,-31,-19,1186810,598618
20150727,3219,3231,3200,3243,3150,3239,3209,8,-22,1497536,606118
20150728,3239,3209,3221,3241,3203,3221,3223,12,14,1012566,593490
20150729,3221,3223,3221,3250,3218,3235,3233,12,10,709150,585096
20150730,3235,3233,3233,3279,3215,3223,3247,-10,14,1242198,582506
20150731,3223,3247,3231,3255,3217,3219,3238,-28,-9,864652,583400
20150803,3219,3238,3239,3285,3229,3246,3253,8,15,1047254,569222
20150804,3246,3253,3234,3242,3168,3208,3208,-45,-45,1031718,641942
20150805,3208,3208,3218,3222,3191,3199,3206,-9,-2,629832,647668
20150806,3199,3206,3215,3226,3191,3208,3208,2,2,656680,630576
20150807,3208,3208,3200,3247,3198,3242,3218,34,10,751408,602422
20150810,3242,3218,3218,3274,3212,3263,3250,45,32,1336552,592580
20150811,3263,3250,3258,3389,3257,3361,3334,111,84,2547806,629066
20150812,3361,3334,3378,3534,3359,3526,3431,192,97,2777698,635964
20150813,3526,3431,3556,3563,3485,3513,3523,82,92,2347042,535850
20150814,3513,3523,3493,3513,3481,3501,3497,-22,-26,1231488,537492
20150817,3501,3497,3505,3535,3430,3460,3470,-37,-27,2054958,504198
20150818,3460,3470,3465,3476,3443,3448,3459,-22,-11,923578,488284
20150819,3448,3459,3420,3424,3365,3419,3392,-40,-67,1519740,506528
20150820,3419,3392,3414,3505,3411,3485,3462,93,70,1710848,513308
20150821,3485,3462,3502,3544,3489,3499,3513,37,51,1887490,513666
20150824,3499,3513,3490,3506,3414,3427,3459,-86,-54,2584172,483962
20150825,3427,3459,3355,3444,3345,3367,3402,-92,-57,2473734,465660
20150826,3367,3402,3399,3412,3316,3318,3366,-84,-36,1849336,474912
20150827,3318,3366,3275,3293,3236,3280,3263,-86,-103,1569930,453642
20150828,3280,3263,3260,3366,3255,3339,3321,76,58,1953862,420528
20150831,3339,3321,3326,3369,3307,3332,3338,11,17,1509230,410518
20150901,3332,3338,3321,3360,3301,3333,3328,-5,-10,1042540,409418
20150902,3333,3328,3332,3363,3316,3324,3334,-4,6,1053868,395636
20150907,3324,3334,3325,3342,3313,3319,3327,-15,-7,274768,405316
20150908,3319,3327,3315,3326,3295,3323,3309,-4,-18,790686,413168
20150909,3323,3309,3345,3395,3327,3332,3360,23,51,1826396,373444
20150910,3332,3360,3333,3339,3305,3333,3323,-27,-37,1121444,373722
20150911,3333,3323,3338,3358,3321,3328,3337,5,14,1069886,389784
20150914,3328,3337,3315,3329,3271,3302,3299,-35,-38,1431436,408486
20150915,3302,3299,3291,3305,3284,3287,3294,-12,-5,741524,429864
20150916,3287,3294,3294,3315,3274,3307,3290,13,-4,812624,411664
20150917,3307,3290,3348,3381,3337,3366,3360,76,70,1438078,392582
20150918,3366,3360,3364,3448,3355,3394,3393,34,33,1679856,399066
20150921,3394,3393,3450,3453,3390,3419,3413,26,20,1103882,398304
20150922,3419,3413,3408,3426,3402,3407,3411,-6,-2,436048,403180
20150923,3407,3411,3350,3373,3340,3357,3357,-54,-54,633094,376520
20150924,3357,3357,3362,3381,3350,3368,3366,11,9,401002,386150
20150925,3368,3366,3360,3417,3357,3391,3395,25,29,787468,400568
20150928,3391,3395,3390,3400,3352,3354,3375,-41,-20,217100,391014
20150929,3354,3375,3324,3327,3273,3286,3305,-89,-70,641526,384110
20150930,3286,3305,3305,3316,3290,3292,3303,-13,-2,365528,351852
20151008,3292,3303,3559,3559,3454,3467,3484,164,181,513814,346412
20151009,3467,3484,3430,3485,3429,3469,3458,-15,-26,733804,379184
20151012,3469,3458,3493,3496,3451,3489,3470,31,12,705888,400162
20151013,3489,3470,3486,3501,3432,3448,3463,-22,-7,621122,396600
20151014,3448,3463,3457,3494,3450,3478,3474,15,11,667046,428026
20151015,3478,3474,3479,3508,3474,3477,3490,3,16,720162,437984
20151016,3477,3490,3468,3483,3449,3449,3466,-41,-24,622714,439894
20151019,3449,3466,3460,3475,3428,3435,3450,-31,-16,546388,430384
20151020,3435,3450,3440,3460,3414,3440,3429,-10,-21,512586,427788
20151021,3440,3429,3439,3454,3414,3418,3435,-11,6,595040,433688
20151022,3418,3435,3424,3435,3402,3433,3414,-2,-21,577678,419752
20151023,3433,3414,3424,3469,3416,3468,3435,54,21,713716,443824
20151026,3468,3435,3468,3468,3420,3435,3434,0,-1,573794,415254
20151027,3435,3434,3438,3447,3424,3438,3436,4,2,397592,417466
20151028,3438,3436,3428,3462,3423,3453,3444,17,8,522540,419594
20151029,3453,3444,3467,3515,3432,3437,3479,-7,35,1311832,389144
20151030,3437,3479,3425,3435,3396,3406,3413,-73,-66,767574,358634
20151102,3406,3413,3388,3404,3383,3390,3392,-23,-21,388510,340924
20151103,3390,3392,3387,3392,3368,3385,3381,-7,-11,328622,330308
20151104,3385,3381,3377,3382,3353,3364,3366,-17,-15,384406,318538
20151105,3364,3366,3367,3377,3313,3318,3345,-48,-21,491200,326166
20151106,3318,3345,3315,3329,3300,3323,3314,-22,-31,409690,308918
20151109,3323,3314,3325,3332,3262,3288,3289,-26,-25,654342,294692
20151110,3288,3289,3289,3289,3241,3258,3264,-31,-25,436342,282128
20151111,3258,3264,3252,3271,3231,3262,3249,-2,-15,416942,273100
20151112,3262,3249,3259,3259,3234,3255,3249,6,0,269162,271644
20151113,3255,3249,3244,3275,3226,3250,3249,1,0,565376,260014
20151116,3250,3249,3248,3284,3243,3278,3263,29,14,447840,245634
20151117,3278,3263,3278,3278,3206,3227,3244,-36,-19,441080,223512
20151118,3227,3244,3228,3248,3210,3230,3226,-14,-18,364644,208602
20151119,3230,3226,3224,3238,3200,3234,3220,8,-6,306342,194960
20151120,3234,3220,3223,3250,3208,3241,3233,21,13,282004,176180
20151123,3241,3233,3241,3252,3135,3176,3199,-57,-34,287122,152162
20151124,3176,3199,3165,3191,3145,3177,3168,-22,-31,157968,138044
20151125,3177,3168,3180,3218,3172,3198,3194,30,26,126696,121784
20151126,3198,3194,3186,3218,3170,3193,3190,-1,-4,99194,99272
20151127,3193,3190,3202,3206,3164,3169,3185,-21,-5,68460,77732
20151130,3169,3185,3175,3178,3135,3138,3147,-47,-38,62576,58414
ag1601,20150116,3631,3631,,,,3631,3631,0,0,0,0
20150119,3631,3631,3768,3851,3768,3797,3793,166,162,20,8
20150120,3797,3793,3801,3808,3786,3808,3798,15,5,12,8
20150121,3808,3798,3840,3950,3838,3945,3940,147,142,90,92
20150122,3945,3940,3949,3949,3870,3890,3890,-50,-50,108,32
20150123,3890,3890,3890,3917,3890,3901,3906,11,16,34,38
20150126,3901,3906,3869,3920,3816,3915,3895,9,-11,30,32
20150127,3915,3895,,,,3895,3895,0,0,0,32
20150128,3895,3895,3843,3889,3843,3867,3862,-28,-33,12,34
20150129,3867,3862,3850,3850,3850,3850,3850,-12,-12,2,36
20150130,3850,3850,3744,3744,3619,3619,3643,-231,-207,24,52
20150202,3619,3643,3611,3689,3611,3689,3646,46,3,16,58
20150203,3689,3646,3655,3700,3655,3700,3675,54,29,10,56
20150204,3700,3675,3690,3690,3672,3690,3683,15,8,14,64
20150205,3690,3683,3721,3743,3712,3742,3732,59,49,28,60
20150206,3742,3732,,,,3731,3731,-1,-1,0,60
20150209,3731,3731,3642,3647,3630,3646,3641,-85,-90,24,62
20150210,3646,3641,3662,3667,3661,3661,3664,20,23,22,58
20150211,3661,3664,,,,3664,3664,0,0,0,58
20150212,3664,3664,3662,3663,3613,3625,3643,-39,-21,12,66
20150213,3625,3643,3662,3681,3629,3669,3659,26,16,16,70
20150216,3669,3659,3724,3742,3712,3727,3725,68,66,116,122
20150217,3727,3725,3718,3718,3718,3718,3718,-7,-7,2,122
20150225,3718,3718,3641,3656,3633,3634,3639,-84,-79,34,138
20150226,3634,3639,3650,3654,3650,3654,3652,15,13,4,138
20150227,3654,3652,3675,3675,3649,3649,3664,-3,12,14,134
20150302,3649,3664,3649,3686,3635,3682,3668,18,4,56,126
20150303,3682,3668,3657,3657,3558,3650,3609,-18,-59,84,134
20150304,3650,3609,3634,3650,3608,3614,3618,5,9,44,142
20150305,3614,3618,3597,3605,3579,3579,3592,-39,-26,60,148
20150306,3579,3592,3589,3597,3562,3567,3579,-25,-13,42,140
20150309,3567,3579,3555,3562,3488,3515,3513,-64,-66,132,186
20150310,3515,3513,3505,3507,3494,3494,3503,-19,-10,28,182
20150311,3494,3503,3487,3500,3487,3490,3493,-13,-10,20,190
20150312,3490,3493,3483,3509,3430,3509,3458,16,-35,94,204
20150313,3509,3458,3492,3510,3484,3499,3491,41,33,44,200
20150316,3499,3491,3489,3520,3478,3518,3498,27,7,30,194
20150317,3518,3498,3483,3495,3483,3487,3489,-11,-9,18,200
20150318,3487,3489,3481,3481,3466,3466,3475,-23,-14,10,200
20150319,3466,3475,3476,3579,3466,3544,3541,69,66,58,186
20150320,3544,3541,3548,3571,3542,3562,3556,21,15,38,186
20150323,3562,3556,3575,3680,3575,3673,3661,117,105,186,280
20150324,3673,3661,3704,3748,3704,3727,3719,66,58,84,250
20150325,3727,3719,3705,3712,3693,3696,3702,-23,-17,10,250
20150326,3696,3702,3725,3735,3710,3735,3720,33,18,20,248
20150327,3735,3720,3730,3730,3716,3724,3719,4,-1,46,258
20150330,3724,3719,3721,3721,3677,3677,3698,-42,-21,46,260
20150331,3677,3698,3667,3674,3626,3626,3650,-72,-48,98,220
20150401,3626,3650,3650,3657,3617,3638,3640,-12,-10,50,222
20150402,3638,3640,3650,3713,3650,3693,3685,53,45,62,228
20150403,3693,3685,3675,3675,3646,3656,3653,-29,-32,68,234
20150407,3656,3653,3696,3701,3688,3699,3696,46,43,48,224
20150408,3699,3696,3692,3693,3676,3693,3686,-3,-10,36,224
20150409,3693,3686,3689,3689,3572,3580,3615,-106,-71,314,216
20150410,3580,3615,3573,3579,3552,3568,3564,-47,-51,162,242
20150413,3568,3564,3597,3627,3597,3616,3612,52,48,40,238
20150414,3616,3612,3619,3619,3562,3575,3594,-37,-18,356,306
20150415,3575,3594,3585,3611,3549,3572,3584,-22,-10,94,290
20150416,3572,3584,3574,3612,3565,3606,3595,22,11,88,312
20150417,3606,3595,3619,3619,3562,3575,3583,-20,-12,150,298
20150420,3575,3583,3588,3600,3584,3600,3589,17,6,46,298
20150421,3600,3589,3566,3566,3528,3528,3544,-61,-45,76,306
20150422,3528,3544,3535,3571,3532,3550,3542,6,-2,116,332
20150423,3550,3542,3538,3563,3483,3496,3507,-46,-35,448,456
20150424,3496,3507,3496,3530,3496,3524,3514,17,7,376,502
20150427,3524,3514,3515,3618,3490,3527,3525,13,11,288,480
20150428,3527,3525,3573,3664,3541,3651,3633,126,108,596,490
20150429,3651,3633,3658,3686,3640,3649,3667,16,34,206,458
20150430,3649,3667,3666,3696,3648,3664,3671,-3,4,134,466
20150504,3664,3671,3589,3634,3578,3630,3604,-41,-67,256,544
20150505,3630,3604,3663,3685,3628,3632,3656,28,52,198,560
20150506,3632,3656,3674,3683,3657,3663,3672,7,16,346,672
20150507,3663,3672,3680,3685,3620,3625,3648,-47,-24,150,648
20150508,3625,3648,3604,3640,3599,3640,3623,-8,-25,102,662
20150511,3640,3623,3674,3674,3621,3638,3648,15,25,394,592
20150512,3638,3648,3648,3661,3588,3617,3620,-31,-28,208,632
20150513,3617,3620,3648,3737,3628,3737,3655,117,35,210,620
20150514,3737,3655,3765,3783,3732,3770,3758,115,103,632,518
20150515,3770,3758,3779,3815,3770,3788,3790,30,32,396,504
20150518,3788,3790,3801,3874,3781,3858,3831,68,41,724,534
20150519,3858,3831,3860,3866,3795,3810,3825,-21,-6,640,566
20150520,3810,3825,3764,3781,3660,3702,3727,-123,-98,564,532
20150521,3702,3727,3711,3751,3708,3729,3728,2,1,586,614
20150522,3729,3728,3707,3745,3701,3735,3727,7,-1,398,628
20150525,3735,3727,3704,3720,3689,3716,3707,-11,-20,304,626
20150526,3716,3707,3716,3750,3674,3675,3710,-32,3,574,690
20150527,3675,3710,3652,3695,3645,3678,3675,-32,-35,752,714
20150528,3678,3675,3664,3681,3649,3669,3668,-6,-7,546,698
20150529,3669,3668,3661,3685,3639,3674,3666,6,-2,286,700
20150601,3674,3666,3676,3688,3658,3660,3669,-6,3,476,814
20150602,3660,3669,3657,3742,3657,3678,3705,9,36,1012,824
20150603,3678,3705,3689,3705,3680,3684,3692,-21,-13,716,942
20150604,3684,3692,3663,3676,3621,3629,3641,-63,-51,532,1008
20150605,3629,3641,3625,3625,3576,3580,3596,-61,-45,762,1070
20150608,3580,3596,3570,3593,3552,3586,3576,-10,-20,554,1124
20150609,3586,3576,3575,3593,3563,3576,3578,0,2,972,1398
20150610,3576,3578,3587,3595,3569,3583,3580,5,2,698,1648
20150611,3583,3580,3605,3607,3570,3570,3584,-10,4,502,1698
20150612,3570,3584,3578,3584,3372,3573,3555,-11,-29,1150,1818
20150615,3573,3555,3547,3569,3543,3561,3557,6,2,866,1956
20150616,3561,3557,3561,3596,3557,3584,3574,27,17,442,1974
20150617,3584,3574,3555,3668,3535,3551,3557,-23,-17,520,1910
20150618,3551,3557,3557,3605,3546,3590,3574,33,17,696,1854
20150619,3590,3574,3643,3644,3571,3586,3597,12,23,1026,1926
20150623,3586,3597,3584,3589,3554,3554,3571,-43,-26,568,2010
20150624,3554,3571,3543,3549,3496,3511,3512,-60,-59,1602,2156
20150625,3511,3512,3511,3519,3496,3506,3510,-6,-2,1130,2256
20150626,3506,3510,3497,3509,3463,3466,3491,-44,-19,826,2310
20150629,3466,3491,3477,3517,3451,3493,3479,2,-12,1032,2300
20150630,3493,3479,3498,3502,3406,3448,3453,-31,-26,590,2258
20150701,3448,3453,3446,3495,3420,3448,3457,-5,4,600,2272
20150702,3448,3457,3440,3460,3430,3440,3442,-17,-15,490,2280
20150703,3440,3442,3464,3487,3425,3472,3464,30,22,746,2294
20150706,3472,3464,3476,3476,3432,3448,3456,-16,-8,500,2296
20150707,3448,3456,3443,3483,3427,3449,3450,-7,-6,422,2252
20150708,3449,3450,3401,3411,3243,3243,3292,-207,-158,1798,2340
20150709,3243,3292,3193,3427,3193,3392,3326,100,34,3024,2266
20150710,3392,3326,3450,3450,3365,3387,3393,61,67,1858,2316
20150713,3387,3393,3393,3427,3371,3385,3395,-8,2,1076,2310
20150714,3385,3395,3374,3386,3329,3356,3360,-39,-35,1796,2318
20150715,3356,3360,3362,3383,3349,3355,3364,-5,4,552,2264
20150716,3355,3364,3322,3329,3287,3309,3305,-55,-59,1782,2292
20150717,3309,3305,3261,3330,3261,3293,3295,-12,-10,874,2302
20150720,3293,3295,3273,3282,3196,3268,3240,-27,-55,2118,2638
20150721,3268,3240,3246,3316,3237,3268,3271,28,31,1214,2662
20150722,3268,3271,3276,3300,3230,3250,3267,-21,-4,952,2548
20150723,3250,3267,3247,3280,3245,3266,3264,-1,-3,344,2472
20150724,3266,3264,3272,3275,3201,3230,3240,-34,-24,1318,2546
20150727,3230,3240,3211,3251,3179,3241,3221,1,-19,2450,2700
20150728,3241,3221,3230,3245,3215,3230,3227,9,6,1040,2656
20150729,3230,3227,3232,3257,3228,3248,3244,21,17,950,2554
20150730,3248,3244,3244,3282,3228,3237,3260,-7,16,1382,2562
20150731,3237,3260,3247,3262,3227,3228,3247,-32,-13,738,2596
20150803,3228,3247,3250,3294,3242,3254,3264,7,17,1278,2548
20150804,3254,3264,3241,3250,3183,3220,3218,-44,-46,1264,2704
20150805,3220,3218,3245,3245,3204,3213,3219,-5,1,884,2880
20150806,3213,3219,3221,3236,3206,3220,3219,1,0,596,2820
20150807,3220,3219,3212,3252,3212,3249,3230,30,11,666,2744
20150810,3249,3230,3226,3280,3226,3274,3259,44,29,1748,2742
20150811,3274,3259,3258,3394,3258,3363,3349,104,90,5070,2770
20150812,3363,3349,3377,3536,3370,3530,3449,181,100,10108,3976
20150813,3530,3449,3564,3574,3489,3513,3522,64,73,13824,3402
20150814,3513,3522,3493,3516,3487,3506,3500,-16,-22,4108,3282
20150817,3506,3500,3511,3538,3440,3469,3474,-31,-26,8420,3298
20150818,3469,3474,3474,3481,3449,3451,3465,-23,-9,3608,3066
20150819,3451,3465,3430,3430,3374,3425,3400,-40,-65,5192,2894
20150820,3425,3400,3421,3509,3419,3492,3468,92,68,6118,3040
20150821,3492,3468,3499,3548,3494,3503,3517,35,49,8554,3770
20150824,3503,3517,3496,3509,3419,3428,3463,-89,-54,11822,3670
20150825,3428,3463,3391,3449,3350,3371,3408,-92,-55,12566,3574
20150826,3371,3408,3405,3415,3324,3324,3372,-84,-36,9466,3650
20150827,3324,3372,3291,3299,3244,3288,3271,-84,-101,6992,3728
20150828,3288,3271,3279,3373,3265,3346,3327,75,56,10146,3426
20150831,3346,3327,3341,3377,3313,3336,3348,9,21,7904,3210
20150901,3336,3348,3335,3364,3308,3338,3335,-10,-13,3726,3212
20150902,3338,3335,3338,3369,3322,3331,3340,-4,5,4580,3250
20150907,3331,3340,3336,3347,3322,3327,3334,-13,-6,1194,3216
20150908,3327,3334,3322,3333,3304,3330,3317,-4,-17,2396,3312
20150909,3330,3317,3355,3401,3333,3337,3368,20,51,10430,3352
20150910,3337,3368,3337,3346,3313,3343,3330,-25,-38,6812,3820
20150911,3343,3330,3348,3366,3331,3336,3347,6,17,6646,3888
20150914,3336,3347,3326,3337,3280,3314,3309,-33,-38,10648,4940
20150915,3314,3309,3303,3314,3297,3302,3306,-7,-3,4684,5332
20150916,3302,3306,3305,3324,3289,3320,3303,14,-3,4816,4994
20150917,3320,3303,3341,3396,3341,3381,3371,78,68,10220,5206
20150918,3381,3371,3381,3456,3368,3408,3406,37,35,10616,5178
20150921,3408,3406,3442,3472,3403,3432,3426,26,20,7500,4744
20150922,3432,3426,3430,3437,3415,3417,3423,-9,-3,3490,4658
20150923,3417,3423,3369,3384,3352,3369,3369,-54,-54,4002,4906
20150924,3369,3369,3372,3392,3363,3379,3378,10,9,2566,4912
20150925,3379,3378,3388,3425,3373,3401,3404,23,26,4278,4326
20150928,3401,3404,3403,3408,3364,3364,3388,-40,-16,1154,4174
20150929,3364,3388,3345,3345,3287,3297,3316,-91,-72,4386,4240
20150930,3297,3316,3320,3328,3303,3307,3316,-9,0,1594,4052
20151008,3307,3316,3500,3559,3460,3475,3490,159,174,4598,3990
20151009,3475,3490,3460,3493,3440,3477,3464,-13,-26,4710,4320
20151012,3477,3464,3489,3504,3460,3495,3479,31,15,6816,4272
20151013,3495,3479,3492,3505,3441,3457,3467,-22,-12,3536,4080
20151014,3457,3467,3461,3500,3459,3485,3480,18,13,3474,4250
20151015,3485,3480,3488,3510,3272,3485,3494,5,14,6058,4440
20151016,3485,3494,3480,3490,3458,3462,3475,-32,-19,2868,4324
20151019,3462,3475,3470,3483,3437,3442,3454,-33,-21,2982,4268
20151020,3442,3454,3450,3466,3423,3452,3437,-2,-17,2184,4200
20151021,3452,3437,3446,3463,3427,3428,3444,-9,7,2110,4152
20151022,3428,3444,3432,3445,3417,3445,3426,1,-18,2188,4008
20151023,3445,3426,3432,3477,3427,3477,3446,51,20,2564,4050
20151026,3477,3446,3482,3482,3431,3445,3445,-1,-1,2062,3954
20151027,3445,3445,3445,3457,3436,3450,3445,5,0,1534,3800
20151028,3450,3445,3435,3474,3434,3465,3456,20,11,1700,3730
20151029,3465,3456,3471,3525,3446,3451,3489,-5,33,5898,3580
20151030,3451,3489,3437,3449,3414,3420,3428,-69,-61,4128,3676
20151102,3420,3428,3401,3413,3397,3406,3405,-22,-23,3184,3620
20151103,3406,3405,3405,3406,3383,3400,3397,-5,-8,1472,3682
20151104,3400,3397,3390,3575,3369,3381,3399,-16,2,3032,3740
20151105,3381,3399,3389,3393,3330,3334,3356,-65,-43,2792,3810
20151106,3334,3356,3325,3343,3319,3334,3331,-22,-25,2256,4012
20151109,3334,3331,3339,3344,3255,3302,3303,-29,-28,3868,4568
20151110,3302,3303,3303,3303,3260,3272,3281,-31,-22,2388,4520
20151111,3272,3281,3264,3286,3248,3275,3264,-6,-17,2348,4794
20151112,3275,3264,3272,3273,3253,3270,3265,6,1,2408,4812
20151113,3270,3265,3256,3285,3242,3261,3264,-4,-1,2636,4602
20151116,3261,3264,3264,3295,3260,3291,3276,27,12,2742,4872
20151117,3291,3276,3298,3298,3222,3240,3262,-36,-14,5416,5422
20151118,3240,3262,3244,3258,3225,3245,3242,-17,-20,3302,5620
20151119,3245,3242,3235,3250,3216,3244,3236,2,-6,2102,5596
20151120,3244,3236,3240,3263,3221,3255,3247,19,11,2696,5452
20151123,3255,3247,3255,3264,3149,3187,3203,-60,-44,11942,5428
20151124,3187,3203,3185,3202,3158,3186,3180,-17,-23,3252,5438
20151125,3186,3180,3200,3226,3185,3209,3206,29,26,4692,5290
20151126,3209,3206,3205,3229,3181,3201,3204,-5,-2,4530,5916
20151127,3201,3204,3210,3218,3178,3182,3197,-22,-7,3068,6114
20151130,3182,3197,3190,3212,3145,3147,3160,-50,-37,4176,6556
ag1602,20150216,3659,3659,,,,3725,3725,66,66,0,0
20150217,3725,3725,,,,3718,3718,-7,-7,0,0
20150225,3718,3718,3629,3654,3629,3654,3641,-64,-77,4,2
20150226,3654,3641,,,,3654,3654,13,13,0,2
20150227,3654,3654,3688,3688,3688,3688,3688,34,34,4,6
20150302,3688,3688,3660,3684,3623,3684,3655,-4,-33,6,6
20150303,3684,3655,3670,3670,3594,3654,3634,-1,-21,32,10
20150304,3654,3634,3636,3636,3621,3624,3627,-10,-7,10,12
20150305,3624,3627,3596,3596,3596,3596,3596,-31,-31,2,12
20150306,3596,3596,3580,3580,3580,3580,3580,-16,-16,2,14
20150309,3580,3580,3496,3503,3492,3501,3498,-79,-82,8,14
20150310,3501,3498,3503,3503,3503,3503,3503,5,5,2,16
20150311,3503,3503,,,,3503,3503,0,0,0,16
20150312,3503,3503,3462,3465,3462,3465,3462,-38,-41,12,18
20150313,3465,3462,,,,3488,3488,26,26,0,18
20150316,3488,3488,,,,3515,3515,27,27,0,18
20150317,3515,3515,3502,3502,3502,3502,3502,-13,-13,2,20
20150318,3502,3502,3465,3505,3454,3454,3481,-48,-21,8,22
20150319,3454,3481,3489,3583,3489,3564,3556,83,75,18,26
20150320,3564,3556,3565,3565,3565,3565,3565,9,9,2,24
20150323,3565,3565,3596,3596,3596,3596,3596,31,31,2,22
20150324,3596,3596,3730,3730,3710,3719,3722,123,126,14,26
20150325,3719,3722,3708,3719,3706,3711,3713,-11,-9,18,24
20150326,3711,3713,3712,3712,3712,3712,3712,-1,-1,2,24
20150327,3712,3712,3723,3723,3721,3721,3722,9,10,4,24
20150330,3721,3722,3707,3707,3707,3707,3707,-15,-15,2,24
20150331,3707,3707,3660,3675,3648,3648,3662,-59,-45,10,24
20150401,3648,3662,3645,3645,3645,3645,3645,-17,-17,2,26
20150402,3645,3645,3656,3689,3656,3689,3669,44,24,6,24
20150403,3689,3669,3650,3663,3648,3662,3656,-7,-13,10,28
20150407,3662,3656,,,,3692,3692,36,36,0,28
20150408,3692,3692,3701,3701,3701,3701,3701,9,9,2,30
20150409,3701,3701,3681,3681,3618,3618,3650,-83,-51,78,88
20150410,3618,3650,3564,3590,3564,3590,3577,-60,-73,8,88
20150413,3590,3577,3662,3662,3637,3637,3654,60,77,40,86
20150414,3637,3654,3603,3618,3583,3589,3594,-65,-60,164,80
20150415,3589,3594,3601,3624,3588,3588,3597,-6,3,34,78
20150416,3588,3597,3585,3614,3585,3607,3598,10,1,8,78
20150417,3607,3598,3587,3589,3572,3589,3582,-9,-16,6,74
20150420,3589,3582,3599,3600,3590,3600,3593,18,11,28,66
20150421,3600,3593,3554,3554,3554,3554,3554,-39,-39,8,58
20150422,3554,3554,3541,3561,3541,3555,3547,1,-7,14,54
20150423,3555,3547,3494,3494,3494,3494,3494,-53,-53,2,52
20150424,3494,3494,3525,3525,3525,3525,3525,31,31,2,50
20150427,3525,3525,3541,3547,3540,3540,3542,15,17,6,50
20150428,3540,3542,3652,3656,3652,3656,3654,114,112,4,52
20150429,3656,3654,3685,3685,3685,3685,3685,31,31,2,52
20150430,3685,3685,,,,3685,3685,0,0,0,52
20150504,3685,3685,3594,3623,3583,3623,3594,-62,-91,34,54
20150505,3623,3594,3674,3694,3634,3648,3652,54,58,38,58
20150506,3648,3652,3692,3692,3670,3670,3681,18,29,4,58
20150507,3670,3681,3663,3663,3639,3639,3642,-42,-39,18,64
20150508,3639,3642,3642,3642,3639,3641,3640,-1,-2,6,62
20150511,3641,3640,,,,3644,3644,4,4,0,62
20150512,3644,3644,3618,3618,3608,3608,3611,-36,-33,6,66
20150513,3608,3611,3649,3690,3649,3690,3668,79,57,20,60
20150514,3690,3668,3788,3789,3755,3755,3775,87,107,36,60
20150515,3755,3775,3782,3799,3782,3799,3790,24,15,4,58
20150518,3799,3790,3817,3898,3806,3898,3841,108,51,8,58
20150519,3898,3841,3874,3874,3851,3861,3859,20,18,16,56
20150520,3861,3859,3781,3782,3693,3693,3714,-166,-145,132,76
20150521,3693,3714,3740,3745,3736,3745,3740,31,26,6,74
20150522,3745,3740,3703,3746,3703,3725,3718,-15,-22,42,78
20150525,3725,3718,3725,3729,3705,3723,3720,5,2,38,82
20150526,3723,3720,3706,3706,3706,3706,3706,-14,-14,2,84
20150527,3706,3706,3657,3699,3657,3688,3683,-18,-23,34,96
20150528,3688,3683,3677,3683,3649,3675,3669,-8,-14,34,116
20150529,3675,3669,3656,3681,3656,3681,3673,12,4,10,112
20150601,3681,3673,3689,3721,3673,3673,3688,0,15,18,110
20150602,3673,3688,3695,3717,3678,3685,3691,-3,3,16,108
20150603,3685,3691,3699,3699,3699,3699,3699,8,8,2,106
20150604,3699,3699,3676,3676,3651,3651,3662,-48,-37,6,108
20150605,3651,3662,3622,3628,3596,3596,3612,-66,-50,62,116
20150608,3596,3612,3619,3619,3589,3597,3605,-15,-7,12,116
20150609,3597,3605,3588,3608,3588,3595,3593,-10,-12,24,108
20150610,3595,3593,3583,3607,3583,3596,3596,3,3,58,136
20150611,3596,3596,3615,3615,3591,3591,3603,-5,7,98,182
20150612,3591,3603,3587,3590,3565,3580,3582,-23,-21,54,184
20150615,3580,3582,3582,3582,3558,3566,3574,-16,-8,24,194
20150616,3566,3574,3576,3616,3576,3591,3591,17,17,30,186
20150617,3591,3591,3574,3574,3562,3562,3568,-29,-23,4,186
20150618,3562,3568,3584,3619,3584,3619,3592,51,24,38,204
20150619,3619,3592,3643,3643,3591,3607,3611,15,19,16,206
20150623,3607,3611,3573,3590,3573,3573,3577,-38,-34,16,210
20150624,3573,3577,3513,3540,3513,3540,3524,-37,-53,40,212
20150625,3540,3524,3528,3534,3528,3533,3532,9,8,10,210
20150626,3533,3532,3512,3525,3492,3500,3509,-32,-23,24,210
20150629,3500,3509,3472,3517,3472,3508,3508,-1,-1,66,260
20150630,3508,3508,3464,3464,3444,3460,3453,-48,-55,14,260
20150701,3460,3453,3452,3490,3444,3487,3470,34,17,16,264
20150702,3487,3470,3463,3463,3437,3460,3453,-10,-17,10,260
20150703,3460,3453,3496,3496,3471,3491,3475,38,22,444,238
20150706,3491,3475,3484,3484,3464,3469,3472,-6,-3,10,238
20150707,3469,3472,3448,3466,3448,3466,3453,-6,-19,10,228
20150708,3466,3453,3414,3414,3245,3276,3295,-177,-158,54,224
20150709,3276,3295,3101,3412,3101,3394,3300,99,5,258,184
20150710,3394,3300,3409,3409,3381,3395,3400,95,100,30,186
20150713,3395,3400,3404,3429,3383,3383,3399,-17,-1,20,188
20150714,3383,3399,3383,3383,3341,3365,3365,-34,-34,64,170
20150715,3365,3365,3385,3385,3370,3374,3376,9,11,14,170
20150716,3374,3376,3326,3326,3326,3326,3326,-50,-50,2,170
20150717,3326,3326,3282,3321,3282,3306,3300,-20,-26,12,174
20150720,3306,3300,3266,3277,3213,3277,3243,-23,-57,20,172
20150721,3277,3243,3272,3334,3272,3273,3296,30,53,20,174
20150722,3273,3296,3295,3304,3262,3273,3280,-23,-16,18,178
20150723,3273,3280,3277,3287,3277,3287,3280,7,0,12,176
20150724,3287,3280,3252,3258,3233,3245,3246,-35,-34,16,178
20150727,3245,3246,3218,3264,3209,3258,3235,12,-11,46,168
20150728,3258,3235,,,,3241,3241,6,6,0,168
20150729,3241,3241,3249,3257,3249,3257,3251,16,10,6,166
20150730,3257,3251,3273,3286,3273,3286,3279,35,28,4,162
20150731,3286,3279,3272,3272,3243,3252,3252,-27,-27,8,166
20150803,3252,3252,3267,3298,3267,3298,3282,46,30,4,170
20150804,3298,3282,3212,3214,3212,3214,3213,-68,-69,4,170
20150805,3214,3213,3235,3235,3235,3235,3235,22,22,2,168
20150806,3235,3235,3230,3236,3208,3228,3228,-7,-7,16,168
20150807,3228,3228,3240,3251,3237,3251,3243,23,15,8,168
20150810,3251,3243,3266,3288,3251,3276,3269,33,26,164,184
20150811,3276,3269,3290,3396,3290,3396,3360,127,91,24,172
20150812,3396,3360,3421,3537,3400,3533,3464,173,104,50,162
20150813,3533,3464,3537,3553,3496,3530,3524,66,60,58,170
20150814,3530,3524,3511,3515,3508,3515,3511,-9,-13,8,172
20150817,3515,3511,3451,3479,3451,3479,3469,-32,-42,12,176
20150818,3479,3469,3474,3474,3474,3474,3474,5,5,2,174
20150819,3474,3474,3392,3436,3392,3436,3417,-38,-57,30,174
20150820,3436,3417,3401,3511,3401,3491,3488,74,71,70,166
20150821,3491,3488,3514,3548,3491,3534,3520,46,32,96,160
20150824,3534,3520,3480,3480,3442,3442,3457,-78,-63,12,154
20150825,3442,3457,3371,3420,3371,3373,3382,-84,-75,10,154
20150826,3373,3382,3402,3402,3363,3376,3384,-6,2,22,158
20150827,3376,3384,3275,3275,3275,3275,3275,-109,-109,2,158
20150828,3275,3275,3354,3354,3351,3351,3352,76,77,6,162
20150831,3351,3352,,,,3373,3373,21,21,0,162
20150901,3373,3373,,,,3359,3359,-14,-14,0,162
20150902,3359,3359,3344,3344,3344,3344,3344,-15,-15,4,162
20150907,3344,3344,3343,3347,3343,3344,3344,0,0,18,178
20150908,3344,3344,3336,3336,3326,3326,3331,-18,-13,4,178
20150909,3326,3331,3399,3399,3363,3363,3386,32,55,12,182
20150910,3363,3386,3341,3363,3334,3363,3346,-23,-40,6,182
20150911,3363,3346,3359,3378,3329,3365,3356,19,10,136,170
20150914,3365,3356,3300,3325,3300,3325,3307,-31,-49,14,168
20150915,3325,3307,3310,3318,3309,3318,3310,11,3,88,190
20150916,3318,3310,,,,3307,3307,-3,-3,0,190
20150917,3307,3307,,,,3375,3375,68,68,0,190
20150918,3375,3375,3407,3433,3387,3387,3417,12,42,12,186
20150921,3387,3417,3447,3447,3421,3421,3437,4,20,6,184
20150922,3421,3437,3432,3432,3423,3423,3428,-14,-9,10,182
20150923,3423,3428,3351,3381,3351,3364,3366,-64,-62,34,174
20150924,3364,3366,3385,3385,3385,3385,3385,19,19,6,172
20150925,3385,3385,3409,3423,3409,3415,3417,30,32,14,162
20150928,3415,3417,3404,3404,3377,3377,3395,-40,-22,12,158
20150929,3377,3395,3334,3334,3334,3334,3334,-61,-61,10,168
20150930,3334,3334,3325,3325,3325,3325,3325,-9,-9,2,168
20151008,3325,3325,3530,3530,3475,3479,3497,154,172,40,146
20151009,3479,3497,3470,3496,3470,3491,3488,-6,-9,10,144
20151012,3491,3488,3493,3496,3485,3496,3488,8,0,16,146
20151013,3496,3488,3479,3481,3457,3461,3466,-27,-22,42,160
20151014,3461,3466,3490,3499,3486,3496,3494,30,28,32,156
20151015,3496,3494,3523,3523,3515,3516,3518,22,24,6,154
20151016,3516,3518,3499,3499,3473,3473,3489,-45,-29,6,154
20151019,3473,3489,3477,3477,3467,3467,3469,-22,-20,40,140
20151020,3467,3469,3444,3461,3444,3461,3452,-8,-17,4,138
20151021,3461,3452,3473,3473,3444,3444,3457,-8,5,14,138
20151022,3444,3457,3419,3419,3419,3419,3419,-38,-38,2,136
20151023,3419,3419,3451,3458,3451,3458,3456,39,37,8,130
20151026,3458,3456,3444,3454,3444,3454,3448,-2,-8,6,130
20151027,3454,3448,,,,3448,3448,0,0,0,130
20151028,3448,3448,3455,3467,3455,3457,3459,9,11,8,130
20151029,3457,3459,3491,3550,3468,3468,3511,9,52,46,132
20151030,3468,3511,,,,3476,3476,-35,-35,0,132
20151102,3476,3476,3417,3428,3417,3428,3423,-48,-53,16,142
20151103,3428,3423,,,,3415,3415,-8,-8,0,142
20151104,3415,3415,3404,3405,3395,3395,3402,-20,-13,16,142
20151105,3395,3402,3345,3388,3345,3350,3358,-52,-44,30,142
20151106,3350,3358,3352,3353,3352,3353,3352,-5,-6,4,142
20151109,3353,3352,3325,3340,3308,3311,3321,-41,-31,212,214
20151110,3311,3321,3314,3314,3280,3280,3300,-41,-21,98,206
20151111,3280,3300,3273,3281,3261,3281,3268,-19,-32,18,198
20151112,3281,3268,3268,3297,3248,3270,3275,2,7,58,192
20151113,3270,3275,3241,3280,3241,3273,3261,-2,-14,102,194
20151116,3273,3261,3278,3316,3268,3307,3286,46,25,14,190
20151117,3307,3286,3307,3307,3240,3255,3260,-31,-26,32,200
20151118,3255,3260,3270,3270,3240,3254,3251,-6,-9,16,200
20151119,3254,3251,3248,3265,3236,3248,3249,-3,-2,26,202
20151120,3248,3249,3240,3268,3231,3264,3243,15,-6,124,160
20151123,3264,3243,3256,3270,3195,3195,3225,-48,-18,24,176
20151124,3195,3225,3186,3203,3151,3196,3183,-29,-42,48,176
20151125,3196,3183,3206,3233,3197,3220,3214,37,31,30,172
20151126,3220,3214,3195,3251,3195,3238,3226,24,12,126,256
20151127,3238,3226,3228,3237,3193,3200,3208,-26,-18,104,298
20151130,3200,3208,3186,3193,3152,3171,3175,-37,-33,172,278
ag1603,20150317,3515,3515,3491,3502,3491,3502,3494,-13,-21,6,4
20150318,3502,3494,3543,3543,3500,3500,3528,6,34,6,0
20150319,3500,3528,,,,3556,3556,28,28,0,0
20150320,3556,3556,3577,3577,3577,3577,3577,21,21,2,2
20150323,3577,3577,3701,3701,3669,3669,3685,92,108,4,4
20150324,3669,3685,3710,3751,3688,3751,3725,66,40,16,4
20150325,3751,3725,,,,3725,3725,0,0,0,4
20150326,3725,3725,,,,3725,3725,0,0,0,4
20150327,3725,3725,,,,3725,3725,0,0,0,4
20150330,3725,3725,,,,3725,3725,0,0,0,4
20150331,3725,3725,3664,3664,3645,3645,3656,-80,-69,8,6
20150401,3645,3656,,,,3656,3656,0,0,0,6
20150402,3656,3656,3667,3746,3630,3673,3679,17,23,8,6
20150403,3673,3679,,,,3679,3679,0,0,0,6
20150407,3679,3679,3711,3725,3698,3700,3708,21,29,12,10
20150408,3700,3708,3719,3719,3665,3700,3696,-8,-12,20,18
20150409,3700,3696,3655,3655,3601,3601,3615,-95,-81,10,26
20150410,3601,3615,3592,3592,3579,3579,3585,-36,-30,4,26
20150413,3579,3585,3663,3663,3604,3628,3625,43,40,12,26
20150414,3628,3625,3624,3631,3586,3586,3616,-39,-9,8,26
20150415,3586,3616,3612,3624,3581,3590,3605,-26,-11,12,32
20150416,3590,3605,3586,3625,3585,3625,3595,20,-10,12,36
20150417,3625,3595,3625,3625,3601,3601,3613,6,18,4,36
20150420,3601,3613,3609,3609,3609,3609,3609,-4,-4,2,34
20150421,3609,3609,3558,3560,3543,3543,3547,-66,-62,18,40
20150422,3543,3547,3561,3561,3555,3559,3556,12,9,44,64
20150423,3559,3556,3550,3550,3505,3519,3522,-37,-34,22,72
20150424,3519,3522,3505,3543,3505,3531,3530,9,8,16,78
20150427,3531,3530,3510,3565,3505,3565,3527,35,-3,42,72
20150428,3565,3527,3604,3670,3584,3656,3636,129,109,50,86
20150429,3656,3636,3674,3677,3654,3660,3670,24,34,14,90
20150430,3660,3670,3682,3682,3669,3669,3675,-1,5,4,92
20150504,3669,3675,3591,3639,3591,3639,3615,-36,-60,6,92
20150505,3639,3615,3677,3686,3640,3640,3655,25,40,22,90
20150506,3640,3655,3684,3689,3675,3675,3681,20,26,40,98
20150507,3675,3681,3687,3699,3621,3655,3661,-26,-20,14,102
20150508,3655,3661,3634,3655,3634,3655,3637,-6,-24,20,92
20150511,3655,3637,3679,3679,3641,3658,3660,21,23,28,88
20150512,3658,3660,3654,3654,3612,3628,3628,-32,-32,92,124
20150513,3628,3628,3665,3695,3665,3693,3687,65,59,24,130
20150514,3693,3687,3785,3800,3766,3789,3782,102,95,24,118
20150515,3789,3782,3822,3823,3811,3811,3819,29,37,8,122
20150518,3811,3819,3813,3905,3813,3875,3873,56,54,12,124
20150519,3875,3873,3882,3906,3867,3873,3876,0,3,58,128
20150520,3873,3876,3781,3950,3699,3710,3743,-166,-133,34,132
20150521,3710,3743,,,,3743,3743,0,0,0,132
20150522,3743,3743,3736,3768,3736,3768,3752,25,9,4,130
20150525,3768,3752,,,,3754,3754,2,2,0,130
20150526,3754,3754,3751,3753,3720,3720,3744,-34,-10,14,130
20150527,3720,3744,3714,3716,3695,3707,3708,-37,-36,12,130
20150528,3707,3708,3702,3702,3702,3702,3702,-6,-6,8,130
20150529,3702,3702,3660,3690,3660,3687,3681,-15,-21,10,130
20150601,3687,3681,3700,3700,3680,3680,3690,-1,9,4,128
20150602,3680,3690,3881,3881,3702,3705,3762,15,72,6,132
20150603,3705,3762,3715,3722,3701,3701,3715,-61,-47,12,138
20150604,3701,3715,3698,3698,3660,3661,3672,-54,-43,20,144
20150605,3661,3672,3630,3638,3606,3608,3615,-64,-57,20,150
20150608,3608,3615,3607,3607,3607,3607,3607,-8,-8,8,152
20150609,3607,3607,3605,3610,3597,3610,3601,3,-6,42,164
20150610,3610,3601,3613,3619,3600,3609,3605,8,4,24,158
20150611,3609,3605,3612,3612,3608,3608,3610,3,5,8,158
20150612,3608,3610,,,,3589,3589,-21,-21,0,158
20150615,3589,3589,,,,3581,3581,-8,-8,0,158
20150616,3581,3581,3584,3584,3584,3584,3584,3,3,22,162
20150617,3584,3584,3578,3578,3578,3578,3578,-6,-6,2,160
20150618,3578,3578,3592,3604,3592,3604,3596,26,18,26,172
20150619,3604,3596,3643,3643,3586,3586,3614,-10,18,4,170
20150623,3586,3614,3588,3588,3588,3588,3588,-26,-26,2,170
20150624,3588,3588,3558,3558,3507,3534,3532,-54,-56,14,162
20150625,3534,3532,3530,3530,3530,3530,3530,-2,-2,2,160
20150626,3530,3530,3522,3522,3474,3501,3499,-29,-31,6,158
20150629,3501,3499,3488,3530,3488,3519,3511,20,12,34,150
20150630,3519,3511,3430,3449,3430,3449,3438,-62,-73,10,146
20150701,3449,3438,3452,3488,3452,3488,3472,50,34,24,146
20150702,3488,3472,3460,3460,3458,3458,3458,-14,-14,6,140
20150703,3458,3458,3484,3494,3484,3494,3489,36,31,4,140
20150706,3494,3489,3492,3493,3455,3455,3471,-34,-18,14,134
20150707,3455,3471,3457,3467,3456,3467,3459,-4,-12,10,132
20150708,3467,3459,3281,3290,3251,3287,3273,-172,-186,28,130
20150709,3287,3273,3321,3427,3312,3395,3360,122,87,16,130
20150710,3395,3360,,,,3385,3385,25,25,0,130
20150713,3385,3385,3396,3418,3396,3418,3407,33,22,4,132
20150714,3418,3407,,,,3373,3373,-34,-34,0,132
20150715,3373,3373,3384,3386,3376,3386,3382,13,9,6,130
20150716,3386,3382,3329,3329,3329,3329,3329,-53,-53,2,132
20150717,3329,3329,,,,3303,3303,-26,-26,0,132
20150720,3303,3303,3271,3295,3248,3248,3259,-55,-44,12,132
20150721,3248,3259,,,,3259,3259,0,0,0,132
20150722,3259,3259,3266,3266,3259,3259,3262,0,3,4,130
20150723,3259,3262,3223,3292,3223,3292,3256,30,-6,8,132
20150724,3292,3256,3280,3287,3253,3253,3274,-3,18,10,128
20150727,3253,3274,3196,3254,3196,3254,3221,-20,-53,32,128
20150728,3254,3221,3252,3252,3240,3240,3243,19,22,10,130
20150729,3240,3243,3240,3263,3239,3263,3247,20,4,6,132
20150730,3263,3247,3276,3287,3231,3274,3268,27,21,24,130
20150731,3274,3268,3181,3277,3181,3267,3248,-1,-20,24,132
20150803,3267,3248,3278,3299,3275,3277,3282,29,34,18,128
20150804,3277,3282,3242,3242,3206,3234,3227,-48,-55,6,128
20150805,3234,3227,3241,3241,3206,3230,3229,3,2,24,132
20150806,3230,3229,3240,3240,3230,3233,3234,4,5,6,136
20150807,3233,3234,3240,3248,3239,3239,3243,5,9,178,188
20150810,3239,3243,3288,3288,3270,3285,3280,42,37,20,192
20150811,3285,3280,3320,3400,3287,3400,3336,120,56,28,196
20150812,3400,3336,3406,3529,3401,3527,3447,191,111,22,188
20150813,3527,3447,3603,3603,3523,3523,3560,76,113,10,184
20150814,3523,3560,,,,3560,3560,0,0,0,184
20150817,3560,3560,3470,3471,3470,3471,3470,-89,-90,4,184
20150818,3471,3470,,,,3475,3475,5,5,0,184
20150819,3475,3475,,,,3418,3418,-57,-57,0,184
20150820,3418,3418,3511,3518,3511,3518,3516,100,98,10,184
20150821,3518,3516,3533,3563,3533,3563,3548,47,32,4,186
20150824,3563,3548,3511,3511,3452,3452,3477,-96,-71,12,186
20150825,3452,3477,3443,3462,3432,3432,3443,-45,-34,8,184
20150826,3432,3443,3388,3395,3388,3395,3392,-48,-51,10,182
20150827,3395,3392,3277,3303,3261,3303,3285,-89,-107,16,188
20150828,3303,3285,3307,3372,3307,3346,3349,61,64,12,188
20150831,3346,3349,3377,3377,3377,3377,3377,28,28,6,188
20150901,3377,3377,3343,3368,3315,3368,3345,-9,-32,50,202
20150902,3368,3345,,,,3330,3330,-15,-15,0,202
20150907,3330,3330,,,,3330,3330,0,0,0,202
20150908,3330,3330,,,,3317,3317,-13,-13,0,202
20150909,3317,3317,3397,3397,3367,3367,3382,50,65,4,204
20150910,3367,3382,,,,3342,3342,-40,-40,0,204
20150911,3342,3342,3344,3373,3344,3356,3356,14,14,8,204
20150914,3356,3356,3316,3333,3310,3333,3319,-23,-37,6,204
20150915,3333,3319,3322,3326,3321,3321,3322,2,3,34,172
20150916,3321,3322,,,,3319,3319,-3,-3,0,172
20150917,3319,3319,3370,3371,3370,3371,3370,52,51,4,170
20150918,3371,3370,3413,3434,3413,3434,3423,64,53,4,170
20150921,3434,3423,3458,3458,3425,3440,3439,17,16,54,140
20150922,3440,3439,,,,3429,3429,-10,-10,0,140
20150923,3429,3429,,,,3367,3367,-62,-62,0,140
20150924,3367,3367,,,,3386,3386,19,19,0,140
20150925,3386,3386,3436,3436,3431,3431,3433,45,47,8,134
20150928,3431,3433,3413,3413,3413,3413,3413,-20,-20,2,132
20150929,3413,3413,3336,3336,3336,3336,3336,-77,-77,4,132
20150930,3336,3336,,,,3326,3326,-10,-10,0,132
20151008,3326,3326,3522,3558,3482,3494,3490,168,164,310,234
20151009,3494,3490,,,,3481,3481,-9,-9,0,234
20151012,3481,3481,3497,3497,3497,3497,3497,16,16,2,232
20151013,3497,3497,3512,3512,3465,3470,3484,-27,-13,24,232
20151014,3470,3484,3516,3520,3516,3520,3518,36,34,8,234
20151015,3520,3518,3510,3518,3510,3518,3517,0,-1,18,232
20151016,3518,3517,3493,3493,3493,3493,3493,-24,-24,2,234
20151019,3493,3493,3484,3484,3477,3477,3480,-16,-13,4,232
20151020,3477,3480,3476,3476,3468,3468,3473,-12,-7,14,232
20151021,3468,3473,,,,3478,3478,5,5,0,232
20151022,3478,3478,3425,3465,3425,3465,3445,-13,-33,4,232
20151023,3465,3445,3485,3485,3485,3485,3485,40,40,4,230
20151026,3485,3485,,,,3476,3476,-9,-9,0,230
20151027,3476,3476,,,,3476,3476,0,0,0,230
20151028,3476,3476,,,,3487,3487,11,11,0,230
20151029,3487,3487,,,,3539,3539,52,52,0,230
20151030,3539,3539,,,,3477,3477,-62,-62,0,230
20151102,3477,3477,3442,3442,3442,3442,3442,-35,-35,2,232
20151103,3442,3442,3400,3400,3400,3400,3400,-42,-42,2,230
20151104,3400,3400,3416,3416,3402,3402,3409,2,9,8,226
20151105,3402,3409,3408,3408,3342,3342,3365,-67,-44,14,232
20151106,3342,3365,3357,3357,3357,3357,3357,-8,-8,2,232
20151109,3357,3357,3340,3340,3291,3291,3320,-66,-37,14,238
20151110,3291,3320,3310,3323,3310,3323,3311,3,-9,28,260
20151111,3323,3311,3299,3299,3280,3296,3284,-15,-27,24,244
20151112,3296,3284,3271,3271,3271,3271,3271,-13,-13,4,240
20151113,3271,3271,3313,3313,3313,3313,3313,42,42,2,242
20151116,3313,3313,3297,3327,3297,3320,3315,7,2,14,252
20151117,3320,3315,3270,3270,3270,3270,3270,-45,-45,30,262
20151118,3270,3270,3265,3269,3257,3257,3260,-13,-10,34,260
20151119,3257,3260,3244,3244,3234,3234,3239,-26,-21,4,260
20151120,3234,3239,3240,3290,3240,3251,3262,12,23,32,256
20151123,3251,3262,3236,3257,3077,3077,3205,-185,-57,24,266
20151124,3077,3205,3188,3188,3188,3188,3188,-17,-17,2,266
20151125,3188,3188,3226,3242,3191,3242,3220,54,32,22,264
20151126,3242,3220,,,,3220,3220,0,0,0,264
20151127,3220,3220,3242,3242,3242,3242,3242,22,22,2,262
20151130,3242,3242,3205,3205,3155,3189,3182,-53,-60,10,264
ag1604,20150416,3605,3605,,,,3595,3595,-10,-10,0,0
20150417,3595,3595,3659,3659,3615,3615,3637,20,42,4,2
20150420,3615,3637,,,,3637,3637,0,0,0,2
20150421,3637,3637,3546,3555,3546,3550,3550,-87,-87,6,8
20150422,3550,3550,3540,3578,3540,3556,3555,6,5,26,26
20150423,3556,3555,3532,3544,3515,3544,3522,-11,-33,14,34
20150424,3544,3522,,,,3522,3522,0,0,0,34
20150427,3522,3522,,,,3519,3519,-3,-3,0,34
20150428,3519,3519,3610,3673,3610,3673,3643,154,124,8,36
20150429,3673,3643,3680,3861,3653,3653,3693,10,50,46,48
20150430,3653,3693,3700,3732,3666,3701,3705,8,12,100,50
20150504,3701,3705,3615,3655,3615,3655,3629,-50,-76,30,60
20150505,3655,3629,3680,3716,3656,3656,3680,27,51,30,66
20150506,3656,3680,3707,3707,3694,3694,3697,14,17,8,70
20150507,3694,3697,3708,3710,3646,3646,3668,-51,-29,26,74
20150508,3646,3668,3629,3670,3629,3636,3649,-32,-19,18,70
20150511,3636,3649,3686,3686,3643,3671,3668,22,19,16,64
20150512,3671,3668,3678,3678,3626,3630,3649,-38,-19,34,84
20150513,3630,3649,3671,3700,3663,3685,3675,36,26,40,78
20150514,3685,3675,3790,3804,3757,3793,3785,118,110,78,80
20150515,3793,3785,3796,3836,3796,3820,3815,35,30,158,118
20150518,3820,3815,3828,3905,3828,3897,3849,82,34,78,130
20150519,3897,3849,3898,3898,3830,3844,3867,-5,18,56,128
20150520,3844,3867,3811,3812,3708,3712,3744,-155,-123,160,140
20150521,3712,3744,3769,3769,3750,3754,3759,10,15,16,130
20150522,3754,3759,3753,3776,3743,3768,3761,9,2,16,130
20150525,3768,3761,3749,3749,3734,3736,3741,-25,-20,10,130
20150526,3736,3741,3753,3778,3705,3705,3749,-36,8,18,134
20150527,3705,3749,3680,3709,3680,3709,3694,-40,-55,4,136
20150528,3709,3694,3689,3690,3679,3679,3683,-15,-11,22,126
20150529,3679,3683,3690,3694,3690,3694,3692,11,9,8,128
20150601,3694,3692,3709,3711,3698,3698,3705,6,13,10,132
20150602,3698,3705,3761,3761,3704,3711,3738,6,33,16,132
20150603,3711,3738,3726,3726,3726,3726,3726,-12,-12,6,138
20150604,3726,3726,3680,3680,3665,3666,3671,-60,-55,18,144
20150605,3666,3671,3630,3632,3616,3624,3625,-47,-46,30,144
20150608,3624,3625,3609,3625,3609,3621,3618,-4,-7,12,146
20150609,3621,3618,,,,3618,3618,0,0,0,146
20150610,3618,3618,3621,3621,3621,3621,3621,3,3,4,146
20150611,3621,3621,3634,3634,3617,3617,3628,-4,7,10,150
20150612,3617,3628,3617,3617,3617,3617,3617,-11,-11,2,150
20150615,3617,3617,3602,3602,3589,3589,3596,-28,-21,22,154
20150616,3589,3596,3604,3633,3599,3607,3609,11,13,24,154
20150617,3607,3609,3602,3602,3589,3589,3595,-20,-14,4,152
20150618,3589,3595,3619,3620,3619,3620,3619,25,24,4,148
20150619,3620,3619,3665,3667,3647,3647,3658,28,39,20,146
20150623,3647,3658,3613,3613,3613,3613,3613,-45,-45,6,150
20150624,3613,3613,,,,3613,3613,0,0,0,150
20150625,3613,3613,,,,3610,3610,-3,-3,0,150
20150626,3610,3610,3531,3546,3514,3514,3538,-96,-72,20,162
20150629,3514,3538,3502,3550,3502,3527,3524,-11,-14,26,162
20150630,3527,3524,3507,3507,3452,3452,3489,-72,-35,12,154
20150701,3452,3489,3489,3489,3488,3488,3488,-1,-1,8,156
20150702,3488,3488,3490,3490,3490,3490,3490,2,2,6,156
20150703,3490,3490,3465,3484,3465,3484,3474,-6,-16,4,154
20150706,3484,3474,,,,3456,3456,-18,-18,0,154
20150707,3456,3456,3462,3512,3442,3489,3473,33,17,40,148
20150708,3489,3473,3405,3413,3264,3265,3274,-208,-199,126,146
20150709,3265,3274,3262,3438,3262,3425,3341,151,67,70,128
20150710,3425,3341,3414,3435,3414,3435,3424,94,83,4,128
20150713,3435,3424,,,,3446,3446,22,22,0,128
20150714,3446,3446,3368,3397,3368,3397,3382,-49,-64,4,126
20150715,3397,3382,,,,3382,3382,0,0,0,126
20150716,3382,3382,,,,3329,3329,-53,-53,0,126
20150717,3329,3329,,,,3303,3303,-26,-26,0,126
20150720,3303,3303,3266,3275,3250,3255,3261,-48,-42,8,128
20150721,3255,3261,3317,3327,3291,3293,3307,32,46,8,130
20150722,3293,3307,3293,3293,3293,3293,3293,-14,-14,2,130
20150723,3293,3293,3297,3303,3297,3303,3300,10,7,4,130
20150724,3303,3300,3256,3256,3256,3256,3256,-44,-44,2,128
20150727,3256,3256,3260,3266,3206,3263,3246,7,-10,98,132
20150728,3263,3246,3263,3268,3200,3263,3238,17,-8,44,132
20150729,3263,3238,,,,3242,3242,4,4,0,132
20150730,3242,3242,,,,3263,3263,21,21,0,132
20150731,3263,3263,,,,3243,3243,-20,-20,0,132
20150803,3243,3243,,,,3277,3277,34,34,0,132
20150804,3277,3277,3262,3262,3262,3262,3262,-15,-15,2,132
20150805,3262,3262,3252,3252,3252,3252,3252,-10,-10,4,132
20150806,3252,3252,3260,3268,3253,3253,3260,1,8,6,130
20150807,3253,3260,,,,3269,3269,9,9,0,130
20150810,3269,3269,,,,3307,3307,38,38,0,130
20150811,3307,3307,3405,3405,3405,3405,3405,98,98,2,130
20150812,3405,3405,3404,3547,3404,3547,3428,142,23,74,132
20150813,3547,3428,3568,3568,3568,3568,3568,140,140,10,128
20150814,3568,3568,,,,3554,3554,-14,-14,0,128
20150817,3554,3554,,,,3554,3554,0,0,0,128
20150818,3554,3554,,,,3559,3559,5,5,0,128
20150819,3559,3559,,,,3559,3559,0,0,0,128
20150820,3559,3559,3488,3521,3479,3521,3495,-38,-64,26,132
20150821,3521,3495,3549,3558,3534,3558,3545,63,50,16,132
20150824,3558,3545,3493,3518,3462,3462,3488,-83,-57,12,134
20150825,3462,3488,3406,3406,3406,3406,3406,-82,-82,2,132
20150826,3406,3406,3440,3440,3388,3388,3412,-18,6,10,134
20150827,3388,3412,3286,3319,3286,3319,3297,-93,-115,6,136
20150828,3319,3297,3373,3373,3373,3373,3373,76,76,2,136
20150831,3373,3373,,,,3401,3401,28,28,0,136
20150901,3401,3401,,,,3369,3369,-32,-32,0,136
20150902,3369,3369,,,,3353,3353,-16,-16,0,136
20150907,3353,3353,,,,3353,3353,0,0,0,136
20150908,3353,3353,,,,3339,3339,-14,-14,0,136
20150909,3339,3339,3405,3432,3405,3432,3414,93,75,10,138
20150910,3432,3414,,,,3373,3373,-41,-41,0,138
20150911,3373,3373,,,,3387,3387,14,14,0,138
20150914,3387,3387,,,,3350,3350,-37,-37,0,138
20150915,3350,3350,,,,3353,3353,3,3,0,138
20150916,3353,3353,3323,3345,3323,3345,3333,-8,-20,10,132
20150917,3345,3333,3390,3412,3387,3401,3398,68,65,22,136
20150918,3401,3398,3408,3437,3408,3435,3415,37,17,24,136
20150921,3435,3415,3452,3452,3452,3452,3452,37,37,2,136
20150922,3452,3452,3454,3461,3451,3455,3455,3,3,8,136
20150923,3455,3455,3406,3413,3395,3395,3405,-60,-50,60,128
20150924,3395,3405,3400,3404,3400,3404,3402,-1,-3,4,130
20150925,3404,3402,3446,3446,3437,3437,3440,35,38,26,124
20150928,3437,3440,3445,3445,3413,3413,3427,-27,-13,36,124
20150929,3413,3427,3380,3388,3320,3334,3359,-93,-68,18,124
20150930,3334,3359,3347,3347,3340,3340,3343,-19,-16,8,122
20151008,3340,3343,3526,3526,3501,3502,3507,159,164,14,118
20151009,3502,3507,3496,3496,3496,3496,3496,-11,-11,4,122
20151012,3496,3496,3498,3498,3498,3498,3498,2,2,6,122
20151013,3498,3498,3487,3494,3482,3482,3488,-16,-10,18,126
20151014,3482,3488,3513,3520,3507,3520,3513,32,25,48,114
20151015,3520,3513,3534,3534,3534,3534,3534,21,21,22,114
20151016,3534,3534,3506,3520,3503,3520,3514,-14,-20,20,108
20151019,3520,3514,3500,3500,3498,3498,3499,-16,-15,4,106
20151020,3498,3499,3495,3495,3486,3486,3490,-13,-9,4,106
20151021,3486,3490,3493,3493,3492,3492,3492,2,2,6,106
20151022,3492,3492,,,,3458,3458,-34,-34,0,106
20151023,3458,3458,3477,3504,3473,3504,3482,46,24,8,106
20151026,3504,3482,3476,3480,3476,3480,3478,-2,-4,4,102
20151027,3480,3478,3489,3489,3489,3489,3489,11,11,4,102
20151028,3489,3489,,,,3500,3500,11,11,0,102
20151029,3500,3500,3550,3550,3550,3550,3550,50,50,2,104
20151030,3550,3550,,,,3488,3488,-62,-62,0,104
20151102,3488,3488,3440,3440,3436,3436,3437,-52,-51,6,98
20151103,3436,3437,,,,3395,3395,-42,-42,0,98
20151104,3395,3395,3419,3432,3419,3432,3425,37,30,4,94
20151105,3432,3425,3410,3428,3390,3390,3407,-35,-18,24,96
20151106,3390,3407,3370,3370,3370,3370,3370,-37,-37,4,100
20151109,3370,3370,3341,3341,3338,3338,3339,-32,-31,4,104
20151110,3338,3339,3333,3333,3310,3310,3325,-29,-14,6,100
20151111,3310,3325,3284,3318,3284,3318,3301,-7,-24,4,98
20151112,3318,3301,3296,3313,3296,3301,3302,0,1,28,112
20151113,3301,3302,3291,3291,3288,3288,3289,-14,-13,8,112
20151116,3288,3289,,,,3291,3291,2,2,0,112
20151117,3291,3291,3302,3302,3273,3297,3293,6,2,52,110
20151118,3297,3293,,,,3283,3283,-10,-10,0,110
20151119,3283,3283,,,,3261,3261,-22,-22,0,110
20151120,3261,3261,,,,3284,3284,23,23,0,110
20151123,3284,3284,3264,3265,3230,3265,3250,-19,-34,10,110
20151124,3265,3250,,,,3232,3232,-18,-18,0,110
20151125,3232,3232,3213,3213,3204,3212,3209,-20,-23,6,110
20151126,3212,3209,,,,3221,3221,12,12,0,110
20151127,3221,3221,,,,3221,3221,0,0,0,110
20151130,3221,3221,,,,3221,3221,0,0,0,110
ag1605,20150518,3815,3815,3873,3918,3855,3918,3873,103,58,18,12
20150519,3918,3873,3920,3920,3863,3867,3878,-6,5,20,26
20150520,3867,3878,3830,3830,3704,3732,3771,-146,-107,88,56
20150521,3732,3771,3771,3771,3770,3770,3770,-1,-1,4,58
20150522,3770,3770,3766,3783,3758,3783,3767,13,-3,86,78
20150525,3783,3767,3747,3769,3747,3754,3754,-13,-13,132,194
20150526,3754,3754,3772,3780,3718,3718,3760,-36,6,40,204
20150527,3718,3760,3717,3744,3706,3719,3720,-41,-40,58,208
20150528,3719,3720,3688,3730,3688,3697,3704,-23,-16,30,204
20150529,3697,3704,3710,3720,3681,3697,3705,-7,1,50,210
20150601,3697,3705,3730,3730,3711,3715,3718,10,13,32,218
20150602,3715,3718,3732,3784,3717,3724,3745,6,27,66,224
20150603,3724,3745,3740,3743,3730,3730,3736,-15,-9,18,226
20150604,3730,3736,3720,3720,3677,3692,3705,-44,-31,72,270
20150605,3692,3705,3663,3663,3621,3626,3643,-79,-62,74,302
20150608,3626,3643,3602,3640,3599,3632,3623,-11,-20,128,364
20150609,3632,3623,3629,3638,3614,3629,3627,6,4,100,442
20150610,3629,3627,3636,3644,3619,3627,3629,0,2,88,492
20150611,3627,3629,3653,3655,3625,3625,3641,-4,12,110,540
20150612,3625,3641,3633,3635,3595,3619,3623,-22,-18,108,566
20150615,3619,3623,3570,3624,3570,3606,3609,-17,-14,246,732
20150616,3606,3609,3618,3639,3613,3626,3622,17,13,110,684
20150617,3626,3622,3620,3637,3585,3598,3602,-24,-20,172,676
20150618,3598,3602,3571,3642,3571,3626,3617,24,15,92,658
20150619,3626,3617,3654,3667,3607,3630,3636,13,19,126,606
20150623,3630,3636,3616,3624,3597,3597,3605,-39,-31,22,614
20150624,3597,3605,3564,3583,3539,3556,3555,-49,-50,104,616
20150625,3556,3555,3551,3561,3540,3557,3554,2,-1,46,610
20150626,3557,3554,3548,3551,3505,3505,3532,-49,-22,46,624
20150629,3505,3532,3517,3552,3517,3530,3529,-2,-3,18,626
20150630,3530,3529,3521,3521,3460,3483,3480,-46,-49,86,648
20150701,3483,3480,3477,3510,3477,3496,3499,16,19,12,648
20150702,3496,3499,3485,3502,3463,3472,3486,-27,-13,34,644
20150703,3472,3486,3500,3516,3482,3516,3503,30,17,20,644
20150706,3516,3503,3484,3517,3474,3480,3503,-23,0,48,640
20150707,3480,3503,3502,3512,3484,3484,3494,-19,-9,14,638
20150708,3484,3494,3375,3376,3284,3284,3303,-210,-191,126,618
20150709,3284,3303,3250,3470,3223,3426,3371,123,68,244,700
20150710,3426,3371,3461,3469,3410,3469,3435,98,64,28,700
20150713,3469,3435,3439,3445,3429,3429,3438,-6,3,40,696
20150714,3429,3438,3429,3473,3350,3404,3409,-34,-29,194,688
20150715,3404,3409,3415,3417,3395,3395,3410,-14,1,28,696
20150716,3395,3410,3351,3358,3340,3353,3353,-57,-57,30,710
20150717,3353,3353,3345,3359,3317,3336,3338,-17,-15,54,704
20150720,3336,3338,3316,3339,3242,3292,3298,-46,-40,52,720
20150721,3292,3298,3301,3346,3301,3304,3321,6,23,14,714
20150722,3304,3321,3323,3323,3283,3300,3306,-21,-15,22,712
20150723,3300,3306,3283,3310,3281,3310,3294,4,-12,12,710
20150724,3310,3294,3288,3303,3254,3276,3280,-18,-14,18,716
20150727,3276,3280,3240,3280,3235,3262,3253,-18,-27,20,710
20150728,3262,3253,3268,3276,3268,3276,3270,23,17,6,708
20150729,3276,3270,3285,3285,3285,3285,3285,15,15,2,708
20150730,3285,3285,3276,3307,3268,3268,3285,-17,0,26,712
20150731,3268,3285,3307,3307,3280,3285,3294,0,9,44,728
20150803,3285,3294,3285,3320,3274,3295,3300,1,6,46,728
20150804,3295,3300,3283,3283,3236,3261,3256,-39,-44,16,726
20150805,3261,3256,3263,3275,3250,3255,3260,-1,4,22,734
20150806,3255,3260,3262,3274,3250,3258,3262,-2,2,22,738
20150807,3258,3262,3255,3284,3241,3284,3267,22,5,62,746
20150810,3284,3267,3303,3312,3303,3303,3305,36,38,10,750
20150811,3303,3305,3309,3423,3309,3409,3361,104,56,62,734
20150812,3409,3361,3408,3562,3408,3562,3468,201,107,136,704
20150813,3562,3468,3573,3573,3531,3543,3544,75,76,176,736
20150814,3543,3544,3528,3565,3526,3540,3539,-4,-5,34,728
20150817,3540,3539,3556,3585,3485,3501,3521,-38,-18,106,708
20150818,3501,3521,3517,3517,3482,3482,3497,-39,-24,22,710
20150819,3482,3497,3463,3470,3412,3459,3426,-38,-71,102,696
20150820,3459,3426,3492,3539,3492,3539,3520,113,94,46,698
20150821,3539,3520,3546,3546,3545,3545,3545,25,25,6,698
20150824,3545,3545,3538,3541,3471,3471,3511,-74,-34,44,688
20150825,3471,3511,3425,3489,3405,3410,3456,-101,-55,340,670
20150826,3410,3456,3440,3440,3404,3406,3417,-50,-39,58,654
20150827,3406,3417,3310,3328,3300,3328,3311,-89,-106,72,654
20150828,3328,3311,3321,3424,3321,3387,3387,76,76,14,648
20150831,3387,3387,,,,3387,3387,0,0,0,648
20150901,3387,3387,3367,3405,3367,3405,3386,18,-1,4,646
20150902,3405,3386,3397,3397,3374,3374,3385,-12,-1,6,642
20150907,3374,3385,,,,3385,3385,0,0,0,642
20150908,3385,3385,3359,3360,3357,3357,3359,-28,-26,10,636
20150909,3357,3359,3357,3428,3357,3418,3409,59,50,22,638
20150910,3418,3409,3361,3361,3357,3359,3359,-50,-50,6,638
20150911,3359,3359,3390,3390,3374,3374,3385,15,26,18,638
20150914,3374,3385,3366,3366,3352,3352,3358,-33,-27,16,638
20150915,3352,3358,3345,3345,3340,3344,3341,-14,-17,26,646
20150916,3344,3341,3326,3372,3326,3360,3349,19,8,10,646
20150917,3360,3349,3389,3420,3389,3415,3408,66,59,6,644
20150918,3415,3408,3442,3464,3442,3464,3451,56,43,8,646
20150921,3464,3451,3450,3450,3450,3450,3450,-1,-1,2,646
20150922,3450,3450,3461,3461,3461,3461,3461,11,11,2,644
20150923,3461,3461,3416,3416,3406,3406,3412,-55,-49,10,640
20150924,3406,3412,3416,3416,3416,3416,3416,4,4,2,640
20150925,3416,3416,3432,3461,3432,3453,3445,37,29,14,634
20150928,3453,3445,3431,3431,3409,3412,3414,-33,-31,14,632
20150929,3412,3414,3367,3373,3337,3337,3360,-77,-54,16,630
20150930,3337,3360,3356,3370,3349,3358,3358,-2,-2,10,632
20151008,3358,3358,3544,3544,3516,3518,3527,160,169,36,620
20151009,3518,3527,3500,3516,3486,3516,3493,-11,-34,80,614
20151012,3516,3493,3523,3538,3492,3535,3512,42,19,52,608
20151013,3535,3512,3530,3530,3481,3495,3495,-17,-17,44,614
20151014,3495,3495,3521,3539,3518,3528,3527,33,32,70,618
20151015,3528,3527,3528,3545,3525,3531,3534,4,7,70,614
20151016,3531,3534,3514,3529,3511,3513,3515,-21,-19,28,606
20151019,3513,3515,3521,3521,3496,3496,3503,-19,-12,16,606
20151020,3496,3503,3476,3476,3475,3475,3475,-28,-28,12,602
20151021,3475,3475,,,,3475,3475,0,0,0,602
20151022,3475,3475,3458,3458,3458,3458,3458,-17,-17,2,602
20151023,3458,3458,3490,3490,3480,3480,3483,22,25,6,598
20151026,3480,3483,,,,3483,3483,0,0,0,598
20151027,3483,3483,3493,3501,3493,3501,3497,18,14,8,598
20151028,3501,3497,3503,3510,3503,3510,3506,13,9,4,600
20151029,3510,3506,3506,3567,3489,3496,3546,-10,40,100,594
20151030,3496,3546,3480,3480,3480,3480,3480,-66,-66,2,594
20151102,3480,3480,3449,3449,3449,3449,3449,-31,-31,2,592
20151103,3449,3449,3449,3449,3404,3447,3424,-2,-25,40,592
20151104,3447,3424,3426,3435,3426,3433,3431,9,7,6,592
20151105,3433,3431,3420,3420,3398,3398,3407,-33,-24,6,592
20151106,3398,3407,3393,3397,3380,3397,3391,-10,-16,8,596
20151109,3397,3391,3376,3376,3353,3353,3368,-38,-23,30,600
20151110,3353,3368,3341,3347,3310,3310,3333,-58,-35,84,612
20151111,3310,3333,3302,3329,3291,3323,3305,-10,-28,90,614
20151112,3323,3305,3311,3317,3294,3317,3304,12,-1,50,608
20151113,3317,3304,3291,3324,3286,3302,3299,-2,-5,268,610
20151116,3302,3299,3302,3334,3298,3334,3314,35,15,38,602
20151117,3334,3314,3314,3329,3261,3261,3293,-53,-21,52,596
20151118,3261,3293,3286,3351,3251,3265,3271,-28,-22,34,596
20151119,3265,3271,3256,3290,3248,3279,3264,8,-7,162,598
20151120,3279,3264,3275,3292,3267,3282,3274,18,10,280,640
20151123,3282,3274,3295,3295,3169,3202,3255,-72,-19,160,632
20151124,3202,3255,3200,3217,3180,3217,3196,-38,-59,168,622
20151125,3217,3196,3223,3260,3203,3228,3240,32,44,284,630
20151126,3228,3240,3223,3291,3210,3257,3241,17,1,316,630
20151127,3257,3241,3246,3293,3212,3224,3241,-17,0,118,668
20151130,3224,3241,3254,3254,3165,3200,3202,-41,-39,166,642
ag1606,20150616,3609,3609,3575,3645,3551,3630,3617,21,8,252,152
20150617,3630,3617,3630,3630,3587,3608,3602,-9,-15,530,412
20150618,3608,3602,3609,3657,3600,3641,3625,39,23,538,606
20150619,3641,3625,3666,3686,3625,3633,3651,8,26,380,720
20150623,3633,3651,3635,3635,3603,3606,3619,-45,-32,140,722
20150624,3606,3619,3594,3597,3547,3564,3562,-55,-57,772,1058
20150625,3564,3562,3557,3568,3548,3556,3560,-6,-2,358,1134
20150626,3556,3560,3556,3564,3505,3505,3548,-55,-12,826,1494
20150629,3505,3548,3511,3567,3503,3542,3542,-6,-6,702,1718
20150630,3542,3542,3549,3553,3455,3520,3500,-22,-42,1046,1946
20150701,3520,3500,3525,3546,3470,3500,3500,0,0,1458,2236
20150702,3500,3500,3493,3522,3479,3491,3496,-9,-4,1310,2432
20150703,3491,3496,3501,3537,3501,3522,3514,26,18,1136,2486
20150706,3522,3514,3530,3533,3488,3501,3508,-13,-6,1028,2612
20150707,3501,3508,3496,3538,3481,3510,3503,2,-5,1150,2618
20150708,3510,3503,3492,3498,3292,3292,3343,-211,-160,4180,2850
20150709,3292,3343,3292,3485,3263,3444,3388,101,45,4692,3448
20150710,3444,3388,3450,3474,3427,3444,3447,56,59,1840,3380
20150713,3444,3447,3444,3481,3428,3443,3452,-4,5,740,3288
20150714,3443,3452,3432,3438,3385,3409,3413,-43,-39,1156,3286
20150715,3409,3413,3418,3437,3400,3409,3416,-4,3,618,3370
20150716,3409,3416,3378,3381,3340,3360,3358,-56,-58,1536,3848
20150717,3360,3358,3325,3380,3308,3343,3349,-15,-9,950,3952
20150720,3343,3349,3305,3337,3250,3322,3287,-27,-62,2858,4496
20150721,3322,3287,3302,3370,3290,3318,3324,31,37,2248,4738
20150722,3318,3324,3326,3352,3280,3300,3311,-24,-13,2180,5186
20150723,3300,3311,3300,3329,3290,3317,3314,6,3,2308,5636
20150724,3317,3314,3315,3326,3251,3277,3285,-37,-29,3338,6366
20150727,3277,3285,3260,3296,3214,3294,3265,9,-20,2974,6658
20150728,3294,3265,3278,3293,3259,3273,3276,8,11,1904,6884
20150729,3273,3276,3276,3298,3270,3289,3284,13,8,1540,6894
20150730,3289,3284,3278,3328,3274,3274,3299,-10,15,2730,6896
20150731,3274,3299,3289,3309,3274,3274,3289,-25,-10,1418,6856
20150803,3274,3289,3285,3336,3280,3299,3302,10,13,2194,6752
20150804,3299,3302,3287,3293,3225,3264,3262,-38,-40,1998,6774
20150805,3264,3262,3273,3276,3251,3257,3263,-5,1,1132,6986
20150806,3257,3263,3263,3282,3254,3270,3267,7,4,1138,7178
20150807,3270,3267,3261,3302,3261,3300,3279,33,12,1188,7030
20150810,3300,3279,3274,3328,3274,3315,3308,36,29,3086,7112
20150811,3315,3308,3313,3437,3313,3411,3392,103,84,6460,7980
20150812,3411,3392,3425,3579,3404,3571,3489,179,97,9372,9196
20150813,3571,3489,3586,3606,3537,3555,3566,66,77,5306,9332
20150814,3555,3566,3555,3558,3529,3549,3543,-17,-23,3182,9106
20150817,3549,3543,3555,3586,3485,3514,3517,-29,-26,6088,8722
20150818,3514,3517,3520,3527,3496,3498,3512,-19,-5,1628,8924
20150819,3498,3512,3480,3480,3425,3472,3449,-40,-63,3042,9144
20150820,3472,3449,3468,3558,3467,3541,3522,92,73,4186,9370
20150821,3541,3522,3575,3594,3544,3553,3568,31,46,5100,9750
20150824,3553,3568,3544,3560,3475,3485,3512,-83,-56,6362,9724
20150825,3485,3512,3450,3506,3402,3426,3457,-86,-55,10458,11588
20150826,3426,3457,3450,3470,3380,3382,3426,-75,-31,6160,12022
20150827,3382,3426,3333,3354,3300,3344,3328,-82,-98,6180,12824
20150828,3344,3328,3329,3428,3320,3399,3378,71,50,7922,13864
20150831,3399,3378,3391,3432,3370,3391,3402,13,24,5760,13554
20150901,3391,3402,3380,3422,3364,3393,3394,-9,-8,2466,13684
20150902,3393,3394,3402,3422,3380,3390,3395,-4,1,2728,13878
20150907,3390,3395,3390,3400,3376,3378,3390,-17,-5,1658,13800
20150908,3378,3390,3380,3388,3360,3386,3372,-4,-18,2234,13974
20150909,3386,3372,3399,3454,3391,3393,3425,21,53,8452,13606
20150910,3393,3425,3391,3400,3368,3395,3384,-30,-41,4142,14568
20150911,3395,3384,3410,3420,3385,3392,3401,8,17,4858,14538
20150914,3392,3401,3380,3388,3336,3366,3360,-35,-41,5104,14768
20150915,3366,3360,3350,3365,3346,3348,3356,-12,-4,2420,14860
20150916,3348,3356,3355,3376,3338,3369,3354,13,-2,2368,14954
20150917,3369,3354,3404,3438,3398,3425,3419,71,65,4798,15106
20150918,3425,3419,3425,3504,3416,3453,3459,34,40,5270,15508
20150921,3453,3459,3487,3514,3450,3481,3471,22,12,5132,15648
20150922,3481,3471,3466,3483,3463,3466,3469,-5,-2,2172,15864
20150923,3466,3469,3429,3429,3316,3417,3412,-52,-57,4174,16292
20150924,3417,3412,3425,3440,3415,3428,3425,16,13,3260,16656
20150925,3428,3425,3421,3478,3421,3455,3457,30,32,6704,16888
20150928,3455,3457,3458,3460,3415,3418,3439,-39,-18,2618,17470
20150929,3418,3439,3388,3388,3338,3352,3367,-87,-72,8790,19208
20150930,3352,3367,3366,3380,3355,3357,3366,-10,-1,3330,19388
20151008,3357,3366,3635,3635,3517,3528,3543,162,177,11942,21220
20151009,3528,3543,3493,3546,3491,3533,3517,-10,-26,14436,25188
20151012,3533,3517,3535,3560,3515,3550,3534,33,17,14520,27898
20151013,3550,3534,3549,3559,3493,3509,3517,-25,-17,16014,28500
20151014,3509,3517,3523,3558,3513,3543,3538,26,21,18400,33314
20151015,3543,3538,3543,3567,3539,3544,3554,6,16,19296,38390
20151016,3544,3554,3538,3554,3522,3524,3536,-30,-18,15858,40246
20151019,3524,3536,3536,3545,3504,3507,3523,-29,-13,14850,41024
20151020,3507,3523,3514,3523,3488,3509,3501,-14,-22,10666,40904
20151021,3509,3501,3509,3525,3486,3489,3507,-12,6,14538,41798
20151022,3489,3507,3493,3503,3476,3503,3487,-4,-20,12582,42844
20151023,3503,3487,3502,3544,3487,3543,3511,56,24,25716,47422
20151026,3543,3511,3546,3548,3491,3505,3504,-6,-7,24134,49002
20151027,3505,3504,3508,3520,3499,3510,3508,6,4,13646,51724
20151028,3510,3508,3501,3536,3497,3528,3517,20,9,29090,63362
20151029,3528,3517,3540,3593,3510,3516,3544,-1,27,63016,80176
20151030,3516,3544,3500,3512,3474,3479,3488,-65,-56,49656,94936
20151102,3479,3488,3465,3477,3452,3467,3465,-21,-23,36012,100750
20151103,3467,3465,3465,3469,3443,3460,3458,-5,-7,41038,105698
20151104,3460,3458,3458,3458,3433,3442,3446,-16,-12,37168,110938
20151105,3442,3446,3444,3456,3395,3398,3421,-48,-25,58108,122564
20151106,3398,3421,3399,3410,3382,3403,3396,-18,-25,41378,129390
20151109,3403,3396,3400,3409,3349,3364,3365,-32,-31,95010,139928
20151110,3364,3365,3366,3366,3316,3329,3338,-36,-27,118308,142454
20151111,3329,3338,3323,3344,3300,3333,3318,-5,-20,114916,157724
20151112,3333,3318,3328,3329,3302,3323,3317,5,-1,106000,190264
20151113,3323,3317,3314,3343,3296,3313,3315,-4,-2,185838,222468
20151116,3313,3315,3310,3346,3303,3340,3326,25,11,168652,247748
20151117,3340,3326,3338,3340,3262,3280,3297,-46,-29,229662,293226
20151118,3280,3297,3281,3305,3263,3286,3279,-11,-18,195064,305198
20151119,3286,3279,3278,3294,3251,3288,3275,9,-4,257330,323960
20151120,3288,3275,3273,3311,3260,3296,3292,21,17,328086,343262
20151123,3296,3292,3300,3309,3168,3220,3242,-72,-50,760626,436044
20151124,3220,3242,3209,3237,3184,3223,3212,-19,-30,679588,428796
20151125,3223,3212,3231,3273,3218,3248,3247,36,35,722136,426808
20151126,3248,3247,3234,3288,3216,3258,3248,11,1,737932,434288
20151127,3258,3248,3267,3280,3218,3229,3252,-19,4,618388,476180
20151130,3229,3252,3234,3239,3185,3202,3212,-50,-40,741960,484564
ag1607,20150716,3416,3416,,,,3416,3416,0,0,0,0
20150717,3416,3416,,,,3407,3407,-9,-9,0,0
20150720,3407,3407,3363,3363,3234,3297,3295,-110,-112,16,8
20150721,3297,3295,3337,3337,3282,3282,3292,-13,-3,24,24
20150722,3282,3292,3305,3344,3275,3335,3316,43,24,44,40
20150723,3335,3316,3262,3339,3262,3336,3328,20,12,48,28
20150724,3336,3328,3265,3291,3265,3291,3272,-37,-56,14,38
20150727,3291,3272,3233,3325,3233,3325,3275,53,3,36,36
20150728,3325,3275,3286,3286,3285,3285,3285,10,10,12,24
20150729,3285,3285,,,,3285,3285,0,0,0,24
20150730,3285,3285,3360,3360,3302,3302,3331,17,46,4,26
20150731,3302,3331,,,,3331,3331,0,0,0,26
20150803,3331,3331,,,,3344,3344,13,13,0,26
20150804,3344,3344,3265,3265,3265,3265,3265,-79,-79,2,28
20150805,3265,3265,3288,3292,3288,3292,3290,27,25,4,30
20150806,3292,3290,3303,3303,3268,3268,3289,-22,-1,6,28
20150807,3268,3289,3297,3297,3297,3297,3297,8,8,2,26
20150810,3297,3297,3333,3333,3333,3333,3333,36,36,2,28
20150811,3333,3333,3347,3452,3347,3420,3408,87,75,28,26
20150812,3420,3408,3439,3552,3439,3552,3473,144,65,14,24
20150813,3552,3473,3602,3602,3547,3547,3568,74,95,48,28
20150814,3547,3568,,,,3568,3568,0,0,0,28
20150817,3568,3568,3520,3520,3520,3520,3520,-48,-48,2,28
20150818,3520,3520,3522,3522,3522,3522,3522,2,2,2,28
20150819,3522,3522,3432,3481,3432,3481,3450,-41,-72,8,32
20150820,3481,3450,,,,3523,3523,73,73,0,32
20150821,3523,3523,3562,3572,3550,3572,3561,49,38,6,32
20150824,3572,3561,3530,3530,3530,3530,3530,-31,-31,2,34
20150825,3530,3530,,,,3475,3475,-55,-55,0,34
20150826,3475,3475,3408,3408,3408,3408,3408,-67,-67,2,32
20150827,3408,3408,3323,3323,3323,3323,3323,-85,-85,2,32
20150828,3323,3323,3408,3408,3408,3408,3408,85,85,2,30
20150831,3408,3408,3408,3414,3394,3414,3404,6,-4,22,32
20150901,3414,3404,,,,3396,3396,-8,-8,0,32
20150902,3396,3396,,,,3397,3397,1,1,0,32
20150907,3397,3397,,,,3392,3392,-5,-5,0,32
20150908,3392,3392,,,,3374,3374,-18,-18,0,32
20150909,3374,3374,3450,3450,3450,3450,3450,76,76,2,32
20150910,3450,3450,3400,3400,3400,3400,3400,-50,-50,2,32
20150911,3400,3400,3400,3400,3400,3400,3400,0,0,2,30
20150914,3400,3400,3359,3359,3359,3359,3359,-41,-41,2,30
20150915,3359,3359,3359,3368,3359,3368,3362,9,3,6,34
20150916,3368,3362,3349,3361,3349,3361,3355,-1,-7,4,32
20150917,3361,3355,3399,3436,3399,3420,3420,65,65,8,34
20150918,3420,3420,,,,3460,3460,40,40,0,34
20150921,3460,3460,3486,3493,3461,3473,3483,13,23,12,36
20150922,3473,3483,,,,3481,3481,-2,-2,0,36
20150923,3481,3481,3428,3430,3428,3430,3429,-51,-52,6,32
20150924,3430,3429,,,,3442,3442,13,13,0,32
20150925,3442,3442,3462,3462,3462,3462,3462,20,20,4,32
20150928,3462,3462,,,,3444,3444,-18,-18,0,32
20150929,3444,3444,3390,3390,3373,3373,3379,-71,-65,8,30
20150930,3373,3379,3379,3379,3379,3379,3379,0,0,2,30
20151008,3379,3379,3527,3528,3526,3526,3526,147,147,10,28
20151009,3526,3526,3520,3520,3520,3520,3520,-6,-6,2,30
20151012,3520,3520,3539,3558,3539,3555,3553,35,33,34,52
20151013,3555,3553,,,,3536,3536,-17,-17,0,52
20151014,3536,3536,3553,3553,3539,3539,3546,3,10,20,50
20151015,3539,3546,3563,3565,3562,3562,3562,16,16,18,52
20151016,3562,3562,3551,3555,3549,3549,3552,-13,-10,10,54
20151019,3549,3552,3544,3544,3537,3537,3540,-15,-12,8,54
20151020,3537,3540,3510,3513,3506,3506,3509,-34,-31,6,50
20151021,3506,3509,,,,3515,3515,6,6,0,50
20151022,3515,3515,,,,3495,3495,-20,-20,0,50
20151023,3495,3495,3476,3522,3476,3522,3517,27,22,22,38
20151026,3522,3517,3526,3526,3510,3510,3518,-7,1,12,40
20151027,3510,3518,3526,3526,3526,3526,3526,8,8,2,38
20151028,3526,3526,,,,3535,3535,9,9,0,38
20151029,3535,3535,3568,3569,3531,3549,3551,14,16,16,38
20151030,3549,3551,3512,3512,3489,3489,3500,-62,-51,4,38
20151102,3489,3500,3481,3481,3481,3481,3481,-19,-19,6,36
20151103,3481,3481,3470,3470,3470,3470,3470,-11,-11,4,36
20151104,3470,3470,,,,3470,3470,0,0,0,36
20151105,3470,3470,3441,3441,3405,3405,3418,-65,-52,14,36
20151106,3405,3418,3406,3406,3406,3406,3406,-12,-12,2,36
20151109,3406,3406,3384,3384,3375,3382,3381,-24,-25,10,40
20151110,3382,3381,3347,3347,3347,3347,3347,-34,-34,2,40
20151111,3347,3347,,,,3347,3347,0,0,0,40
20151112,3347,3347,3349,3349,3330,3330,3337,-17,-10,16,34
20151113,3330,3337,,,,3337,3337,0,0,0,34
20151116,3337,3337,3359,3359,3330,3350,3344,13,7,20,32
20151117,3350,3344,3300,3300,3298,3299,3299,-45,-45,8,32
20151118,3299,3299,3298,3298,3298,3298,3298,-1,-1,8,30
20151119,3298,3298,,,,3298,3298,0,0,0,30
20151120,3298,3298,,,,3298,3298,0,0,0,30
20151123,3298,3298,,,,3298,3298,0,0,0,30
20151124,3298,3298,,,,3267,3267,-31,-31,0,30
20151125,3267,3267,3267,3449,3233,3271,3300,4,33,10,30
20151126,3271,3300,3237,3237,3237,3237,3237,-63,-63,4,30
20151127,3237,3237,3292,3292,3292,3292,3292,55,55,2,30
20151130,3292,3292,3187,3219,3187,3219,3203,-73,-89,4,30
ag1608,20150818,3520,3520,,,,3522,3522,2,2,0,0
20150819,3522,3522,3466,3506,3466,3506,3486,-16,-36,4,4
20150820,3506,3486,3550,3550,3518,3546,3539,60,53,8,4
20150821,3546,3539,3609,3609,3561,3605,3595,66,56,8,10
20150824,3605,3595,3507,3551,3500,3500,3523,-95,-72,10,16
20150825,3500,3523,3478,3510,3478,3510,3494,-13,-29,4,16
20150826,3510,3494,3434,3434,3434,3434,3434,-60,-60,2,14
20150827,3434,3434,3389,3389,3389,3389,3389,-45,-45,2,14
20150828,3389,3389,3389,3450,3358,3437,3405,48,16,34,20
20150831,3437,3405,3421,3446,3411,3411,3424,6,19,20,28
20150901,3411,3424,3437,3437,3381,3381,3425,-43,1,10,24
20150902,3381,3425,3415,3416,3411,3411,3413,-14,-12,34,36
20150907,3411,3413,3407,3407,3407,3407,3407,-6,-6,2,34
20150908,3407,3407,3390,3390,3390,3390,3390,-17,-17,2,34
20150909,3390,3390,3446,3462,3417,3417,3443,27,53,38,22
20150910,3417,3443,3394,3429,3383,3429,3396,-14,-47,12,30
20150911,3429,3396,3401,3421,3401,3421,3412,25,16,16,26
20150914,3421,3412,3390,3390,3344,3383,3372,-29,-40,34,40
20150915,3383,3372,3390,3390,3390,3390,3390,18,18,2,40
20150916,3390,3390,,,,3382,3382,-8,-8,0,40
20150917,3382,3382,3441,3456,3441,3445,3451,63,69,44,44
20150918,3445,3451,3458,3484,3458,3480,3474,29,23,6,44
20150921,3480,3474,3508,3508,3487,3487,3492,13,18,10,44
20150922,3487,3492,3492,3492,3492,3492,3492,0,0,4,44
20150923,3492,3492,3447,3447,3447,3447,3447,-45,-45,4,44
20150924,3447,3447,,,,3460,3460,13,13,0,44
20150925,3460,3460,3480,3487,3480,3487,3483,27,23,4,44
20150928,3487,3483,3473,3481,3466,3468,3473,-15,-10,10,44
20150929,3468,3473,3396,3402,3396,3399,3399,-74,-74,8,44
20150930,3399,3399,,,,3399,3399,0,0,0,44
20151008,3399,3399,3565,3565,3543,3543,3557,144,158,8,48
20151009,3543,3557,3549,3560,3549,3560,3554,3,-3,4,48
20151012,3560,3554,,,,3554,3554,0,0,0,48
20151013,3554,3554,,,,3554,3554,0,0,0,48
20151014,3554,3554,,,,3564,3564,10,10,0,48
20151015,3564,3564,3566,3566,3553,3553,3555,-11,-9,10,46
20151016,3553,3555,3532,3532,3532,3532,3532,-23,-23,2,46
20151019,3532,3532,3530,3530,3515,3515,3522,-17,-10,4,46
20151020,3515,3522,3518,3526,3513,3526,3519,4,-3,6,42
20151021,3526,3519,3516,3516,3516,3516,3516,-3,-3,2,42
20151022,3516,3516,,,,3496,3496,-20,-20,0,42
20151023,3496,3496,,,,3518,3518,22,22,0,42
20151026,3518,3518,,,,3519,3519,1,1,0,42
20151027,3519,3519,,,,3527,3527,8,8,0,42
20151028,3527,3527,,,,3536,3536,9,9,0,42
20151029,3536,3536,3588,3588,3579,3579,3583,43,47,4,42
20151030,3579,3583,,,,3532,3532,-51,-51,0,42
20151102,3532,3532,3486,3495,3486,3495,3492,-37,-40,8,48
20151103,3495,3492,,,,3480,3480,-12,-12,0,48
20151104,3480,3480,,,,3468,3468,-12,-12,0,48
20151105,3468,3468,3408,3466,3408,3463,3445,-5,-23,6,52
20151106,3463,3445,,,,3432,3432,-13,-13,0,52
20151109,3432,3432,3398,3399,3379,3389,3390,-43,-42,20,54
20151110,3389,3390,3381,3381,3350,3350,3367,-40,-23,18,48
20151111,3350,3367,3334,3360,3334,3356,3350,-11,-17,6,46
20151112,3356,3350,3350,3351,3340,3340,3346,-10,-4,34,64
20151113,3340,3346,3359,3359,3334,3334,3346,-12,0,4,62
20151116,3334,3346,,,,3353,3353,7,7,0,62
20151117,3353,3353,,,,3308,3308,-45,-45,0,62
20151118,3308,3308,3304,3304,3298,3299,3301,-9,-7,10,62
20151119,3299,3301,3294,3308,3294,3308,3301,7,0,4,58
20151120,3308,3301,3330,3363,3320,3320,3337,19,36,30,76
20151123,3320,3337,3320,3320,3239,3245,3307,-92,-30,42,76
20151124,3245,3307,3251,3260,3219,3246,3241,-61,-66,16,80
20151125,3246,3241,3250,3250,3250,3250,3250,9,9,2,78
20151126,3250,3250,,,,3187,3187,-63,-63,0,78
20151127,3187,3187,3257,3257,3211,3211,3234,24,47,4,80
20151130,3211,3234,,,,3146,3146,-88,-88,0,80
ag1609,20150916,3390,3390,,,,3390,3390,0,0,0,0
20150917,3390,3390,,,,3459,3459,69,69,0,0
20150918,3459,3459,,,,3482,3482,23,23,0,0
20150921,3482,3482,3537,3537,3443,3471,3478,-11,-4,10,8
20150922,3471,3478,3464,3469,3464,3469,3466,-9,-12,6,12
20150923,3469,3466,3451,3453,3421,3421,3436,-45,-30,8,10
20150924,3421,3436,3460,3460,3460,3460,3460,24,24,2,10
20150925,3460,3460,3464,3495,3464,3495,3487,35,27,8,10
20150928,3495,3487,,,,3477,3477,-10,-10,0,10
20150929,3477,3477,3400,3400,3400,3400,3400,-77,-77,12,22
20150930,3400,3400,3401,3401,3395,3395,3397,-5,-3,6,22
20151008,3395,3397,3588,3588,3539,3539,3547,142,150,12,28
20151009,3539,3547,3516,3548,3516,3548,3538,1,-9,16,22
20151012,3548,3538,3545,3561,3535,3561,3550,23,12,18,30
20151013,3561,3550,3519,3549,3519,3544,3538,-6,-12,14,28
20151014,3544,3538,3551,3574,3551,3574,3562,36,24,16,38
20151015,3574,3562,3570,3584,3570,3584,3577,22,15,4,40
20151016,3584,3577,3560,3560,3558,3558,3558,-19,-19,14,48
20151019,3558,3558,3558,3558,3543,3543,3551,-15,-7,10,52
20151020,3543,3551,,,,3550,3550,-1,-1,0,52
20151021,3550,3550,3552,3553,3540,3540,3544,-10,-6,12,44
20151022,3540,3544,3527,3527,3511,3520,3518,-24,-26,14,46
20151023,3520,3518,3533,3564,3528,3555,3538,37,20,36,46
20151026,3555,3538,3540,3540,3527,3527,3530,-11,-8,10,50
20151027,3527,3530,3537,3537,3537,3537,3537,7,7,2,48
20151028,3537,3537,3534,3548,3534,3548,3543,11,6,8,46
20151029,3548,3543,3558,3621,3554,3554,3578,11,35,34,48
20151030,3554,3578,3543,3543,3535,3535,3537,-43,-41,10,46
20151102,3535,3537,3509,3514,3501,3501,3507,-36,-30,10,48
20151103,3501,3507,3500,3510,3483,3495,3495,-12,-12,16,50
20151104,3495,3495,3477,3490,3477,3490,3483,-5,-12,4,50
20151105,3490,3483,3483,3486,3414,3414,3456,-69,-27,40,58
20151106,3414,3456,3424,3442,3424,3436,3431,-20,-25,26,62
20151109,3436,3431,3431,3431,3392,3393,3401,-38,-30,20,68
20151110,3393,3401,3357,3375,3357,3362,3364,-39,-37,6,72
20151111,3362,3364,3348,3374,3347,3362,3354,-2,-10,12,70
20151112,3362,3354,3363,3394,3317,3351,3353,-3,-1,30,74
20151113,3351,3353,3335,3368,3327,3368,3343,15,-10,6,74
20151116,3368,3343,3369,3371,3347,3371,3362,28,19,6,72
20151117,3371,3362,3353,3353,3300,3336,3334,-26,-28,12,76
20151118,3336,3334,3318,3318,3292,3311,3303,-23,-31,18,74
20151119,3311,3303,3325,3353,3320,3324,3334,21,31,276,176
20151120,3324,3334,3305,3343,3290,3334,3296,0,-38,152,78
20151123,3334,3296,3331,3331,3251,3251,3278,-45,-18,22,76
20151124,3251,3278,3241,3261,3227,3244,3238,-34,-40,34,78
20151125,3244,3238,3277,3285,3276,3277,3280,39,42,16,80
20151126,3277,3280,3268,3313,3239,3291,3288,11,8,66,94
20151127,3291,3288,3283,3283,3269,3269,3273,-19,-15,18,88
20151130,3269,3273,,,,3273,3273,0,0,0,88
ag1610,20151016,3577,3577,,,,3558,3558,-19,-19,0,0
20151019,3558,3558,,,,3558,3558,0,0,0,0
20151020,3558,3558,,,,3558,3558,0,0,0,0
20151021,3558,3558,,,,3552,3552,-6,-6,0,0
20151022,3552,3552,,,,3535,3535,-17,-17,0,0
20151023,3535,3535,,,,3535,3535,0,0,0,0
20151026,3535,3535,,,,3535,3535,0,0,0,0
20151027,3535,3535,3499,3499,3499,3499,3499,-36,-36,2,2
20151028,3499,3499,3546,3546,3546,3546,3546,47,47,2,0
20151029,3546,3546,,,,3581,3581,35,35,0,0
20151030,3581,3581,,,,3540,3540,-41,-41,0,0
20151102,3540,3540,,,,3510,3510,-30,-30,0,0
20151103,3510,3510,,,,3498,3498,-12,-12,0,0
20151104,3498,3498,,,,3486,3486,-12,-12,0,0
20151105,3486,3486,3427,3427,3427,3427,3427,-59,-59,2,2
20151106,3427,3427,3440,3440,3440,3440,3440,13,13,2,4
20151109,3440,3440,,,,3410,3410,-30,-30,0,4
20151110,3410,3410,3392,3392,3342,3389,3385,-21,-25,24,24
20151111,3389,3385,3388,3388,3318,3353,3355,-32,-30,28,22
20151112,3353,3355,,,,3354,3354,-1,-1,0,22
20151113,3354,3354,,,,3354,3354,0,0,0,22
20151116,3354,3354,,,,3373,3373,19,19,0,22
20151117,3373,3373,,,,3345,3345,-28,-28,0,22
20151118,3345,3345,3305,3305,3305,3305,3305,-40,-40,2,22
20151119,3305,3305,,,,3337,3337,32,32,0,22
20151120,3337,3337,3352,3352,3352,3352,3352,15,15,4,26
20151123,3352,3352,3278,3278,3206,3206,3263,-146,-89,102,106
20151124,3206,3263,3228,3241,3228,3241,3230,-22,-33,12,106
20151125,3241,3230,3275,3296,3262,3295,3283,65,53,30,112
20151126,3295,3283,3317,3317,3295,3295,3306,12,23,4,112
20151127,3295,3306,3285,3285,3285,3285,3285,-21,-21,2,114
20151130,3285,3285,3249,3255,3249,3249,3250,-36,-35,10,116
ag1611,20151117,3373,3373,,,,3373,3373,0,0,0,0
20151118,3373,3373,3276,3338,3276,3338,3307,-35,-66,4,2
20151119,3338,3307,,,,3339,3339,32,32,0,2
20151120,3339,3339,3299,3366,3299,3363,3342,24,3,6,4
20151123,3363,3342,3364,3371,3264,3264,3336,-78,-6,62,52
20151124,3264,3336,3253,3303,3235,3290,3258,-46,-78,114,48
20151125,3290,3258,3263,3263,3263,3263,3263,5,5,4,50
20151126,3263,3263,3307,3349,3291,3291,3322,28,59,10,52
20151127,3291,3322,,,,3322,3322,0,0,0,52
20151130,3322,3322,3236,3287,3236,3270,3246,-52,-76,28,36
al1501,20150105,12985,12945,12840,12855,12795,12825,12820,-120,-125,6448,31110
20150106,12825,12820,12695,12780,12685,12750,12760,-70,-60,6550,30380
20150107,12750,12760,12750,12750,12665,12675,12695,-85,-65,6980,30270
20150108,12675,12695,12700,12755,12700,12745,12730,50,35,4430,30120
20150109,12745,12730,12800,12835,12755,12825,12800,95,70,4460,27510
20150112,12825,12800,12830,12835,12655,12715,12760,-85,-40,7410,21490
20150113,12715,12760,12730,12730,12655,12685,12680,-75,-80,5190,17130
20150114,12685,12680,12690,12690,12415,12555,12570,-125,-110,3670,15080
20150115,12555,12570,12630,12980,12610,12980,12665,410,95,3260,13690
al1502,20150105,12990,13005,12800,12915,12800,12820,12865,-185,-140,21150,74594
20150106,12820,12865,12785,12835,12705,12795,12790,-70,-75,22450,69198
20150107,12795,12790,12775,12805,12695,12700,12730,-90,-60,12984,66630
20150108,12700,12730,12740,12790,12710,12770,12745,40,15,8760,65650
20150109,12770,12745,12790,12855,12740,12830,12805,85,60,8564,64112
20150112,12830,12805,12800,12820,12725,12725,12765,-80,-40,8076,62552
20150113,12725,12765,12700,12740,12660,12715,12685,-50,-80,12266,57786
20150114,12715,12685,12650,12730,12435,12585,12570,-100,-115,14526,54404
20150115,12585,12570,12650,12940,12615,12780,12720,210,150,11512,50330
20150116,12780,12720,12855,12855,12720,12760,12770,40,50,6318,48540
20150119,12760,12770,12790,12900,12790,12800,12820,30,50,5646,46930
20150120,12800,12820,12755,12805,12730,12735,12760,-85,-60,4384,45694
20150121,12735,12760,12805,12810,12710,12730,12735,-30,-25,3848,44790
20150122,12730,12735,12720,12800,12695,12780,12770,45,35,3680,43728
20150123,12780,12770,12790,12815,12745,12760,12765,-10,-5,7312,41156
20150126,12760,12765,12705,12745,12665,12700,12705,-65,-60,8728,37726
20150127,12700,12705,12715,12835,12715,12770,12770,65,65,4748,38258
20150128,12770,12770,12675,12780,12675,12770,12735,0,-35,5084,37318
20150129,12770,12735,12760,12760,12710,12710,12725,-25,-10,2784,36156
20150130,12710,12725,12740,12760,12650,12760,12690,35,-35,5536,34050
20150202,12760,12690,12750,12800,12700,12785,12745,95,55,5570,32190
20150203,12785,12745,12820,13080,12820,13080,12965,335,220,6520,28780
20150204,13080,12965,13010,13120,13010,13120,13085,155,120,5630,25890
20150205,13120,13085,13055,13185,13055,13100,13130,15,45,6920,24060
20150206,13100,13130,13110,13250,13100,13210,13205,80,75,6340,19030
20150209,13210,13205,13190,13190,13145,13145,13160,-60,-45,2770,16610
20150210,13145,13160,13145,13150,13005,13055,13100,-105,-60,4300,13830
al1503,20150105,13060,13080,12970,12985,12860,12895,12915,-185,-165,56386,157426
20150106,12895,12915,12860,12880,12800,12845,12835,-70,-80,56276,160562
20150107,12845,12835,12800,12860,12760,12760,12790,-75,-45,63712,168550
20150108,12760,12790,12780,12845,12755,12805,12800,15,10,47172,166856
20150109,12805,12800,12850,12900,12780,12855,12845,55,45,62750,161134
20150112,12855,12845,12840,12855,12760,12770,12805,-75,-40,41144,162158
20150113,12770,12805,12705,12770,12685,12750,12725,-55,-80,55832,160048
20150114,12750,12725,12700,12755,12445,12620,12605,-105,-120,115790,155188
20150115,12620,12605,12670,13005,12665,12840,12770,235,165,96998,139916
20150116,12840,12770,12930,12930,12765,12820,12815,50,45,44358,136906
20150119,12820,12815,12840,12950,12825,12845,12870,30,55,45928,135432
20150120,12845,12870,12835,12850,12765,12775,12805,-95,-65,33438,133104
20150121,12775,12805,12820,12850,12745,12775,12785,-30,-20,36746,128830
20150122,12775,12785,12760,12855,12740,12825,12805,40,20,34910,126454
20150123,12825,12805,12880,12880,12795,12815,12820,10,15,30180,122420
20150126,12815,12820,12790,12805,12710,12775,12765,-45,-55,34984,119076
20150127,12775,12765,12800,12895,12765,12840,12830,75,65,39482,111106
20150128,12840,12830,12800,12830,12750,12805,12800,-25,-30,28512,104836
20150129,12805,12800,12830,12830,12765,12775,12785,-25,-15,18054,100328
20150130,12775,12785,12850,12850,12715,12740,12750,-45,-35,18062,92764
20150202,12740,12750,12790,12850,12775,12840,12805,90,55,21278,83840
20150203,12840,12805,12840,13170,12835,13140,12985,335,180,25956,75960
20150204,13140,12985,13300,13300,13055,13165,13130,180,145,15632,72262
20150205,13165,13130,13160,13270,13115,13170,13175,40,45,21654,72734
20150206,13170,13175,13150,13305,13130,13285,13255,110,80,15496,69634
20150209,13285,13255,13275,13280,13155,13175,13205,-80,-50,8858,67276
20150210,13175,13205,13190,13200,13060,13060,13125,-145,-80,9114,65570
20150211,13060,13125,13080,13100,12980,12990,13010,-135,-115,5622,63928
20150212,12990,13010,12995,12995,12905,12925,12930,-85,-80,6656,62432
20150213,12925,12930,12960,13160,12940,13025,13005,95,75,4780,61288
20150216,13025,13005,13000,13085,12975,12995,13000,-10,-5,5792,58714
20150217,12995,13000,12990,13030,12945,13000,12980,0,-20,3674,57044
20150225,13000,12980,12975,13035,12925,12935,12955,-45,-25,3894,54902
20150226,12935,12955,12900,12960,12875,12950,12915,-5,-40,10444,51840
20150227,12950,12915,12965,12970,12890,12890,12910,-25,-5,7094,48764
20150302,12890,12910,12880,13030,12870,13020,12945,110,35,7854,46360
20150303,13020,12945,12960,12995,12940,12950,12950,5,5,5410,43590
20150304,12950,12950,12920,12950,12865,12900,12905,-50,-45,9560,38300
20150305,12900,12905,12935,12935,12880,12905,12895,0,-10,4320,35780
20150306,12905,12895,12930,12940,12890,12900,12900,5,5,3470,35610
20150309,12900,12900,12900,12900,12860,12890,12875,-10,-25,3490,35310
20150310,12890,12875,12870,12920,12870,12885,12900,10,25,5770,33060
20150311,12885,12900,12850,12895,12850,12895,12880,-5,-20,5620,29640
20150312,12895,12880,12885,13035,12880,13035,12945,155,65,7410,24780
20150313,13035,12945,13300,13300,13080,13150,13135,205,190,5990,21810
20150316,13150,13135,13200,13200,13020,13020,13100,-115,-35,4500,19750
al1504,20150105,13150,13170,13040,13060,12930,12960,12985,-210,-185,17198,64838
20150106,12960,12985,12800,12940,12800,12910,12895,-75,-90,17314,66700
20150107,12910,12895,12805,12915,12805,12835,12855,-60,-40,13988,72578
20150108,12835,12855,12880,12905,12820,12865,12865,10,10,14084,75198
20150109,12865,12865,12885,12950,12840,12920,12905,55,40,19124,78452
20150112,12920,12905,12875,12910,12815,12820,12855,-85,-50,14668,81676
20150113,12820,12855,12805,12810,12730,12795,12770,-60,-85,19772,84996
20150114,12795,12770,12720,12805,12520,12680,12670,-90,-100,38696,90928
20150115,12680,12670,12745,13150,12745,12905,12830,235,160,35458,92022
20150116,12905,12830,12920,12995,12830,12870,12880,40,50,19586,95748
20150119,12870,12880,12890,13000,12885,12915,12930,35,50,27350,101216
20150120,12915,12930,12880,12905,12830,12850,12870,-80,-60,22626,105000
20150121,12850,12870,12905,12915,12810,12830,12845,-40,-25,27342,110710
20150122,12830,12845,12830,12920,12800,12880,12870,35,25,25612,116826
20150123,12880,12870,12900,12920,12855,12875,12880,5,10,24880,118540
20150126,12875,12880,12865,12865,12765,12825,12815,-55,-65,33432,123432
20150127,12825,12815,12840,12960,12815,12900,12890,85,75,39026,131160
20150128,12900,12890,12855,12890,12800,12865,12850,-25,-40,27478,134836
20150129,12865,12850,12870,12875,12815,12830,12840,-20,-10,18792,136722
20150130,12830,12840,12820,12835,12770,12810,12795,-30,-45,29420,143652
20150202,12810,12795,12855,12910,12835,12885,12865,90,70,35638,144530
20150203,12885,12865,12890,13300,12885,13160,13040,295,175,63988,142264
20150204,13160,13040,13200,13250,13105,13225,13180,185,140,48574,141478
20150205,13225,13180,13200,13350,13180,13235,13250,55,70,75206,135176
20150206,13235,13250,13200,13375,13195,13360,13310,110,60,46732,131290
20150209,13360,13310,13350,13350,13220,13235,13270,-75,-40,34228,124518
20150210,13235,13270,13250,13255,13125,13155,13185,-115,-85,30268,118844
20150211,13155,13185,13125,13160,13030,13035,13070,-150,-115,33430,117494
20150212,13035,13070,13030,13045,12960,12990,12990,-80,-80,29642,116708
20150213,12990,12990,13035,13115,13000,13080,13060,90,70,29074,112718
20150216,13080,13060,13085,13135,13035,13060,13065,0,5,21448,109892
20150217,13060,13065,13050,13095,12995,13060,13035,-5,-30,19590,110034
20150225,13060,13035,13035,13145,12975,12990,13010,-45,-25,16314,108462
20150226,12990,13010,12920,13005,12905,12980,12950,-30,-60,33526,104990
20150227,12980,12950,13025,13025,12925,12930,12955,-20,5,22422,100432
20150302,12930,12955,12930,13060,12910,13050,12980,95,25,21930,93708
20150303,13050,12980,13010,13040,12960,12965,12990,-15,10,19046,89718
20150304,12965,12990,12950,12965,12885,12890,12925,-100,-65,14300,88492
20150305,12890,12925,12930,12975,12900,12930,12925,5,0,8030,88514
20150306,12930,12925,12945,12965,12890,12890,12920,-35,-5,6176,89632
20150309,12890,12920,12915,12925,12845,12900,12880,-20,-40,11398,84678
20150310,12900,12880,12865,12945,12850,12885,12900,5,20,7240,82938
20150311,12885,12900,12840,12920,12840,12885,12870,-15,-30,9130,78810
20150312,12885,12870,12890,13245,12860,13100,12975,230,105,15388,72642
20150313,13100,12975,13070,13170,13025,13075,13110,100,135,16878,66712
20150316,13075,13110,13065,13125,13050,13075,13075,-35,-35,8122,66124
20150317,13075,13075,13040,13105,13040,13070,13070,-5,-5,5532,65856
20150318,13070,13070,13030,13130,13030,13120,13110,50,40,7576,62092
20150319,13120,13110,13115,13310,13090,13220,13230,110,120,10288,57722
20150320,13220,13230,13275,13360,13220,13265,13305,35,75,14968,53720
20150323,13265,13305,13235,13345,13235,13260,13295,-45,-10,5880,51588
20150324,13260,13295,13290,13320,13235,13310,13295,15,0,3940,50998
20150325,13310,13295,13305,13320,13275,13320,13285,25,-10,2556,49752
20150326,13320,13285,13285,13325,13265,13320,13300,35,15,3822,47936
20150327,13320,13300,13340,13370,13320,13355,13345,55,45,4906,45990
20150330,13355,13345,13340,13360,13325,13330,13335,-15,-10,7068,41954
20150331,13330,13335,12840,13420,12840,13300,13385,-35,50,7680,39242
20150401,13300,13385,13340,13395,13340,13380,13380,-5,-5,2632,38310
20150402,13380,13380,13385,13395,13385,13390,13390,10,10,2530,38110
20150403,13390,13390,13375,13395,13375,13390,13385,0,-5,1610,37270
20150407,13390,13385,13400,13435,13395,13400,13400,15,15,3830,36680
20150408,13400,13400,13390,13400,13365,13370,13385,-30,-15,2880,36460
20150409,13370,13385,13340,13340,13070,13225,13185,-160,-200,6490,35240
20150410,13225,13185,13200,13275,13190,13250,13225,65,40,5580,31970
20150413,13250,13225,13320,13320,13000,13080,13165,-145,-60,5820,27380
20150414,13080,13165,13095,13165,12960,13020,13025,-145,-140,4490,25050
20150415,13020,13025,12890,13085,12890,13085,13035,60,10,4240,22180
al1505,20150105,13230,13245,13060,13140,13005,13045,13050,-200,-195,10872,27294
20150106,13045,13050,13000,13000,12900,12975,12950,-75,-100,13998,33784
20150107,12975,12950,12910,12970,12900,12900,12920,-50,-30,7468,36536
20150108,12900,12920,12940,12970,12880,12925,12930,5,10,6156,38006
20150109,12925,12930,12950,13005,12900,12970,12965,40,35,7792,40370
20150112,12970,12965,12965,12965,12870,12870,12915,-95,-50,6412,42762
20150113,12870,12915,12835,12860,12785,12840,12820,-75,-95,9098,46488
20150114,12840,12820,12780,12865,12580,12745,12725,-75,-95,15684,52028
20150115,12745,12725,12815,13105,12800,12965,12895,240,170,12486,54592
20150116,12965,12895,13015,13020,12895,12930,12940,35,45,12426,57460
20150119,12930,12940,12960,13060,12955,12985,12990,45,50,9632,58586
20150120,12985,12990,12965,12965,12890,12910,12935,-80,-55,7668,58898
20150121,12910,12935,12950,12970,12860,12890,12905,-45,-30,8940,61206
20150122,12890,12905,12890,12970,12865,12940,12935,35,30,9746,64088
20150123,12940,12935,12960,12980,12915,12925,12935,-10,0,11128,67690
20150126,12925,12935,12870,12915,12830,12870,12875,-65,-60,15288,70346
20150127,12870,12875,12850,13020,12850,12955,12945,80,70,19062,74036
20150128,12955,12945,12970,12970,12870,12920,12915,-25,-30,11336,76366
20150129,12920,12915,12915,12935,12880,12900,12900,-15,-15,6770,77998
20150130,12900,12900,12900,12905,12835,12860,12860,-40,-40,13406,83798
20150202,12860,12860,12915,12970,12895,12945,12925,85,65,13624,86336
20150203,12945,12925,12945,13250,12945,13225,13085,300,160,28112,87360
20150204,13225,13085,13275,13300,13165,13285,13240,200,155,23392,84764
20150205,13285,13240,13280,13415,13235,13295,13315,55,75,36568,85494
20150206,13295,13315,13275,13420,13240,13405,13365,90,50,21998,89162
20150209,13405,13365,13395,13400,13270,13290,13325,-75,-40,13160,88252
20150210,13290,13325,13290,13305,13180,13200,13230,-125,-95,17710,90114
20150211,13200,13230,13190,13210,13065,13070,13120,-160,-110,19850,94602
20150212,13070,13120,13080,13085,13005,13025,13030,-95,-90,18174,96188
20150213,13025,13030,13070,13150,13045,13115,13100,85,70,17462,98308
20150216,13115,13100,13115,13165,13070,13100,13100,0,0,11524,98540
20150217,13100,13100,13085,13125,13030,13095,13075,-5,-25,9794,99158
20150225,13095,13075,13100,13165,13005,13020,13050,-55,-25,13210,103128
20150226,13020,13050,13000,13045,12955,13025,12995,-25,-55,27288,111168
20150227,13025,12995,13045,13055,12965,12965,13000,-30,5,26980,119332
20150302,12965,13000,12960,13100,12955,13095,13030,95,30,45394,124192
20150303,13095,13030,13080,13085,13005,13020,13040,-10,10,36124,124222
20150304,13020,13040,13000,13020,12925,12970,12960,-70,-80,43946,124584
20150305,12970,12960,12970,13020,12940,12975,12965,15,5,27402,121018
20150306,12975,12965,12985,13020,12940,12940,12965,-25,0,19934,121236
20150309,12940,12965,12950,12965,12880,12940,12920,-25,-45,33936,126206
20150310,12940,12920,12925,12995,12890,12915,12935,-5,15,31078,123238
20150311,12915,12935,12880,12925,12865,12900,12900,-35,-35,25678,123242
20150312,12900,12900,12920,13290,12890,13120,13005,220,105,58044,116542
20150313,13120,13005,13100,13200,13045,13110,13130,105,125,54878,110196
20150316,13110,13130,13095,13150,13065,13100,13105,-30,-25,35454,109868
20150317,13100,13105,13080,13130,13070,13090,13100,-15,-5,31158,113148
20150318,13090,13100,13080,13160,13060,13140,13130,40,30,29222,110184
20150319,13140,13130,13130,13340,13105,13290,13235,160,105,59452,109150
20150320,13290,13235,13300,13400,13250,13265,13315,30,80,46606,104086
20150323,13265,13315,13295,13360,13235,13280,13295,-35,-20,33886,100234
20150324,13280,13295,13310,13335,13260,13310,13300,15,5,19526,93602
20150325,13310,13300,13315,13335,13270,13300,13285,0,-15,11570,91374
20150326,13300,13285,13270,13330,13250,13320,13290,35,5,10674,90536
20150327,13320,13290,13290,13385,13290,13345,13330,55,40,12626,86048
20150330,13345,13330,13325,13345,13300,13345,13325,15,-5,9372,83598
20150331,13345,13325,13335,13425,13320,13375,13385,50,60,22828,77528
20150401,13375,13385,13375,13410,13345,13380,13385,-5,0,7874,74472
20150402,13380,13385,13370,13410,13350,13385,13385,0,0,7254,71644
20150403,13385,13385,13385,13400,13375,13395,13385,10,0,4484,70516
20150407,13395,13385,13395,13455,13395,13420,13420,35,35,4346,68654
20150408,13420,13420,13440,13445,13385,13390,13395,-30,-25,4826,66862
20150409,13390,13395,13350,13375,13070,13270,13220,-125,-175,13766,64606
20150410,13270,13220,13240,13285,13210,13260,13240,40,20,5016,63852
20150413,13260,13240,13250,13265,13100,13105,13160,-135,-80,7846,62186
20150414,13105,13160,13145,13145,13005,13040,13055,-120,-105,11366,58468
20150415,13040,13055,13050,13100,13005,13040,13055,-15,0,5352,57452
20150416,13040,13055,13065,13170,13050,13135,13120,80,65,5126,56098
20150417,13135,13120,13195,13245,13160,13195,13205,75,85,6832,54040
20150420,13195,13205,13160,13205,13070,13125,13115,-80,-90,5488,53678
20150421,13125,13115,13105,13125,13070,13095,13085,-20,-30,2590,53274
20150422,13095,13085,13025,13150,13025,13150,13110,65,25,3450,52590
20150423,13150,13110,13120,13225,13105,13215,13180,105,70,7744,49268
20150424,13215,13180,13215,13225,13165,13220,13205,40,25,2510,48050
20150427,13220,13205,13250,13350,13240,13325,13305,120,100,12798,44092
20150428,13325,13305,13335,13370,13250,13280,13300,-25,-5,5692,41306
20150429,13280,13300,13360,13370,13250,13260,13300,-40,0,6280,39488
20150430,13260,13300,13265,13320,13260,13280,13285,-20,-15,5790,36928
20150504,13280,13285,13360,13365,13300,13340,13340,55,55,5108,36610
20150505,13340,13340,13350,13350,13275,13275,13295,-65,-45,3370,36750
20150506,13275,13295,13300,13455,13300,13445,13405,150,110,13220,40330
20150507,13445,13405,13370,13380,13300,13350,13335,-55,-70,3260,39470
20150508,13350,13335,13350,13355,13320,13320,13335,-15,0,1350,39690
20150511,13320,13335,13350,13385,13260,13305,13295,-30,-40,5710,39550
20150512,13305,13295,13300,13300,13055,13215,13205,-80,-90,5350,37800
20150513,13215,13205,13240,13255,13210,13250,13220,45,15,2900,36800
20150514,13250,13220,13280,13280,13145,13175,13190,-45,-30,3990,34250
20150515,13175,13190,13065,13230,13065,13230,13200,40,10,3740,31520
al1506,20150105,13320,13325,13295,13295,13070,13100,13110,-225,-215,1594,4830
20150106,13100,13110,13040,13060,13000,13050,13020,-60,-90,2048,6230
20150107,13050,13020,13000,13030,12965,12970,12980,-50,-40,2818,7366
20150108,12970,12980,12990,13035,12955,13000,12990,20,10,1014,7638
20150109,13000,12990,13010,13065,12970,13040,13025,50,35,1438,8058
20150112,13040,13025,13015,13020,12935,12950,12960,-75,-65,952,8682
20150113,12950,12960,12875,12915,12855,12890,12880,-70,-80,5178,12238
20150114,12890,12880,12860,12930,12680,12805,12795,-75,-85,7874,16802
20150115,12805,12795,12880,13140,12880,13030,12950,235,155,4388,17202
20150116,13030,12950,13050,13080,12965,13000,13005,50,55,3816,17700
20150119,13000,13005,13030,13120,13025,13055,13050,50,45,3080,19236
20150120,13055,13050,13000,13025,12950,12965,12995,-85,-55,3002,20474
20150121,12965,12995,12980,13025,12930,12970,12975,-25,-20,2942,22218
20150122,12970,12975,12920,13025,12920,13005,12990,30,15,3090,23174
20150123,13005,12990,13020,13050,12975,12990,13000,0,10,2922,23990
20150126,12990,13000,12960,12975,12890,12950,12935,-50,-65,2950,25188
20150127,12950,12935,12955,13065,12950,13015,13000,80,65,5082,26688
20150128,13015,13000,12970,13005,12955,12985,12970,-15,-30,3362,27610
20150129,12985,12970,12985,12985,12940,12955,12960,-15,-10,1222,28140
20150130,12955,12960,12945,12950,12900,12915,12915,-45,-45,3172,29246
20150202,12915,12915,12960,13020,12955,12990,12985,75,70,3182,29786
20150203,12990,12985,13015,13265,12995,13265,13140,280,155,8074,31180
20150204,13265,13140,13265,13360,13215,13360,13290,220,150,4956,30894
20150205,13360,13290,13340,13465,13285,13340,13350,50,60,6718,31572
20150206,13340,13350,13305,13465,13290,13450,13405,100,55,4770,32368
20150209,13450,13405,13475,13475,13315,13370,13355,-35,-50,3290,33736
20150210,13370,13355,13355,13355,13230,13245,13275,-110,-80,4528,33572
20150211,13245,13275,13240,13250,13120,13120,13160,-155,-115,4562,34988
20150212,13120,13160,13135,13135,13045,13060,13065,-100,-95,5682,37888
20150213,13060,13065,13070,13180,13070,13125,13140,60,75,4646,38692
20150216,13125,13140,13125,13190,13110,13130,13130,-10,-10,5184,40096
20150217,13130,13130,13115,13155,13065,13140,13105,10,-25,4174,41080
20150225,13140,13105,13115,13145,13040,13060,13070,-45,-35,4746,41056
20150226,13060,13070,13020,13080,12990,13075,13030,5,-40,6108,42396
20150227,13075,13030,13120,13120,13010,13020,13045,-10,15,9114,46458
20150302,13020,13045,13020,13145,13000,13145,13090,100,45,12498,50278
20150303,13145,13090,13120,13130,13070,13075,13085,-15,-5,9338,54378
20150304,13075,13085,13050,13065,12980,13020,13020,-65,-65,12756,59552
20150305,13020,13020,13050,13070,13000,13030,13015,10,-5,14794,61708
20150306,13030,13015,13040,13070,12990,13005,13020,-10,5,9444,61548
20150309,13005,13020,13005,13010,12940,12995,12975,-25,-45,16696,66714
20150310,12995,12975,12980,13040,12940,12965,12985,-10,10,17690,68716
20150311,12965,12985,12930,12975,12925,12940,12950,-45,-35,11510,70116
20150312,12940,12950,12940,13290,12935,13195,13050,245,100,30972,76592
20150313,13195,13050,13175,13230,13080,13145,13160,95,110,30270,77974
20150316,13145,13160,13145,13180,13090,13120,13125,-40,-35,21196,82132
20150317,13120,13125,13090,13150,13090,13095,13115,-30,-10,12958,84370
20150318,13095,13115,13085,13180,13080,13160,13150,45,35,20300,88450
20150319,13160,13150,13145,13360,13130,13315,13270,165,120,50440,101974
20150320,13315,13270,13350,13400,13255,13265,13325,-5,55,54718,110252
20150323,13265,13325,13285,13365,13230,13295,13300,-30,-25,52396,117938
20150324,13295,13300,13300,13345,13270,13315,13305,15,5,35658,120410
20150325,13315,13305,13325,13350,13270,13315,13290,10,-15,24568,123150
20150326,13315,13290,13300,13325,13250,13300,13280,10,-10,31306,122146
20150327,13300,13280,13380,13380,13300,13330,13325,50,45,29912,120896
20150330,13330,13325,13300,13340,13285,13310,13315,-15,-10,26856,120146
20150331,13310,13315,13315,13420,13310,13370,13375,55,60,58312,126646
20150401,13370,13375,13360,13405,13330,13370,13370,-5,-5,25522,125400
20150402,13370,13370,13350,13400,13330,13370,13370,0,0,27312,128402
20150403,13370,13370,13365,13385,13355,13375,13365,5,-5,17410,125408
20150407,13375,13365,13380,13445,13365,13410,13405,45,40,16288,125520
20150408,13410,13405,13405,13435,13370,13385,13390,-20,-15,18402,123756
20150409,13385,13390,13315,13365,13050,13255,13200,-135,-190,97334,120416
20150410,13255,13200,13245,13275,13180,13265,13230,65,30,31024,114990
20150413,13265,13230,13250,13265,13100,13105,13160,-125,-70,41976,117146
20150414,13105,13160,13155,13155,13000,13020,13050,-140,-110,67982,119072
20150415,13020,13050,13040,13105,13005,13060,13060,10,10,27882,121674
20150416,13060,13060,13060,13195,13050,13180,13120,120,60,31486,122168
20150417,13180,13120,13235,13250,13160,13190,13210,70,90,36348,113880
20150420,13190,13210,13205,13215,13075,13110,13125,-100,-85,31388,115256
20150421,13110,13125,13100,13140,13065,13095,13090,-30,-35,14598,112870
20150422,13095,13090,13090,13155,13020,13150,13110,60,20,18334,109822
20150423,13150,13110,13130,13260,13100,13190,13170,80,60,34756,102142
20150424,13190,13170,13160,13230,13160,13225,13205,55,35,25774,90400
20150427,13225,13205,13250,13385,13250,13330,13330,125,125,33800,80216
20150428,13330,13330,13375,13400,13275,13310,13320,-20,-10,18862,74436
20150429,13310,13320,13380,13405,13280,13290,13340,-30,20,14306,72562
20150430,13290,13340,13330,13355,13300,13325,13325,-15,-15,13294,70358
20150504,13325,13325,13390,13435,13355,13400,13390,75,65,16034,65768
20150505,13400,13390,13410,13415,13320,13350,13350,-40,-40,9686,64456
20150506,13350,13350,13400,13540,13355,13490,13475,140,125,27312,65476
20150507,13490,13475,13430,13485,13360,13415,13405,-60,-70,10518,62792
20150508,13415,13405,13410,13455,13380,13390,13405,-15,0,8872,61496
20150511,13390,13405,13400,13445,13350,13390,13380,-15,-25,7122,61514
20150512,13390,13380,13385,13390,13260,13260,13295,-120,-85,9640,60834
20150513,13260,13295,13285,13325,13260,13310,13290,15,-5,4084,61294
20150514,13310,13290,13330,13340,13195,13250,13250,-40,-40,5326,61140
20150515,13250,13250,13245,13290,13210,13265,13245,15,-5,4422,60708
20150518,13265,13245,13200,13250,13200,13225,13230,-20,-15,5238,59008
20150519,13225,13230,13195,13195,13160,13170,13175,-60,-55,4800,58388
20150520,13170,13175,13125,13175,13115,13115,13145,-60,-30,6884,56514
20150521,13115,13145,13125,13220,13120,13195,13185,50,40,6358,56800
20150522,13195,13185,13165,13220,13160,13180,13180,-5,-5,4590,56142
20150525,13180,13180,13120,13150,13105,13130,13130,-50,-50,7204,53486
20150526,13130,13130,13125,13185,13120,13155,13150,25,20,6050,51882
20150527,13155,13150,13120,13130,13085,13090,13115,-60,-35,5660,48652
20150528,13090,13115,13045,13085,13045,13055,13065,-60,-50,8630,43266
20150529,13055,13065,13095,13110,13060,13080,13085,15,20,7720,40302
20150601,13080,13085,13030,13065,13030,13050,13045,-35,-40,2872,40770
20150602,13050,13045,13065,13070,13010,13035,13045,-10,0,4700,39410
20150603,13035,13045,13015,13045,13015,13015,13025,-30,-20,3250,39180
20150604,13015,13025,13030,13035,12980,12995,13005,-30,-20,2740,38860
20150605,12995,13005,13000,13000,12870,12885,12940,-120,-65,3040,37870
20150608,12885,12940,12840,12900,12840,12860,12870,-80,-70,2660,36680
20150609,12860,12870,12840,12860,12815,12825,12825,-45,-45,6530,35400
20150610,12825,12825,12845,12855,12785,12785,12810,-40,-15,8680,33490
20150611,12785,12810,12800,12815,12715,12720,12770,-90,-40,3620,30660
20150612,12720,12770,12640,12645,12585,12645,12615,-125,-155,5620,27890
20150615,12645,12615,12615,12615,12555,12555,12595,-60,-20,5500,24570
al1507,20150105,13395,13410,13360,13360,13175,13190,13220,-220,-190,266,694
20150106,13190,13220,13100,13115,13045,13115,13095,-105,-125,128,778
20150107,13115,13095,13075,13085,13035,13035,13050,-60,-45,248,806
20150108,13035,13050,13055,13090,13030,13065,13060,15,10,184,896
20150109,13065,13060,13070,13115,13030,13095,13080,35,20,418,1114
20150112,13095,13080,13075,13075,12995,13000,13025,-80,-55,174,1214
20150113,13000,13025,12900,12965,12900,12960,12950,-65,-75,126,1248
20150114,12960,12950,12925,13010,12745,12860,12895,-90,-55,1358,1880
20150115,12860,12895,13210,13210,12960,13100,13040,205,145,1362,2432
20150116,13100,13040,13130,13130,13030,13055,13065,15,25,560,2404
20150119,13055,13065,13085,13145,13075,13075,13110,10,45,260,2408
20150120,13075,13110,13075,13075,13020,13020,13055,-90,-55,712,2632
20150121,13020,13055,13060,13060,13000,13015,13025,-40,-30,124,2718
20150122,13015,13025,12955,13070,12955,13065,13045,40,20,436,2782
20150123,13065,13045,13450,13450,13020,13025,13120,-20,75,600,3022
20150126,13025,13120,13025,13035,12955,12995,12995,-125,-125,312,3074
20150127,12995,12995,13005,13100,13005,13050,13060,55,65,494,3106
20150128,13050,13060,13000,13055,13000,13035,13025,-25,-35,152,3148
20150129,13035,13025,13030,13030,12995,13020,13005,-5,-20,58,3114
20150130,13020,13005,13000,13010,12950,12950,12985,-55,-20,436,3026
20150202,12950,12985,13010,13070,13010,13050,13030,65,45,294,3056
20150203,13050,13030,13080,13280,13075,13280,13170,250,140,444,3144
20150204,13280,13170,13325,13365,13260,13365,13320,195,150,344,3164
20150205,13365,13320,13340,13510,13340,13385,13390,65,70,686,3478
20150206,13385,13390,13365,13505,13365,13500,13490,110,100,1030,3502
20150209,13500,13490,13490,13490,13385,13385,13425,-105,-65,394,3668
20150210,13385,13425,13370,13405,13285,13300,13320,-125,-105,1308,4358
20150211,13300,13320,13700,13700,13175,13175,13210,-145,-110,1834,5442
20150212,13175,13210,13165,13165,13100,13120,13120,-90,-90,1730,6442
20150213,13120,13120,13350,13350,13140,13190,13195,70,75,1084,6800
20150216,13190,13195,13215,13230,13165,13185,13185,-10,-10,934,7266
20150217,13185,13185,13170,13205,13110,13180,13170,-5,-15,438,7456
20150225,13180,13170,13190,13255,13080,13090,13120,-80,-50,1092,7900
20150226,13090,13120,13005,13130,13005,13105,13070,-15,-50,1216,8230
20150227,13105,13070,13130,13130,13055,13060,13080,-10,10,1898,9354
20150302,13060,13080,13060,13195,13060,13195,13145,115,65,2916,10630
20150303,13195,13145,13135,13175,13120,13120,13135,-25,-10,1452,11214
20150304,13120,13135,13105,13105,13035,13070,13065,-65,-70,5532,14624
20150305,13070,13065,13090,13110,13040,13070,13060,5,-5,3262,16554
20150306,13070,13060,13085,13110,13035,13040,13060,-20,0,2078,17838
20150309,13040,13060,13040,13045,12995,13030,13020,-30,-40,5618,19798
20150310,13030,13020,13000,13075,12990,13010,13025,-10,5,4350,21138
20150311,13010,13025,12980,13010,12980,12990,12995,-35,-30,4516,23702
20150312,12990,12995,12995,13325,12980,13200,13060,205,65,7988,26474
20150313,13200,13060,13200,13250,13110,13150,13180,90,120,5826,27148
20150316,13150,13180,13145,13190,13120,13150,13145,-30,-35,4232,28704
20150317,13150,13145,13145,13170,13115,13130,13135,-15,-10,4118,30096
20150318,13130,13135,13130,13200,13120,13185,13170,50,35,6328,32248
20150319,13185,13170,13180,13380,13160,13340,13260,170,90,12654,36668
20150320,13340,13260,13375,13430,13270,13280,13350,20,90,19144,42902
20150323,13280,13350,13280,13375,13250,13300,13305,-50,-45,12736,46498
20150324,13300,13305,13330,13360,13285,13335,13320,30,15,13122,50608
20150325,13335,13320,13330,13355,13290,13290,13305,-30,-15,6940,51876
20150326,13290,13305,13295,13335,13260,13315,13295,10,-10,7376,53698
20150327,13315,13295,13295,13365,13295,13335,13335,40,40,8104,55652
20150330,13335,13335,13290,13345,13290,13325,13320,-10,-15,9950,58726
20150331,13325,13320,13345,13425,13330,13365,13385,45,65,13376,62800
20150401,13365,13385,13370,13405,13335,13380,13375,-5,-10,7224,64036
20150402,13380,13375,13325,13410,13325,13375,13380,0,5,9904,63878
20150403,13375,13380,13380,13385,13360,13380,13370,0,-10,7558,66294
20150407,13380,13370,13440,13450,13380,13415,13415,45,45,8092,67136
20150408,13415,13415,13425,13435,13375,13395,13390,-20,-25,9054,69510
20150409,13395,13390,13370,13370,13085,13265,13215,-125,-175,47026,80932
20150410,13265,13215,13275,13280,13200,13255,13235,40,20,18936,87264
20150413,13255,13235,13260,13260,13105,13130,13170,-105,-65,26592,97086
20150414,13130,13170,13160,13160,13020,13030,13065,-140,-105,38834,97766
20150415,13030,13065,13030,13125,13030,13075,13080,10,15,20128,98050
20150416,13075,13080,13075,13210,13070,13195,13135,115,55,29138,102440
20150417,13195,13135,13230,13275,13185,13210,13225,75,90,27672,103624
20150420,13210,13225,13200,13235,13095,13125,13150,-100,-75,27616,106792
20150421,13125,13150,13100,13150,13090,13110,13105,-40,-45,17636,111556
20150422,13110,13105,13100,13165,13040,13155,13125,50,20,25344,117800
20150423,13155,13125,13130,13280,13105,13210,13185,85,60,58130,119028
20150424,13210,13185,13180,13240,13170,13230,13210,45,25,28630,123644
20150427,13230,13210,13275,13400,13265,13360,13335,150,125,70880,133392
20150428,13360,13335,13360,13420,13280,13320,13345,-15,10,52922,137144
20150429,13320,13345,13385,13420,13290,13305,13360,-40,15,66102,141968
20150430,13305,13360,13340,13380,13315,13345,13350,-15,-10,47484,145898
20150504,13345,13350,13400,13465,13380,13420,13415,70,65,44714,147352
20150505,13420,13415,13440,13450,13350,13370,13390,-45,-25,35878,144926
20150506,13370,13390,13420,13620,13400,13580,13535,190,145,133430,162078
20150507,13580,13535,13540,13555,13425,13460,13475,-75,-60,72870,150382
20150508,13460,13475,13470,13520,13440,13455,13460,-20,-15,59728,136138
20150511,13455,13460,13455,13515,13405,13480,13450,20,-10,42292,134282
20150512,13480,13450,13450,13460,13315,13315,13380,-135,-70,39718,131570
20150513,13315,13380,13365,13395,13325,13380,13360,0,-20,26398,133478
20150514,13380,13360,13380,13410,13270,13330,13335,-30,-25,30664,131988
20150515,13330,13335,13295,13360,13280,13335,13315,0,-20,25600,132026
20150518,13335,13315,13280,13330,13275,13285,13295,-30,-20,20192,129200
20150519,13285,13295,13270,13270,13220,13235,13235,-60,-60,28858,123172
20150520,13235,13235,13195,13220,13150,13170,13195,-65,-40,30172,116398
20150521,13170,13195,13185,13275,13160,13245,13225,50,30,16286,113198
20150522,13245,13225,13225,13270,13210,13215,13235,-10,10,19482,108620
20150525,13215,13235,13190,13200,13160,13180,13185,-55,-50,18972,103968
20150526,13180,13185,13195,13255,13175,13200,13210,15,25,21340,99678
20150527,13200,13210,13175,13195,13135,13155,13170,-55,-40,17802,95326
20150528,13155,13170,13090,13145,13070,13115,13120,-55,-50,18996,89744
20150529,13115,13120,13165,13180,13120,13160,13150,40,30,14814,84684
20150601,13160,13150,13135,13135,13070,13105,13105,-45,-45,18798,78636
20150602,13105,13105,13070,13125,13070,13090,13110,-15,5,13930,74488
20150603,13090,13110,13090,13120,13070,13080,13095,-30,-15,9530,72890
20150604,13080,13095,13095,13115,13020,13020,13065,-75,-30,8342,70544
20150605,13020,13065,13060,13145,12935,12950,12985,-115,-80,11842,68226
20150608,12950,12985,12935,12960,12895,12905,12920,-80,-65,8970,67396
20150609,12905,12920,12925,12930,12875,12890,12890,-30,-30,6240,65372
20150610,12890,12890,12905,12920,12860,12860,12885,-30,-5,8498,64480
20150611,12860,12885,12880,12905,12765,12775,12825,-110,-60,12418,62738
20150612,12775,12825,12770,12770,12640,12695,12680,-130,-145,11636,61312
20150615,12695,12680,12695,12715,12600,12620,12665,-60,-15,9322,59954
20150616,12620,12665,12605,12695,12580,12645,12650,-20,-15,4610,58832
20150617,12645,12650,12650,12670,12625,12635,12650,-15,0,4442,58048
20150618,12635,12650,12675,12680,12550,12635,12630,-15,-20,5652,55466
20150619,12635,12630,12640,12680,12630,12655,12650,25,20,3762,53538
20150623,12655,12650,12715,12730,12680,12725,12705,75,55,5856,50630
20150624,12725,12705,12765,12765,12715,12745,12730,40,25,5378,47984
20150625,12745,12730,12620,12740,12620,12720,12710,-10,-20,5384,44834
20150626,12720,12710,12710,12755,12675,12740,12730,30,20,5536,41608
20150629,12740,12730,12705,12735,12680,12715,12705,-15,-25,5380,39210
20150630,12715,12705,12670,12750,12450,12750,12610,45,-95,12296,37016
20150701,12750,12610,12575,12580,12445,12480,12500,-130,-110,5786,36270
20150702,12480,12500,12525,12765,12525,12610,12620,110,120,5440,37310
20150703,12610,12620,12620,12655,12565,12600,12590,-20,-30,4500,36520
20150706,12600,12590,12575,12575,12370,12410,12480,-180,-110,6560,33360
20150707,12410,12480,12360,12430,12335,12335,12385,-145,-95,5380,32810
20150708,12335,12385,12300,12300,11885,11900,12080,-485,-305,8670,31500
20150709,11900,12080,12030,12275,12030,12255,12170,175,90,8230,28990
20150710,12255,12170,12300,12395,12240,12305,12310,135,140,7930,28500
20150713,12305,12310,12300,12340,12255,12260,12285,-50,-25,3640,26360
20150714,12260,12285,12305,12350,12280,12280,12320,-5,35,5370,24330
20150715,12280,12320,12300,12330,12275,12330,12300,10,-20,5580,20640
al1508,20150105,13475,13475,13425,13425,13250,13250,13355,-225,-120,76,338
20150106,13250,13355,13180,13185,13170,13175,13175,-180,-180,54,382
20150107,13175,13175,13065,13150,13065,13105,13105,-70,-70,38,394
20150108,13105,13105,13115,13115,13100,13115,13110,10,5,14,398
20150109,13115,13110,13140,13150,13140,13150,13145,40,35,20,402
20150112,13150,13145,13015,13120,12995,13095,13050,-50,-95,18,410
20150113,13095,13050,13015,13015,13015,13015,13015,-35,-35,2,410
20150114,13015,13015,13000,13050,12735,12945,13005,-70,-10,628,844
20150115,12945,13005,13040,13170,13015,13170,13105,165,100,346,910
20150116,13170,13105,13175,13190,13100,13105,13105,0,0,692,1214
20150119,13105,13105,13155,13195,13150,13150,13155,45,50,22,1210
20150120,13150,13155,13125,13130,13060,13070,13110,-85,-45,144,1286
20150121,13070,13110,13110,13120,13050,13050,13070,-60,-40,118,1318
20150122,13050,13070,13055,13110,13025,13110,13080,40,10,188,1324
20150123,13110,13080,13085,13105,13080,13080,13085,0,5,62,1328
20150126,13080,13085,13070,13070,13020,13025,13045,-60,-40,56,1364
20150127,13025,13045,13080,13185,13080,13105,13105,60,60,76,1372
20150128,13105,13105,13085,13105,13050,13090,13095,-15,-10,138,1394
20150129,13090,13095,13055,13080,13055,13070,13065,-25,-30,14,1398
20150130,13070,13065,13050,13050,13005,13020,13025,-45,-40,32,1410
20150202,13020,13025,13075,13110,13060,13105,13085,80,60,72,1386
20150203,13105,13085,13145,13305,13145,13305,13175,220,90,134,1454
20150204,13305,13175,13390,13390,13285,13375,13350,200,175,74,1438
20150205,13375,13350,13375,13520,13375,13400,13445,50,95,88,1428
20150206,13400,13445,13400,13570,13400,13560,13505,115,60,188,1434
20150209,13560,13505,13490,13490,13440,13450,13450,-55,-55,20,1438
20150210,13450,13450,13435,13435,13385,13385,13395,-65,-55,78,1438
20150211,13385,13395,13385,13385,13185,13185,13245,-210,-150,198,1374
20150212,13185,13245,13215,13215,13150,13165,13175,-80,-70,40,1364
20150213,13165,13175,13240,13250,13210,13250,13235,75,60,164,1426
20150216,13250,13235,13275,13290,13230,13230,13240,-5,5,104,1462
20150217,13230,13240,13230,13240,13190,13240,13225,0,-15,96,1520
20150225,13240,13225,13245,13245,13145,13145,13175,-80,-50,70,1482
20150226,13145,13175,13125,13180,13100,13165,13160,-10,-15,364,1778
20150227,13165,13160,13195,13195,13125,13125,13150,-35,-10,76,1822
20150302,13125,13150,13125,13250,13125,13250,13205,100,55,334,2012
20150303,13250,13205,13210,13230,13175,13175,13195,-30,-10,354,2158
20150304,13175,13195,13150,13160,13085,13120,13095,-75,-100,1322,2760
20150305,13120,13095,13140,13150,13090,13110,13105,15,10,272,2832
20150306,13110,13105,13130,13150,13085,13100,13110,-5,5,744,3284
20150309,13100,13110,13050,13095,13045,13090,13070,-20,-40,706,3776
20150310,13090,13070,13090,13105,13050,13050,13075,-20,5,834,4298
20150311,13050,13075,13035,13060,13035,13050,13045,-25,-30,616,4786
20150312,13050,13045,13050,13360,13020,13240,13125,195,80,1814,5958
20150313,13240,13125,13200,13290,13160,13165,13225,40,100,680,6206
20150316,13165,13225,13180,13225,13145,13150,13165,-75,-60,1596,6844
20150317,13150,13165,13180,13180,13140,13140,13160,-25,-5,400,6832
20150318,13140,13160,13140,13215,13140,13195,13195,35,35,1670,7814
20150319,13195,13195,13210,13405,13195,13370,13335,175,140,4068,9722
20150320,13370,13335,13355,13465,13295,13295,13370,-40,35,5044,13058
20150323,13295,13370,13310,13385,13300,13315,13325,-55,-45,2416,13826
20150324,13315,13325,13325,13370,13310,13350,13340,25,15,1820,13788
20150325,13350,13340,13350,13360,13315,13345,13325,5,-15,480,13790
20150326,13345,13325,13330,13355,13280,13330,13320,5,-5,1250,14468
20150327,13330,13320,13355,13375,13330,13340,13355,20,35,2838,15318
20150330,13340,13355,13315,13360,13305,13335,13340,-20,-15,1692,16046
20150331,13335,13340,13350,13430,13350,13385,13390,45,50,2820,17442
20150401,13385,13390,13350,13410,13350,13385,13380,-5,-10,1936,18028
20150402,13385,13380,13375,13420,13360,13400,13385,20,5,626,18220
20150403,13400,13385,13395,13395,13365,13380,13370,-5,-15,1784,19164
20150407,13380,13370,13415,13440,13410,13425,13415,55,45,986,18826
20150408,13425,13415,13440,13440,13380,13405,13400,-10,-15,1344,19312
20150409,13405,13400,13350,13375,13130,13290,13250,-110,-150,9078,23948
20150410,13290,13250,13275,13295,13215,13280,13245,30,-5,8166,27594
20150413,13280,13245,13265,13270,13125,13150,13170,-95,-75,6192,30028
20150414,13150,13170,13160,13165,13055,13075,13090,-95,-80,11980,33408
20150415,13075,13090,13080,13150,13060,13090,13100,0,10,5488,34790
20150416,13090,13100,13090,13225,13090,13225,13165,125,65,5856,36450
20150417,13225,13165,13230,13290,13210,13230,13250,65,85,6400,37338
20150420,13230,13250,13215,13260,13135,13160,13170,-90,-80,6602,39650
20150421,13160,13170,13140,13175,13120,13130,13135,-40,-35,2460,40626
20150422,13130,13135,13090,13190,13070,13185,13150,50,15,3394,41530
20150423,13185,13150,13160,13270,13125,13220,13210,70,60,12684,44496
20150424,13220,13210,13220,13255,13185,13235,13235,25,25,7808,48576
20150427,13235,13235,13295,13420,13285,13380,13355,145,120,16244,55334
20150428,13380,13355,13380,13435,13305,13330,13365,-25,10,9030,57124
20150429,13330,13365,13400,13435,13310,13320,13375,-45,10,12624,56888
20150430,13320,13375,13345,13400,13335,13380,13370,5,-5,13956,59568
20150504,13380,13370,13440,13495,13400,13465,13440,95,70,17544,65978
20150505,13465,13440,13485,13485,13385,13400,13415,-40,-25,13330,68062
20150506,13400,13415,13440,13660,13425,13620,13570,205,155,47662,79536
20150507,13620,13570,13570,13600,13470,13500,13515,-70,-55,21948,79546
20150508,13500,13515,13500,13560,13475,13490,13500,-25,-15,23460,79476
20150511,13490,13500,13520,13555,13455,13520,13490,20,-10,22246,82276
20150512,13520,13490,13500,13505,13395,13395,13430,-95,-60,23926,86306
20150513,13395,13430,13430,13455,13380,13435,13420,5,-10,14580,88122
20150514,13435,13420,13440,13470,13335,13380,13390,-40,-30,19702,91218
20150515,13380,13390,13360,13420,13350,13390,13375,0,-15,12458,92710
20150518,13390,13375,13350,13395,13330,13330,13360,-45,-15,12636,93590
20150519,13330,13360,13300,13325,13280,13280,13290,-80,-70,19254,93670
20150520,13280,13290,13250,13275,13210,13225,13245,-65,-45,29372,93398
20150521,13225,13245,13215,13320,13215,13280,13275,35,30,17352,96632
20150522,13280,13275,13250,13310,13250,13265,13280,-10,5,23138,100920
20150525,13265,13280,13230,13250,13200,13235,13230,-45,-50,14570,103754
20150526,13235,13230,13210,13310,13210,13250,13265,20,35,19866,109448
20150527,13250,13265,13230,13250,13185,13195,13220,-70,-45,23774,115126
20150528,13195,13220,13150,13195,13145,13175,13170,-45,-50,33002,123802
20150529,13175,13170,13200,13225,13175,13225,13205,55,35,24516,127372
20150601,13225,13205,13175,13200,13125,13175,13170,-30,-35,38608,125170
20150602,13175,13170,13170,13200,13155,13155,13175,-15,5,27010,132758
20150603,13155,13175,13180,13190,13130,13140,13155,-35,-20,26250,135252
20150604,13140,13155,13165,13175,13080,13105,13120,-50,-35,29702,132794
20150605,13105,13120,13090,13160,12905,13010,13055,-110,-65,36360,133402
20150608,13010,13055,12985,13020,12950,12950,12975,-105,-80,31406,132024
20150609,12950,12975,12950,12990,12930,12950,12950,-25,-25,23802,135144
20150610,12950,12950,12980,12985,12930,12930,12950,-20,0,19994,134944
20150611,12930,12950,12950,12975,12830,12835,12895,-115,-55,42472,133236
20150612,12835,12895,12825,12840,12705,12755,12750,-140,-145,55882,129630
20150615,12755,12750,12775,12790,12655,12675,12725,-75,-25,25236,128062
20150616,12675,12725,12655,12750,12630,12705,12685,-20,-40,31858,123400
20150617,12705,12685,12680,12715,12665,12675,12690,-10,5,20752,122972
20150618,12675,12690,12705,12735,12580,12675,12650,-15,-40,22242,120800
20150619,12675,12650,12670,12710,12650,12690,12675,40,25,19792,115164
20150623,12690,12675,12695,12770,12695,12760,12735,85,60,15674,109444
20150624,12760,12735,12755,12790,12745,12780,12770,45,35,19922,102928
20150625,12780,12770,12780,12790,12670,12740,12735,-30,-35,18412,96826
20150626,12740,12735,12745,12760,12680,12745,12735,10,0,15188,93450
20150629,12745,12735,12715,12750,12685,12720,12715,-15,-20,13240,92252
20150630,12720,12715,12680,12695,12560,12600,12605,-115,-110,28064,83418
20150701,12600,12605,12595,12600,12450,12450,12515,-155,-90,17458,78008
20150702,12450,12515,12510,13015,12510,12650,12680,135,165,17172,75876
20150703,12650,12680,12660,12710,12615,12640,12645,-40,-35,9994,75424
20150706,12640,12645,12640,12650,12405,12450,12515,-195,-130,16104,72978
20150707,12450,12515,12400,12500,12380,12390,12445,-125,-70,11568,70774
20150708,12390,12445,12405,12405,11945,11975,12120,-470,-325,30014,65032
20150709,11975,12120,12215,12365,12070,12330,12235,210,115,20146,63168
20150710,12330,12235,12390,12465,12325,12365,12385,130,150,12110,63014
20150713,12365,12385,12310,12410,12310,12335,12345,-50,-40,6696,60886
20150714,12335,12345,12350,12430,12350,12350,12385,5,40,8554,58438
20150715,12350,12385,12350,12400,12340,12380,12365,-5,-20,5362,58052
20150716,12380,12365,12375,12590,12290,12490,12455,125,90,16686,51120
20150717,12490,12455,12445,12510,12415,12465,12445,10,-10,7156,49818
20150720,12465,12445,12420,12430,12370,12395,12390,-50,-55,2874,49182
20150721,12395,12390,12385,12390,12350,12370,12370,-20,-20,3092,48290
20150722,12370,12370,12340,12355,12285,12310,12310,-60,-60,6766,45456
20150723,12310,12310,12290,12300,12210,12300,12260,-10,-50,6676,42688
20150724,12300,12260,12245,12260,12220,12245,12235,-15,-25,3732,40904
20150727,12245,12235,12230,12280,12190,12210,12240,-25,5,3232,39912
20150728,12210,12240,12160,12245,12160,12245,12210,5,-30,3094,39784
20150729,12245,12210,12260,12350,12245,12265,12300,55,90,5770,38822
20150730,12265,12300,12230,12255,12150,12190,12215,-110,-85,5064,37044
20150731,12190,12215,12175,12195,12050,12050,12180,-165,-35,5692,34172
20150803,12050,12180,12180,12180,11990,12000,12070,-180,-110,8662,34130
20150804,12000,12070,11965,12045,11960,12045,12005,-25,-65,5440,33160
20150805,12045,12005,12095,12095,11980,12010,12010,5,5,7610,33460
20150806,12010,12010,12015,12015,11945,11945,11965,-65,-45,3080,32820
20150807,11945,11965,11855,11920,11855,11890,11890,-75,-75,4790,31480
20150810,11890,11890,11900,11935,11865,11910,11895,20,5,3380,30160
20150811,11910,11895,11920,12020,11920,11955,11990,60,95,4410,29270
20150812,11955,11990,11930,12020,11930,12020,11990,30,0,8540,29390
20150813,12020,11990,12195,12195,12005,12010,12045,20,55,4470,29240
20150814,12010,12045,12005,12030,12000,12030,12015,-15,-30,4250,26240
20150817,12030,12015,12020,12050,11950,12000,12010,-15,-5,4740,22830
al1509,20150105,13545,13545,13465,13465,13270,13275,13400,-270,-145,80,358
20150106,13275,13400,13280,13280,13220,13240,13255,-160,-145,64,370
20150107,13240,13255,13200,13210,13155,13210,13180,-45,-75,42,386
20150108,13210,13180,13150,13170,13150,13170,13160,-10,-20,6,388
20150109,13170,13160,13265,13265,13160,13200,13190,40,30,80,416
20150112,13200,13190,13150,13150,13100,13100,13130,-90,-60,22,428
20150113,13100,13130,13075,13075,12975,12975,13030,-155,-100,8,424
20150114,12975,13030,13095,13095,13000,13000,13020,-30,-10,16,436
20150115,13000,13020,13095,13225,13060,13225,13180,205,160,108,516
20150116,13225,13180,13165,13190,13130,13190,13160,10,-20,134,558
20150119,13190,13160,13205,13260,13200,13200,13225,40,65,34,550
20150120,13200,13225,13170,13195,13130,13130,13175,-95,-50,86,608
20150121,13130,13175,13130,13170,13100,13110,13120,-65,-55,124,644
20150122,13110,13120,13120,13160,13115,13160,13150,40,30,54,634
20150123,13160,13150,13170,13170,13140,13140,13140,-10,-10,48,672
20150126,13140,13140,13095,13110,13095,13095,13095,-45,-45,8,670
20150127,13095,13095,13125,13190,13125,13160,13165,65,70,44,650
20150128,13160,13165,13120,13155,13120,13155,13135,-10,-30,36,660
20150129,13155,13135,13125,13150,13125,13150,13135,15,0,10,656
20150130,13150,13135,13140,13140,13060,13070,13080,-65,-55,264,734
20150202,13070,13080,13110,13175,13110,13170,13145,90,65,20,736
20150203,13170,13145,13175,13385,13175,13380,13285,235,140,76,746
20150204,13380,13285,13400,13400,13400,13400,13400,115,115,2,746
20150205,13400,13400,13420,13560,13420,13505,13530,105,130,48,768
20150206,13505,13530,13450,13615,13445,13610,13525,80,-5,64,774
20150209,13610,13525,13520,13540,13460,13490,13515,-35,-10,54,752
20150210,13490,13515,13470,13470,13400,13400,13435,-115,-80,40,730
20150211,13400,13435,13370,13375,13280,13280,13295,-155,-140,56,736
20150212,13280,13295,13225,13255,13200,13200,13220,-95,-75,14,734
20150213,13200,13220,13245,13320,13245,13320,13280,100,60,58,734
20150216,13320,13280,13280,13310,13280,13300,13295,20,15,92,788
20150217,13300,13295,13260,13280,13240,13275,13260,-20,-35,26,788
20150225,13275,13260,13225,13250,13170,13170,13215,-90,-45,60,796
20150226,13170,13215,13135,13220,13135,13210,13175,-5,-40,152,932
20150227,13210,13175,13220,13250,13175,13180,13195,5,20,190,976
20150302,13180,13195,13150,13265,13150,13260,13245,65,50,398,1248
20150303,13260,13245,13285,13285,13220,13240,13245,-5,0,74,1230
20150304,13240,13245,13200,13210,13150,13180,13170,-65,-75,96,1248
20150305,13180,13170,13195,13205,13155,13155,13175,-15,5,148,1300
20150306,13155,13175,13175,13180,13155,13155,13165,-20,-10,30,1310
20150309,13155,13165,13110,13145,13100,13145,13130,-20,-35,260,1292
20150310,13145,13130,13145,13175,13115,13115,13135,-15,5,116,1270
20150311,13115,13135,13120,13140,13080,13095,13105,-40,-30,164,1298
20150312,13095,13105,13125,13310,13095,13220,13125,115,20,382,1380
20150313,13220,13125,13260,13315,13190,13240,13260,115,135,358,1442
20150316,13240,13260,13215,13245,13185,13185,13210,-75,-50,466,1564
20150317,13185,13210,13190,13220,13180,13180,13200,-30,-10,174,1562
20150318,13180,13200,13170,13295,13165,13225,13240,25,40,582,1592
20150319,13225,13240,13265,13400,13230,13400,13345,160,105,220,1608
20150320,13400,13345,13510,13510,13320,13320,13410,-25,65,544,1628
20150323,13320,13410,13285,13420,13285,13330,13350,-80,-60,1136,2080
20150324,13330,13350,13330,13400,13330,13380,13355,30,5,818,2446
20150325,13380,13355,13345,13350,13335,13350,13340,-5,-15,382,2504
20150326,13350,13340,13340,13345,13310,13340,13330,0,-10,178,2534
20150327,13340,13330,13370,13385,13345,13345,13365,15,35,882,2918
20150330,13345,13365,13340,13365,13320,13355,13350,-10,-15,1590,4146
20150331,13355,13350,13360,13445,13360,13380,13405,30,55,1648,5034
20150401,13380,13405,13375,13425,13365,13400,13400,-5,-5,696,5360
20150402,13400,13400,13370,13430,13370,13395,13400,-5,0,640,5674
20150403,13395,13400,13405,13405,13370,13390,13390,-10,-10,610,5862
20150407,13390,13390,13440,13445,13425,13435,13430,45,40,498,6038
20150408,13435,13430,13430,13430,13390,13390,13400,-40,-30,1084,6668
20150409,13390,13400,13375,13375,13150,13305,13280,-95,-120,2692,7702
20150410,13305,13280,13250,13355,13235,13275,13260,-5,-20,606,7814
20150413,13275,13260,13255,13285,13150,13170,13210,-90,-50,826,8022
20150414,13170,13210,13190,13190,13075,13090,13105,-120,-105,2318,8692
20150415,13090,13105,13125,13175,13095,13135,13120,30,15,1836,9524
20150416,13135,13120,13145,13250,13145,13250,13185,130,65,1316,9694
20150417,13250,13185,13280,13325,13240,13265,13275,80,90,856,9644
20150420,13265,13275,13235,13280,13165,13190,13205,-85,-70,1104,9936
20150421,13190,13205,13180,13195,13150,13180,13165,-25,-40,1560,10596
20150422,13180,13165,13125,13215,13125,13200,13175,35,10,1732,11194
20150423,13200,13175,13205,13275,13145,13235,13225,60,50,4270,13614
20150424,13235,13225,13225,13275,13205,13250,13240,25,15,2146,15160
20150427,13250,13240,13320,13425,13300,13400,13365,160,125,9696,20432
20150428,13400,13365,13390,13440,13310,13345,13370,-20,5,5772,23250
20150429,13345,13370,13485,13485,13320,13330,13385,-40,15,7066,25882
20150430,13330,13385,13355,13410,13340,13380,13380,-5,-5,3326,26410
20150504,13380,13380,13460,13510,13410,13470,13455,90,75,6530,27176
20150505,13470,13455,13470,13500,13395,13410,13435,-45,-20,3270,26772
20150506,13410,13435,13485,13690,13440,13650,13605,215,170,9934,28386
20150507,13650,13605,13580,13740,13510,13530,13580,-75,-25,5302,29464
20150508,13530,13580,13530,13595,13510,13530,13535,-50,-45,6402,31446
20150511,13530,13535,13550,13600,13500,13550,13530,15,-5,5438,31726
20150512,13550,13530,13525,13545,13435,13450,13480,-80,-50,4686,31810
20150513,13450,13480,13450,13500,13430,13490,13460,10,-20,1640,32268
20150514,13490,13460,13490,13520,13380,13430,13420,-30,-40,3202,31986
20150515,13430,13420,13430,13460,13400,13445,13425,25,5,2194,32632
20150518,13445,13425,13380,13440,13370,13405,13400,-20,-25,2530,32584
20150519,13405,13400,13335,13355,13325,13330,13330,-70,-70,2654,32502
20150520,13330,13330,13295,13315,13255,13270,13285,-60,-45,5652,32798
20150521,13270,13285,13270,13380,13260,13330,13315,45,30,4218,33470
20150522,13330,13315,13320,13355,13295,13300,13325,-15,10,3018,33828
20150525,13300,13325,13250,13305,13250,13290,13280,-35,-45,6684,35832
20150526,13290,13280,13280,13360,13280,13315,13315,35,35,4944,37966
20150527,13315,13315,13300,13300,13235,13235,13270,-80,-45,6900,41502
20150528,13235,13270,13210,13245,13195,13225,13220,-45,-50,11112,45176
20150529,13225,13220,13265,13285,13230,13280,13265,60,45,9442,49348
20150601,13280,13265,13225,13260,13195,13240,13225,-25,-40,12300,55480
20150602,13240,13225,13240,13265,13220,13220,13240,-5,15,8240,57972
20150603,13220,13240,13230,13250,13195,13195,13215,-45,-25,6886,60250
20150604,13195,13215,13215,13230,13140,13145,13180,-70,-35,9786,62856
20150605,13145,13180,13130,13225,13050,13055,13105,-125,-75,16914,67320
20150608,13055,13105,13070,13070,13005,13015,13030,-90,-75,12472,67608
20150609,13015,13030,13010,13045,12995,13015,13010,-15,-20,11762,71508
20150610,13015,13010,13025,13045,12995,12995,13005,-15,-5,13102,74418
20150611,12995,13005,13020,13040,12890,12890,12960,-115,-45,28638,80042
20150612,12890,12960,12875,12905,12780,12815,12815,-145,-145,25688,89168
20150615,12815,12815,12850,12850,12715,12735,12785,-80,-30,17506,94484
20150616,12735,12785,12715,12810,12695,12770,12745,-15,-40,25814,98986
20150617,12770,12745,12750,12775,12720,12735,12750,-10,5,15272,102092
20150618,12735,12750,12775,12795,12630,12720,12695,-30,-55,22230,101186
20150619,12720,12695,12715,12750,12695,12720,12715,25,20,20542,103748
20150623,12720,12715,12745,12795,12740,12795,12770,80,55,23042,102484
20150624,12795,12770,12815,12820,12775,12810,12795,40,25,24346,103636
20150625,12810,12795,12775,12830,12700,12755,12755,-40,-40,31384,108422
20150626,12755,12755,12755,12780,12700,12760,12750,5,-5,26572,110602
20150629,12760,12750,12740,12760,12695,12735,12730,-15,-20,28260,119202
20150630,12735,12730,12700,12715,12560,12625,12620,-105,-110,49992,124950
20150701,12625,12620,12620,12620,12470,12500,12535,-120,-85,39706,131554
20150702,12500,12535,12555,13030,12550,12670,12710,135,175,48928,127104
20150703,12670,12710,12720,12740,12650,12675,12685,-35,-25,21954,128006
20150706,12675,12685,12655,12685,12440,12500,12540,-185,-145,47018,132748
20150707,12500,12540,12405,12545,12405,12430,12475,-110,-65,32074,134944
20150708,12430,12475,12405,12450,11975,12045,12145,-430,-330,178144,133002
20150709,12045,12145,12155,12435,12145,12390,12290,245,145,88724,122998
20150710,12390,12290,12460,12535,12385,12410,12450,120,160,42236,124748
20150713,12410,12450,12375,12470,12365,12395,12400,-55,-50,18256,124234
20150714,12395,12400,12450,12495,12400,12405,12445,5,45,20162,123012
20150715,12405,12445,12390,12460,12385,12435,12420,-10,-25,15312,123222
20150716,12435,12420,12440,12655,12350,12545,12505,125,85,54318,117958
20150717,12545,12505,12500,12560,12470,12520,12510,15,5,19016,118134
20150720,12520,12510,12510,12510,12420,12460,12450,-50,-60,17286,116100
20150721,12460,12450,12405,12450,12400,12445,12430,-5,-20,15832,114612
20150722,12445,12430,12415,12420,12325,12335,12360,-95,-70,23312,112694
20150723,12335,12360,12345,12345,12245,12335,12300,-25,-60,23590,107602
20150724,12335,12300,12285,12290,12240,12255,12265,-45,-35,13586,105604
20150727,12255,12265,12290,12330,12225,12235,12280,-30,15,14268,103844
20150728,12235,12280,12255,12300,12130,12275,12240,-5,-40,10158,103250
20150729,12275,12240,12295,12415,12295,12325,12345,85,105,18704,100038
20150730,12325,12345,12295,12320,12240,12250,12270,-95,-75,16172,98660
20150731,12250,12270,12215,12260,12170,12210,12235,-60,-35,14936,98122
20150803,12210,12235,12210,12260,12000,12060,12135,-175,-100,17496,94004
20150804,12060,12135,12040,12110,11985,12105,12065,-30,-70,11404,92206
20150805,12105,12065,12070,12200,12035,12060,12075,-5,10,11188,90956
20150806,12060,12075,12060,12075,11975,11980,12030,-95,-45,8236,89860
20150807,11980,12030,11955,11980,11870,11930,11950,-100,-80,15416,88102
20150810,11930,11950,11945,12000,11920,11960,11950,10,0,8594,87528
20150811,11960,11950,11960,12090,11945,12005,12035,55,85,13450,86422
20150812,12005,12035,11980,12100,11980,12070,12045,35,10,16308,84764
20150813,12070,12045,12120,12210,12055,12075,12120,30,75,13606,81018
20150814,12075,12120,12050,12105,12045,12095,12065,-25,-55,8730,78842
20150817,12095,12065,12105,12110,11995,12045,12050,-20,-15,6806,77806
20150818,12045,12050,12005,12045,11950,11975,11995,-75,-55,4264,77566
20150819,11975,11995,11960,11985,11885,11925,11920,-70,-75,7068,76910
20150820,11925,11920,11930,12010,11920,12005,11965,85,45,7398,75858
20150821,12005,11965,12065,12085,11940,11955,11995,-10,30,7858,75278
20150824,11955,11995,11930,11955,11800,11815,11860,-180,-135,14212,71690
20150825,11815,11860,11775,11885,11770,11850,11845,-10,-15,10682,66762
20150826,11850,11845,11930,12015,11830,11840,11870,-5,25,11842,60508
20150827,11840,11870,11830,11880,11815,11860,11855,-10,-15,7608,56080
20150828,11860,11855,11895,11930,11840,11890,11885,35,30,7202,53682
20150831,11890,11885,11910,11960,11825,11840,11885,-45,0,9414,48990
20150901,11840,11885,11800,11835,11750,11750,11790,-135,-95,7130,48390
20150902,11750,11790,11780,11810,11755,11775,11775,-15,-15,6230,47080
20150907,11775,11775,11780,11810,11775,11810,11790,35,15,4980,46550
20150908,11810,11790,11800,11810,11765,11810,11785,20,-5,8720,45040
20150909,11810,11785,11820,11945,11820,11930,11900,145,115,12810,43630
20150910,11930,11900,11980,12035,11850,11890,11895,-10,-5,6140,45040
20150911,11890,11895,11900,11930,11895,11920,11905,25,10,6140,42180
20150914,11920,11905,11905,11930,11900,11920,11920,15,15,6830,37090
20150915,11920,11920,11890,11900,11790,11790,11870,-130,-50,5970,32680
al1510,20150105,13600,13560,13400,13405,13390,13390,13395,-170,-165,86,314
20150106,13390,13395,,,,13390,13390,-5,-5,0,314
20150107,13390,13390,13235,13235,13230,13230,13230,-160,-160,16,312
20150108,13230,13230,13245,13245,13230,13240,13235,10,5,10,308
20150109,13240,13235,13295,13295,13250,13290,13270,55,35,26,308
20150112,13290,13270,13235,13235,13235,13235,13235,-35,-35,2,310
20150113,13235,13235,13130,13150,13130,13145,13140,-90,-95,10,312
20150114,13145,13140,,,,13140,13140,0,0,0,312
20150115,13140,13140,13190,13270,13175,13235,13200,95,60,30,318
20150116,13235,13200,13240,13240,13240,13240,13240,40,40,2,316
20150119,13240,13240,13280,13280,13280,13280,13280,40,40,2,318
20150120,13280,13280,13270,13270,13200,13200,13255,-80,-25,70,370
20150121,13200,13255,13225,13225,13155,13155,13205,-100,-50,10,370
20150122,13155,13205,13185,13230,13185,13215,13210,10,5,16,376
20150123,13215,13210,13215,13215,13215,13215,13215,5,5,10,366
20150126,13215,13215,13185,13185,13150,13150,13180,-65,-35,26,368
20150127,13150,13180,13185,13245,13185,13235,13235,55,55,52,378
20150128,13235,13235,13225,13225,13195,13205,13215,-30,-20,10,380
20150129,13205,13215,13205,13205,13195,13200,13200,-15,-15,6,380
20150130,13200,13200,13165,13165,13100,13100,13105,-100,-95,118,430
20150202,13100,13105,13155,13210,13155,13210,13190,105,85,100,512
20150203,13210,13190,13200,13375,13200,13375,13260,185,70,20,522
20150204,13375,13260,13465,13465,13430,13430,13445,170,185,8,522
20150205,13430,13445,13480,13615,13480,13525,13555,80,110,22,506
20150206,13525,13555,13555,13665,13555,13630,13625,75,70,20,512
20150209,13630,13625,13595,13595,13550,13550,13570,-75,-55,8,510
20150210,13550,13570,13505,13510,13445,13450,13460,-120,-110,62,474
20150211,13450,13460,13375,13375,13340,13340,13345,-120,-115,12,480
20150212,13340,13345,13285,13290,13240,13240,13260,-105,-85,40,482
20150213,13240,13260,13265,13340,13265,13340,13315,80,55,84,518
20150216,13340,13315,13345,13375,13320,13320,13345,5,30,82,574
20150217,13320,13345,13340,13355,13340,13355,13340,10,-5,26,584
20150225,13355,13340,13285,13285,13250,13250,13270,-90,-70,18,590
20150226,13250,13270,13205,13285,13205,13250,13220,-20,-50,68,634
20150227,13250,13220,13260,13320,13205,13235,13255,15,35,170,728
20150302,13235,13255,13230,13370,13230,13370,13325,115,70,108,824
20150303,13370,13325,13320,13345,13225,13290,13300,-35,-25,70,836
20150304,13290,13300,13220,13235,13200,13235,13215,-65,-85,108,892
20150305,13235,13215,13240,13240,13215,13240,13220,25,5,32,890
20150306,13240,13220,13260,13260,13205,13205,13225,-15,5,18,894
20150309,13205,13225,13180,13225,13135,13175,13180,-50,-45,128,836
20150310,13175,13180,13185,13185,13185,13185,13185,5,5,2,834
20150311,13185,13185,13115,13135,13115,13135,13130,-50,-55,82,754
20150312,13135,13130,13185,13335,13185,13295,13275,165,145,20,752
20150313,13295,13275,13290,13320,13270,13285,13300,10,25,176,816
20150316,13285,13300,13245,13290,13245,13245,13265,-55,-35,70,816
20150317,13245,13265,13265,13320,13220,13220,13265,-45,0,244,826
20150318,13220,13265,13265,13290,13255,13275,13270,10,5,250,830
20150319,13275,13270,13270,13425,13270,13425,13360,155,90,110,838
20150320,13425,13360,13405,13520,13355,13355,13415,-5,55,216,844
20150323,13355,13415,13360,13415,13335,13350,13350,-65,-65,238,930
20150324,13350,13350,13350,13410,13350,13410,13405,60,55,534,1074
20150325,13410,13405,13370,13385,13365,13380,13370,-25,-35,224,1064
20150326,13380,13370,13355,13380,13340,13380,13365,10,-5,272,1128
20150327,13380,13365,13375,13410,13375,13380,13385,15,20,44,1152
20150330,13380,13385,13360,13395,13355,13390,13390,5,5,328,1366
20150331,13390,13390,13390,13445,13390,13415,13425,25,35,116,1446
20150401,13415,13425,13390,13445,13390,13435,13435,10,10,878,2196
20150402,13435,13435,13420,13455,13415,13435,13445,0,10,114,2206
20150403,13435,13445,13420,13445,13415,13435,13425,-10,-20,132,2286
20150407,13435,13425,13475,13475,13445,13450,13450,25,25,48,2286
20150408,13450,13450,13425,13465,13425,13465,13440,15,-10,6,2288
20150409,13465,13440,13410,13410,13180,13340,13285,-100,-155,200,2298
20150410,13340,13285,13310,13315,13270,13315,13280,30,-5,66,2300
20150413,13315,13280,13280,13310,13195,13200,13235,-80,-45,166,2424
20150414,13200,13235,13215,13215,13120,13160,13145,-75,-90,186,2452
20150415,13160,13145,13145,13210,13140,13175,13160,30,15,152,2504
20150416,13175,13160,13185,13260,13180,13240,13215,80,55,58,2488
20150417,13240,13215,13290,13350,13290,13295,13315,80,100,148,2520
20150420,13295,13315,13270,13315,13205,13215,13245,-100,-70,130,2526
20150421,13215,13245,13230,13230,13190,13190,13200,-55,-45,488,2764
20150422,13190,13200,13180,13250,13180,13240,13220,40,20,256,2834
20150423,13240,13220,13210,13320,13190,13280,13255,60,35,270,2826
20150424,13280,13255,13300,13310,13255,13285,13280,30,25,120,2840
20150427,13285,13280,13330,13445,13330,13415,13390,135,110,1266,3114
20150428,13415,13390,13440,13470,13340,13350,13375,-40,-15,1062,3510
20150429,13350,13375,13440,13465,13335,13340,13375,-35,0,1152,4138
20150430,13340,13375,13355,13420,13355,13395,13390,20,15,1246,4746
20150504,13395,13390,13420,13515,13420,13480,13470,90,80,1566,5628
20150505,13480,13470,13485,13485,13435,13440,13455,-30,-15,716,5706
20150506,13440,13455,13490,13720,13490,13675,13645,220,190,2842,7150
20150507,13675,13645,13660,13660,13555,13575,13590,-70,-55,510,7232
20150508,13575,13590,13575,13620,13550,13570,13570,-20,-20,404,7278
20150511,13570,13570,13585,13610,13545,13595,13570,25,0,860,7076
20150512,13595,13570,13550,13580,13500,13505,13530,-65,-40,260,7140
20150513,13505,13530,13520,13545,13490,13520,13500,-10,-30,1716,8192
20150514,13520,13500,13515,13550,13435,13465,13455,-35,-45,1518,8118
20150515,13465,13455,13455,13505,13445,13495,13490,40,35,604,8206
20150518,13495,13490,13460,13485,13435,13470,13465,-20,-25,484,8266
20150519,13470,13465,13390,13405,13375,13400,13385,-65,-80,796,8326
20150520,13400,13385,13340,13360,13305,13330,13335,-55,-50,514,8126
20150521,13330,13335,13305,13410,13300,13370,13355,35,20,740,8356
20150522,13370,13355,13370,13400,13350,13365,13380,10,25,560,8612
20150525,13365,13380,13325,13365,13320,13325,13330,-55,-50,1426,9228
20150526,13325,13330,13335,13395,13335,13365,13370,35,40,288,9316
20150527,13365,13370,13325,13340,13290,13305,13315,-65,-55,626,9712
20150528,13305,13315,13250,13290,13245,13290,13270,-25,-45,1588,10366
20150529,13290,13270,13320,13340,13280,13320,13315,50,45,1076,10896
20150601,13320,13315,13295,13310,13260,13295,13290,-20,-25,2036,11194
20150602,13295,13290,13325,13325,13265,13265,13300,-25,10,1948,11990
20150603,13265,13300,13295,13310,13255,13255,13280,-45,-20,1846,12520
20150604,13255,13280,13265,13285,13195,13195,13215,-85,-65,3742,13608
20150605,13195,13215,13195,13285,13105,13120,13170,-95,-45,5332,15092
20150608,13120,13170,13070,13120,13060,13070,13085,-100,-85,2584,16376
20150609,13070,13085,13050,13095,13050,13070,13060,-15,-25,3510,17988
20150610,13070,13060,13075,13095,13055,13060,13065,0,5,2264,19662
20150611,13060,13065,13095,13095,12950,12960,13010,-105,-55,4156,22172
20150612,12960,13010,12950,12960,12845,12880,12890,-130,-120,8040,26374
20150615,12880,12890,12915,12920,12780,12785,12850,-105,-40,6174,29476
20150616,12785,12850,12800,12860,12750,12830,12805,-20,-45,10686,32618
20150617,12830,12805,12830,12830,12770,12785,12805,-20,0,5800,33760
20150618,12785,12805,12835,12840,12680,12760,12750,-45,-55,5460,35786
20150619,12760,12750,12785,12795,12740,12760,12755,10,5,4096,36798
20150623,12760,12755,12800,12840,12765,12810,12790,55,35,6964,40328
20150624,12810,12790,12835,12840,12805,12830,12820,40,30,13956,46648
20150625,12830,12820,12815,12840,12730,12765,12780,-55,-40,12508,49788
20150626,12765,12780,12765,12795,12725,12770,12765,-10,-15,6650,52198
20150629,12770,12765,12755,12765,12710,12735,12735,-30,-30,10444,57258
20150630,12735,12735,12705,12715,12575,12600,12630,-135,-105,20338,63954
20150701,12600,12630,12600,12620,12510,12550,12565,-80,-65,13558,68434
20150702,12550,12565,12580,13000,12580,12695,12725,130,160,16596,68950
20150703,12695,12725,12715,12750,12665,12705,12695,-20,-30,8964,72300
20150706,12705,12695,12670,12700,12485,12535,12580,-160,-115,27016,84454
20150707,12535,12580,12495,12585,12470,12480,12520,-100,-60,14570,90632
20150708,12480,12520,12455,12465,12015,12105,12220,-415,-300,70914,102708
20150709,12105,12220,12220,12485,12200,12440,12350,220,130,35172,104014
20150710,12440,12350,12520,12585,12445,12455,12505,105,155,16700,108764
20150713,12455,12505,12415,12535,12415,12450,12450,-55,-55,10404,109800
20150714,12450,12450,12600,12600,12445,12450,12495,0,45,14672,113124
20150715,12450,12495,12445,12505,12445,12485,12470,-10,-25,8438,113922
20150716,12485,12470,12470,12705,12405,12570,12550,100,80,26688,114306
20150717,12570,12550,12555,12585,12510,12560,12540,10,-10,15624,116764
20150720,12560,12540,12560,12560,12470,12495,12490,-45,-50,11258,118654
20150721,12495,12490,12485,12500,12445,12485,12465,-5,-25,14944,122424
20150722,12485,12465,12450,12450,12355,12355,12390,-110,-75,34332,134002
20150723,12355,12390,12345,12370,12270,12355,12320,-35,-70,34006,141560
20150724,12355,12320,12310,12310,12255,12270,12280,-50,-40,29574,146544
20150727,12270,12280,12270,12345,12240,12245,12295,-35,15,22660,145880
20150728,12245,12295,12230,12315,12145,12295,12245,0,-50,25984,145968
20150729,12295,12245,12270,12430,12270,12345,12360,100,115,38462,137704
20150730,12345,12360,12315,12340,12265,12275,12295,-85,-65,23968,137668
20150731,12275,12295,12195,12280,12195,12255,12260,-40,-35,27614,140186
20150803,12255,12260,12245,12310,12000,12095,12170,-165,-90,45728,147740
20150804,12095,12170,12080,12170,12025,12145,12110,-25,-60,31710,144964
20150805,12145,12110,12165,12280,12080,12120,12125,10,15,18196,145990
20150806,12120,12125,12115,12120,12010,12025,12065,-100,-60,25772,148932
20150807,12025,12065,11990,12005,11910,11960,11965,-105,-100,37040,150482
20150810,11960,11965,11965,12055,11935,11965,11975,0,10,27690,153038
20150811,11965,11975,11955,12120,11955,12040,12055,65,80,50750,146868
20150812,12040,12055,12040,12165,12000,12135,12085,80,30,49638,144384
20150813,12135,12085,12170,12270,12100,12140,12180,55,95,52368,140668
20150814,12140,12180,12120,12145,12085,12110,12110,-70,-70,21436,140010
20150817,12110,12110,12120,12140,12020,12070,12080,-40,-30,24268,139546
20150818,12070,12080,12040,12070,11975,11995,12020,-85,-60,16198,138896
20150819,11995,12020,11980,12020,11890,11965,11940,-55,-80,25354,136282
20150820,11965,11940,11945,12045,11935,12035,11990,95,50,26696,133364
20150821,12035,11990,12105,12120,11980,11990,12040,0,50,25474,131196
20150824,11990,12040,11970,11995,11805,11830,11885,-210,-155,55470,126524
20150825,11830,11885,11800,11910,11765,11870,11865,-15,-20,41970,121184
20150826,11870,11865,11945,12050,11840,11855,11900,-10,35,40152,117724
20150827,11855,11900,11810,11900,11810,11885,11865,-15,-35,26522,115082
20150828,11885,11865,11895,11975,11865,11930,11925,65,60,31412,112696
20150831,11930,11925,11950,12020,11865,11875,11935,-50,10,30540,107838
20150901,11875,11935,11895,11910,11775,11790,11825,-145,-110,23188,103314
20150902,11790,11825,11825,11865,11780,11830,11825,5,0,13000,100154
20150907,11830,11825,11870,11875,11810,11870,11840,45,15,11240,99798
20150908,11870,11840,11845,11875,11830,11870,11845,30,5,12508,98028
20150909,11870,11845,11940,12030,11905,12020,11965,175,120,28306,93470
20150910,12020,11965,12030,12130,11920,11960,11965,-5,0,21302,91014
20150911,11960,11965,11900,12000,11900,11990,11975,25,10,12278,92494
20150914,11990,11975,11950,12000,11945,11960,11970,-15,-5,11692,91262
20150915,11960,11970,11925,11950,11810,11830,11885,-140,-85,11634,87834
20150916,11830,11885,11930,11930,11845,11905,11880,20,-5,4448,86540
20150917,11905,11880,11900,11925,11870,11920,11900,40,20,6420,83878
20150918,11920,11900,11895,12000,11890,11965,11950,65,50,6674,81850
20150921,11965,11950,11930,11990,11845,11880,11920,-70,-30,12440,77422
20150922,11880,11920,11880,11895,11750,11840,11825,-80,-95,11300,73068
20150923,11840,11825,11765,11800,11720,11775,11770,-50,-55,10440,68868
20150924,11775,11770,11770,11795,11735,11780,11775,10,5,12466,64238
20150925,11780,11775,11750,11850,11750,11825,11805,50,30,10436,59712
20150928,11825,11805,11790,11800,11730,11730,11760,-75,-45,7724,56852
20150929,11730,11760,11705,11720,11610,11660,11645,-100,-115,10736,50826
20150930,11660,11645,11680,11730,11590,11650,11625,5,-20,5866,47390
20151008,11650,11625,11685,11685,11490,11495,11550,-130,-75,5330,44510
20151009,11495,11550,11385,11580,11385,11545,11485,-5,-65,10580,38800
20151012,11545,11485,11590,11640,11525,11555,11560,70,75,9200,33410
20151013,11555,11560,11505,11520,11430,11455,11450,-105,-110,4990,30300
20151014,11455,11450,11410,11450,11230,11260,11360,-190,-90,5320,27010
20151015,11260,11360,11260,11300,11210,11210,11270,-150,-90,6290,22900
al1511,20150105,13690,13630,13555,13555,13445,13445,13470,-185,-160,26,152
20150106,13445,13470,13400,13400,13400,13400,13400,-70,-70,22,160
20150107,13400,13400,13330,13380,13330,13370,13360,-30,-40,40,178
20150108,13370,13360,,,,13360,13360,0,0,0,178
20150109,13360,13360,13390,13390,13305,13375,13345,15,-15,16,174
20150112,13375,13345,13310,13310,13310,13310,13310,-35,-35,2,176
20150113,13310,13310,13180,13180,13180,13180,13180,-130,-130,10,180
20150114,13180,13180,13110,13110,13105,13105,13105,-75,-75,4,178
20150115,13105,13105,13220,13285,13195,13195,13220,90,115,28,176
20150116,13195,13220,13375,13375,13295,13330,13310,110,90,14,166
20150119,13330,13310,13295,13295,13295,13295,13295,-15,-15,10,174
20150120,13295,13295,13290,13335,13290,13300,13315,5,20,72,184
20150121,13300,13315,,,,13265,13265,-50,-50,0,184
20150122,13265,13265,13250,13280,13250,13280,13265,15,0,60,202
20150123,13280,13265,13280,13280,13280,13280,13280,15,15,6,200
20150126,13280,13280,13245,13245,13210,13210,13230,-70,-50,24,200
20150127,13210,13230,13295,13300,13295,13300,13295,70,65,80,242
20150128,13300,13295,13295,13295,13295,13295,13295,0,0,6,246
20150129,13295,13295,,,,13275,13275,-20,-20,0,246
20150130,13275,13275,13225,13225,13130,13175,13170,-100,-105,28,264
20150202,13175,13170,13180,13260,13180,13260,13195,90,25,84,280
20150203,13260,13195,13295,13420,13275,13420,13340,225,145,26,276
20150204,13420,13340,13515,13515,13375,13475,13460,135,120,70,306
20150205,13475,13460,13520,13520,13520,13520,13520,60,60,2,304
20150206,13520,13520,13660,13660,13660,13660,13660,140,140,2,306
20150209,13660,13660,13575,13625,13565,13565,13580,-95,-80,20,310
20150210,13565,13580,13530,13535,13465,13465,13515,-115,-65,20,306
20150211,13465,13515,13420,13425,13350,13350,13385,-165,-130,12,306
20150212,13350,13385,13315,13315,13290,13290,13300,-95,-85,4,308
20150213,13290,13300,13370,13370,13370,13370,13370,70,70,32,328
20150216,13370,13370,13425,13425,13385,13385,13405,15,35,38,344
20150217,13385,13405,13370,13370,13325,13350,13345,-55,-60,34,368
20150225,13350,13345,13395,13395,13320,13320,13345,-25,0,22,356
20150226,13320,13345,13350,13350,13350,13350,13350,5,5,2,356
20150227,13350,13350,13320,13330,13255,13265,13290,-85,-60,118,406
20150302,13265,13290,13375,13390,13375,13390,13380,100,90,4,404
20150303,13390,13380,13355,13355,13340,13340,13340,-40,-40,24,404
20150304,13340,13340,13285,13285,13285,13285,13285,-55,-55,10,404
20150305,13285,13285,13300,13300,13260,13265,13270,-20,-15,22,410
20150306,13265,13270,13295,13295,13250,13250,13270,-20,0,4,412
20150309,13250,13270,13245,13245,13235,13240,13235,-30,-35,32,408
20150310,13240,13235,,,,13235,13235,0,0,0,408
20150311,13235,13235,13225,13225,13225,13225,13225,-10,-10,16,408
20150312,13225,13225,13280,13435,13280,13435,13365,210,140,34,426
20150313,13435,13365,13360,13415,13320,13345,13355,-20,-10,140,462
20150316,13345,13355,13340,13340,13325,13335,13330,-20,-25,10,462
20150317,13335,13330,13310,13310,13280,13280,13290,-50,-40,6,466
20150318,13280,13290,13330,13335,13320,13320,13325,30,35,42,470
20150319,13320,13325,13455,13455,13455,13455,13455,130,130,6,470
20150320,13455,13455,13595,13595,13385,13385,13465,-70,10,312,570
20150323,13385,13465,13435,13435,13410,13410,13410,-55,-55,48,564
20150324,13410,13410,13415,13415,13410,13410,13410,0,0,20,574
20150325,13410,13410,13400,13400,13400,13400,13400,-10,-10,4,574
20150326,13400,13400,13430,13430,13430,13430,13430,30,30,2,576
20150327,13430,13430,,,,13430,13430,0,0,0,576
20150330,13430,13430,13385,13400,13385,13400,13395,-30,-35,86,594
20150331,13400,13395,13455,13455,13445,13445,13450,50,55,8,588
20150401,13445,13450,13455,13455,13455,13455,13455,5,5,2,588
20150402,13455,13455,13455,13455,13455,13455,13455,0,0,40,628
20150403,13455,13455,13465,13470,13465,13470,13465,15,10,22,648
20150407,13470,13465,13515,13515,13490,13490,13490,25,25,22,648
20150408,13490,13490,,,,13490,13490,0,0,0,648
20150409,13490,13490,13390,13415,13210,13415,13300,-75,-190,78,650
20150410,13415,13300,13340,13350,13295,13350,13310,50,10,30,652
20150413,13350,13310,13330,13330,13220,13260,13250,-50,-60,36,670
20150414,13260,13250,13215,13250,13175,13175,13190,-75,-60,28,690
20150415,13175,13190,13250,13250,13185,13200,13200,10,10,152,716
20150416,13200,13200,13265,13265,13260,13260,13260,60,60,44,710
20150417,13260,13260,13400,13400,13320,13320,13365,60,105,6,710
20150420,13320,13365,13315,13315,13240,13280,13270,-85,-95,28,710
20150421,13280,13270,13220,13240,13215,13240,13215,-30,-55,44,714
20150422,13240,13215,13270,13270,13270,13270,13270,55,55,4,714
20150423,13270,13270,13230,13365,13230,13315,13270,45,0,12,716
20150424,13315,13270,13285,13325,13285,13300,13300,30,30,22,728
20150427,13300,13300,13400,13465,13395,13445,13425,145,125,284,880
20150428,13445,13425,13475,13480,13350,13405,13400,-20,-25,54,874
20150429,13405,13400,13465,13465,13370,13375,13420,-25,20,232,886
20150430,13375,13420,13415,13440,13405,13420,13420,0,0,32,882
20150504,13420,13420,13450,13520,13450,13505,13495,85,75,574,1226
20150505,13505,13495,13515,13515,13460,13465,13475,-30,-20,240,1272
20150506,13465,13475,13505,13750,13505,13730,13680,255,205,296,1402
20150507,13730,13680,13695,13715,13615,13640,13640,-40,-40,260,1496
20150508,13640,13640,13625,13665,13590,13595,13605,-45,-35,416,1590
20150511,13595,13605,13655,13655,13595,13625,13620,20,15,40,1594
20150512,13625,13620,13620,13630,13550,13550,13575,-70,-45,42,1616
20150513,13550,13575,13570,13575,13540,13550,13555,-25,-20,22,1634
20150514,13550,13555,13550,13605,13500,13510,13530,-45,-25,50,1658
20150515,13510,13530,13520,13550,13500,13550,13515,20,-15,60,1702
20150518,13550,13515,13515,13530,13500,13510,13505,-5,-10,228,1688
20150519,13510,13505,13430,13455,13415,13440,13440,-65,-65,546,1946
20150520,13440,13440,13410,13410,13340,13340,13375,-100,-65,196,2052
20150521,13340,13375,13370,13425,13360,13425,13380,50,5,134,2072
20150522,13425,13380,13425,13430,13385,13385,13405,5,25,196,2108
20150525,13385,13405,13385,13395,13375,13380,13380,-25,-25,224,2176
20150526,13380,13380,13400,13455,13395,13400,13405,20,25,324,2274
20150527,13400,13405,13400,13400,13320,13325,13345,-80,-60,254,2378
20150528,13325,13345,13305,13335,13285,13320,13315,-25,-30,392,2612
20150529,13320,13315,13330,13380,13330,13375,13365,60,50,342,2840
20150601,13375,13365,13330,13360,13325,13345,13345,-20,-20,340,3010
20150602,13345,13345,13365,13365,13335,13335,13350,-10,5,410,3282
20150603,13335,13350,13320,13340,13295,13295,13315,-55,-35,346,3392
20150604,13295,13315,13340,13340,13230,13230,13260,-85,-55,600,3768
20150605,13230,13260,13200,13305,13150,13150,13195,-110,-65,1278,4146
20150608,13150,13195,13140,13180,13105,13120,13140,-75,-55,208,4170
20150609,13120,13140,13140,13210,13110,13125,13150,-15,10,106,4212
20150610,13125,13150,13145,13155,13110,13110,13125,-40,-25,546,4348
20150611,13110,13125,13125,13125,13010,13010,13055,-115,-70,1562,5542
20150612,13010,13055,13000,13000,12900,12930,12930,-125,-125,2378,7072
20150615,12930,12930,12945,12945,12850,12855,12890,-75,-40,2258,8452
20150616,12855,12890,12850,12910,12800,12870,12860,-20,-30,3382,10110
20150617,12870,12860,12860,12870,12820,12820,12850,-40,-10,1752,11126
20150618,12820,12850,12845,12845,12725,12800,12795,-50,-55,2180,12040
20150619,12800,12795,12815,12830,12780,12790,12805,-5,10,542,12312
20150623,12790,12805,12845,12855,12805,12835,12830,30,25,2432,13976
20150624,12835,12830,12850,12860,12830,12855,12845,25,15,4856,17258
20150625,12855,12845,12860,12865,12755,12775,12790,-70,-55,3056,18566
20150626,12775,12790,12780,12795,12750,12780,12775,-10,-15,3084,20464
20150629,12780,12775,12730,12775,12720,12740,12745,-35,-30,2778,21622
20150630,12740,12745,12730,12730,12590,12660,12635,-85,-110,5658,23978
20150701,12660,12635,12620,12620,12550,12585,12585,-50,-50,3354,24888
20150702,12585,12585,12640,12930,12640,12710,12725,125,140,6590,27092
20150703,12710,12725,12720,12765,12680,12710,12715,-15,-10,1934,27718
20150706,12710,12715,12700,12700,12530,12575,12590,-140,-125,5112,29190
20150707,12575,12590,12545,12615,12515,12520,12555,-70,-35,2946,29798
20150708,12520,12555,12505,12510,12050,12130,12265,-425,-290,15628,33578
20150709,12130,12265,12490,12530,12250,12480,12400,215,135,8262,34438
20150710,12480,12400,12500,12630,12480,12480,12535,80,135,4004,36040
20150713,12480,12535,12465,12540,12455,12475,12485,-60,-50,1238,36104
20150714,12475,12485,12575,12580,12480,12480,12515,-5,30,2468,37038
20150715,12480,12515,12470,12525,12470,12520,12500,5,-15,1306,37598
20150716,12520,12500,12500,12750,12450,12590,12595,90,95,10232,39028
20150717,12590,12595,12580,12605,12535,12580,12560,-15,-35,3138,39954
20150720,12580,12560,12540,12560,12500,12535,12515,-25,-45,2692,40426
20150721,12535,12515,12500,12520,12480,12510,12495,-5,-20,2246,41358
20150722,12510,12495,12465,12480,12385,12390,12415,-105,-80,12292,48644
20150723,12390,12415,12380,12390,12300,12370,12345,-45,-70,8138,51712
20150724,12370,12345,12300,12325,12285,12290,12300,-55,-45,10672,56468
20150727,12290,12300,12295,12360,12265,12280,12310,-20,10,5752,58152
20150728,12280,12310,12310,12330,12165,12300,12270,-10,-40,8090,59706
20150729,12300,12270,12330,12445,12330,12370,12375,100,105,10876,61054
20150730,12370,12375,12345,12350,12285,12305,12305,-70,-70,6160,63406
20150731,12305,12305,12280,12300,12210,12280,12275,-25,-30,6440,64942
20150803,12280,12275,12285,12325,12085,12135,12205,-140,-70,19628,72492
20150804,12135,12205,12135,12200,12070,12195,12150,-10,-55,15686,75102
20150805,12195,12150,12200,12270,12120,12160,12170,10,20,6246,76170
20150806,12160,12170,12160,12160,12055,12070,12105,-100,-65,11256,79414
20150807,12070,12105,12030,12035,11955,11995,11995,-110,-110,19352,85398
20150810,11995,11995,11990,12095,11965,12010,12005,15,10,11674,88014
20150811,12010,12005,12000,12140,11995,12075,12085,70,80,20574,88608
20150812,12075,12085,12060,12200,12025,12190,12125,105,40,24200,89444
20150813,12190,12125,12220,12300,12140,12180,12210,55,85,20050,93534
20150814,12180,12210,12145,12180,12120,12135,12145,-75,-65,7696,94100
20150817,12135,12145,12160,12170,12050,12090,12105,-55,-40,12814,96132
20150818,12090,12105,12075,12095,12005,12010,12045,-95,-60,8970,96040
20150819,12010,12045,12010,12045,11920,11970,11965,-75,-80,20678,101404
20150820,11970,11965,11975,12070,11965,12055,12015,90,50,16752,100000
20150821,12055,12015,12135,12140,12000,12000,12060,-15,45,15630,100140
20150824,12000,12060,11975,12020,11820,11840,11895,-220,-165,49934,115542
20150825,11840,11895,11810,11910,11785,11880,11865,-15,-30,29272,114488
20150826,11880,11865,11965,12030,11850,11855,11900,-10,35,30442,117426
20150827,11855,11900,11845,11900,11820,11875,11860,-25,-40,21710,119978
20150828,11875,11860,11885,11980,11865,11935,11920,75,60,31564,119536
20150831,11935,11920,11950,12020,11875,11890,11945,-30,25,33894,120760
20150901,11890,11945,11900,11900,11775,11825,11825,-120,-120,50776,121534
20150902,11825,11825,11825,11885,11780,11850,11840,25,15,19480,120628
20150907,11850,11840,11840,11915,11825,11885,11865,45,25,18490,119704
20150908,11885,11865,11875,11915,11870,11915,11885,50,20,24578,115746
20150909,11915,11885,11970,12065,11950,12060,12010,175,125,54768,118280
20150910,12060,12010,12085,12195,11950,12010,12015,0,5,37326,117682
20150911,12010,12015,12000,12060,11970,12045,12025,30,10,24738,117746
20150914,12045,12025,12000,12055,11980,12010,12015,-15,-10,25476,116386
20150915,12010,12015,11955,11995,11860,11900,11930,-115,-85,27780,114696
20150916,11900,11930,11905,11950,11875,11935,11915,5,-15,18628,114092
20150917,11935,11915,11935,11965,11905,11955,11935,40,20,19422,112724
20150918,11955,11935,11950,12045,11920,12005,11985,70,50,23438,110774
20150921,12005,11985,11955,12030,11865,11890,11950,-95,-35,44598,110024
20150922,11890,11950,11905,11925,11800,11870,11855,-80,-95,35154,109444
20150923,11870,11855,11820,11820,11735,11790,11780,-65,-75,35438,106228
20150924,11790,11780,11790,11825,11730,11785,11775,5,-5,23622,100860
20150925,11785,11775,11755,11880,11740,11815,11810,40,35,25818,94046
20150928,11815,11810,11840,11840,11715,11715,11755,-95,-55,12576,91582
20150929,11715,11755,11715,11725,11590,11660,11645,-95,-110,28818,82572
20150930,11660,11645,11725,11725,11570,11660,11625,15,-20,15638,79752
20151008,11660,11625,11700,11700,11470,11475,11545,-150,-80,13354,77340
20151009,11475,11545,11460,11610,11375,11610,11495,65,-50,20270,72774
20151012,11610,11495,11705,11705,11535,11585,11595,90,100,19326,70684
20151013,11585,11595,11625,11625,11430,11485,11495,-110,-100,8166,70362
20151014,11485,11495,11445,11570,11250,11300,11400,-195,-95,11894,69554
20151015,11300,11400,11355,11355,11210,11250,11310,-150,-90,13686,68790
20151016,11250,11310,11215,11275,11160,11170,11215,-140,-95,10224,65972
20151019,11170,11215,11170,11260,11075,11110,11170,-105,-45,12084,62404
20151020,11110,11170,11110,11120,10985,11025,11035,-145,-135,14180,59532
20151021,11025,11035,11000,11040,10770,10825,10885,-210,-150,19920,51688
20151022,10825,10885,10795,10865,10700,10720,10780,-165,-105,12138,48080
20151023,10720,10780,10750,10810,10360,10630,10580,-150,-200,24210,44356
20151026,10630,10580,10675,10675,10415,10460,10470,-120,-110,10030,42962
20151027,10460,10470,10455,10570,10420,10510,10510,40,40,6964,41112
20151028,10510,10510,10500,10640,10345,10355,10400,-155,-110,13088,40046
20151029,10355,10400,10320,10455,10315,10345,10365,-55,-35,7604,38924
20151030,10345,10365,10340,10405,10320,10380,10365,15,0,4700,37550
20151102,10380,10365,10360,10380,10310,10325,10340,-40,-25,2880,36350
20151103,10325,10340,10365,10440,10350,10370,10380,30,40,3120,36680
20151104,10370,10380,10360,10490,10360,10490,10410,110,30,3830,37030
20151105,10490,10410,10445,10590,10445,10515,10500,105,90,8070,37290
20151106,10515,10500,10505,10570,10475,10515,10510,15,10,3910,36390
20151109,10515,10510,10500,10585,10460,10520,10545,10,35,4450,36270
20151110,10520,10545,10500,10500,10300,10320,10345,-225,-200,8070,34170
20151111,10320,10345,10250,10270,10090,10105,10130,-240,-215,6850,32330
20151112,10105,10130,10100,10210,10065,10185,10150,55,20,4390,29840
20151113,10185,10150,10000,10285,10000,10265,10235,115,85,6300,28110
20151116,10265,10235,10270,10275,10160,10160,10240,-75,5,6710,22960
al1512,20150105,13755,13685,,,,13565,13565,-120,-120,0,32
20150106,13565,13565,,,,13565,13565,0,0,0,32
20150107,13565,13565,13400,13400,13400,13400,13400,-165,-165,2,32
20150108,13400,13400,13440,13440,13390,13390,13405,-10,5,6,28
20150109,13390,13405,13420,13420,13415,13420,13415,15,10,6,26
20150112,13420,13415,,,,13360,13360,-55,-55,0,26
20150113,13360,13360,13280,13300,13280,13300,13290,-60,-70,6,20
20150114,13300,13290,13295,13295,12955,13140,13190,-150,-100,24,32
20150115,13140,13190,13290,13320,13205,13310,13280,120,90,62,62
20150116,13310,13280,13350,13410,13325,13325,13340,45,60,28,78
20150119,13325,13340,13395,13470,13330,13330,13355,-10,15,40,102
20150120,13330,13355,13315,13380,13280,13280,13335,-75,-20,102,188
20150121,13280,13335,13325,13325,13265,13265,13300,-70,-35,32,196
20150122,13265,13300,13305,13330,13305,13330,13315,30,15,12,198
20150123,13330,13315,13325,13325,13310,13310,13315,-5,0,16,206
20150126,13310,13315,13285,13285,13130,13130,13235,-185,-80,30,228
20150127,13130,13235,13305,13340,13305,13335,13325,100,90,54,246
20150128,13335,13325,13310,13310,13290,13310,13305,-15,-20,20,260
20150129,13310,13305,13290,13300,13290,13300,13295,-5,-10,18,262
20150130,13300,13295,13250,13300,13250,13250,13295,-45,0,86,348
20150202,13250,13295,13310,13325,13310,13325,13320,30,25,92,390
20150203,13325,13320,13310,13525,13310,13525,13405,205,85,12,392
20150204,13525,13405,13555,13620,13465,13535,13535,130,130,12,394
20150205,13535,13535,13675,13690,13600,13600,13615,65,80,50,434
20150206,13600,13615,13600,13700,13600,13700,13650,85,35,22,456
20150209,13700,13650,13655,13655,13580,13580,13615,-70,-35,46,460
20150210,13580,13615,13560,13560,13535,13535,13540,-80,-75,8,464
20150211,13535,13540,13445,13455,13385,13385,13425,-155,-115,10,468
20150212,13385,13425,13360,13360,13325,13340,13355,-85,-70,40,506
20150213,13340,13355,13285,13425,13285,13425,13385,70,30,14,510
20150216,13425,13385,13450,13450,13405,13430,13435,45,50,28,502
20150217,13430,13435,13400,13440,13400,13440,13425,5,-10,18,508
20150225,13440,13425,13380,13380,13380,13380,13380,-45,-45,6,502
20150226,13380,13380,13290,13320,13290,13315,13310,-65,-70,18,496
20150227,13315,13310,13335,13335,13305,13305,13320,-5,10,82,484
20150302,13305,13320,13355,13360,13355,13360,13355,40,35,26,510
20150303,13360,13355,13385,13390,13355,13355,13380,0,25,16,512
20150304,13355,13380,13335,13335,13335,13335,13335,-45,-45,4,512
20150305,13335,13335,13310,13320,13310,13320,13315,-15,-20,12,506
20150306,13320,13315,13375,13375,13335,13335,13360,20,45,16,500
20150309,13335,13360,13290,13320,13275,13320,13290,-40,-70,54,478
20150310,13320,13290,13280,13290,13280,13290,13280,0,-10,22,476
20150311,13290,13280,13170,13275,13170,13275,13210,-5,-70,32,478
20150312,13275,13210,13270,13270,13260,13260,13265,50,55,4,478
20150313,13260,13265,13400,13450,13385,13385,13400,120,135,48,484
20150316,13385,13400,13370,13380,13320,13320,13340,-80,-60,66,460
20150317,13320,13340,13340,13340,13305,13305,13305,-35,-35,26,460
20150318,13305,13305,13300,13425,13300,13370,13355,65,50,130,460
20150319,13370,13355,13370,13485,13350,13455,13425,100,70,48,492
20150320,13455,13425,13600,13600,13435,13435,13475,10,50,230,554
20150323,13435,13475,13455,13460,13425,13425,13445,-50,-30,118,544
20150324,13425,13445,13500,13515,13445,13515,13475,70,30,8,544
20150325,13515,13475,13450,13450,13450,13450,13450,-25,-25,12,546
20150326,13450,13450,13465,13485,13440,13450,13450,0,0,34,556
20150327,13450,13450,13495,13495,13465,13465,13475,15,25,6,560
20150330,13465,13475,13410,13440,13410,13440,13430,-35,-45,16,570
20150331,13440,13430,13460,13460,13460,13460,13460,30,30,2,570
20150401,13460,13460,13415,13485,13415,13485,13460,25,0,14,574
20150402,13485,13460,13495,13495,13495,13495,13495,35,35,2,572
20150403,13495,13495,13510,13510,13510,13510,13510,15,15,22,586
20150407,13510,13510,13540,13545,13520,13520,13535,10,25,18,598
20150408,13520,13535,,,,13535,13535,0,0,0,598
20150409,13535,13535,13365,13370,13230,13370,13305,-165,-230,84,580
20150410,13370,13305,,,,13305,13305,0,0,0,580
20150413,13305,13305,13315,13360,13315,13325,13330,20,25,24,580
20150414,13325,13330,13240,13240,13190,13190,13205,-140,-125,58,584
20150415,13190,13205,13240,13240,13240,13240,13240,35,35,42,582
20150416,13240,13240,13285,13285,13285,13285,13285,45,45,20,582
20150417,13285,13285,13400,13400,13400,13400,13400,115,115,2,580
20150420,13400,13400,13355,13355,13285,13320,13310,-80,-90,8,588
20150421,13320,13310,,,,13310,13310,0,0,0,588
20150422,13310,13310,,,,13310,13310,0,0,0,588
20150423,13310,13310,13290,13600,13290,13380,13380,70,70,50,596
20150424,13380,13380,13360,13380,13290,13290,13360,-90,-20,34,604
20150427,13290,13360,13455,13510,13430,13510,13455,150,95,142,634
20150428,13510,13455,13495,13495,13475,13475,13490,20,35,12,634
20150429,13475,13490,13500,13505,13430,13430,13485,-60,-5,68,624
20150430,13430,13485,13460,13460,13425,13425,13440,-60,-45,14,622
20150504,13425,13440,13540,13540,13515,13515,13515,75,75,22,600
20150505,13515,13515,,,,13510,13510,-5,-5,0,600
20150506,13510,13510,13610,13760,13505,13740,13685,230,175,110,594
20150507,13740,13685,13725,13725,13645,13685,13690,0,5,224,704
20150508,13685,13690,13650,13670,13610,13660,13640,-30,-50,250,758
20150511,13660,13640,13625,13625,13585,13585,13605,-55,-35,4,760
20150512,13585,13605,13655,13655,13600,13600,13620,-5,15,36,770
20150513,13600,13620,13550,13615,13540,13585,13580,-35,-40,96,798
20150514,13585,13580,13600,13600,13540,13540,13560,-40,-20,94,882
20150515,13540,13560,,,,13545,13545,-15,-15,0,882
20150518,13545,13545,13570,13570,13570,13570,13570,25,25,4,882
20150519,13570,13570,,,,13570,13570,0,0,0,882
20150520,13570,13570,13450,13455,13425,13425,13435,-145,-135,106,898
20150521,13425,13435,13495,13495,13475,13475,13485,40,50,4,898
20150522,13475,13485,13455,13460,13455,13455,13455,-30,-30,10,898
20150525,13455,13455,13440,13440,13400,13430,13420,-25,-35,14,904
20150526,13430,13420,,,,13445,13445,25,25,0,904
20150527,13445,13445,13400,13430,13385,13385,13400,-60,-45,14,900
20150528,13385,13400,13355,13385,13330,13380,13365,-20,-35,36,898
20150529,13380,13365,13410,13415,13350,13415,13400,50,35,102,936
20150601,13415,13400,13370,13415,13340,13385,13390,-15,-10,118,936
20150602,13385,13390,13420,13420,13390,13390,13410,0,20,72,936
20150603,13390,13410,13385,13390,13365,13365,13375,-45,-35,50,976
20150604,13365,13375,13410,13410,13300,13300,13355,-75,-20,106,1004
20150605,13300,13355,13255,13330,13215,13215,13230,-140,-125,328,1182
20150608,13215,13230,13200,13230,13175,13175,13190,-55,-40,1140,1700
20150609,13175,13190,13180,13190,13160,13160,13170,-30,-20,190,1876
20150610,13160,13170,13160,13205,13160,13170,13165,0,-5,586,2108
20150611,13170,13165,13190,13195,13080,13080,13130,-85,-35,270,2240
20150612,13080,13130,12995,13015,12980,12990,13000,-140,-130,374,2344
20150615,12990,13000,12970,12985,12900,12900,12945,-100,-55,1466,3150
20150616,12900,12945,12880,12950,12875,12920,12910,-25,-35,1582,4394
20150617,12920,12910,12910,12915,12880,12880,12900,-30,-10,942,4684
20150618,12880,12900,12880,12880,12780,12835,12845,-65,-55,944,5360
20150619,12835,12845,12860,12870,12820,12850,12845,5,0,438,5508
20150623,12850,12845,12870,12875,12840,12865,12855,20,10,792,6208
20150624,12865,12855,12890,12890,12860,12865,12870,10,15,2052,7774
20150625,12865,12870,12885,12885,12765,12800,12825,-70,-45,630,8134
20150626,12800,12825,12790,12810,12775,12775,12795,-50,-30,1102,8826
20150629,12775,12795,12750,12790,12725,12750,12745,-45,-50,3656,9966
20150630,12750,12745,12710,12715,12605,12665,12650,-80,-95,1528,9628
20150701,12665,12650,12615,12665,12590,12620,12625,-30,-25,794,9678
20150702,12620,12625,12755,13125,12695,12720,12740,95,115,2302,11124
20150703,12720,12740,12730,12780,12695,12720,12730,-20,-10,936,11676
20150706,12720,12730,12660,12690,12550,12610,12610,-120,-120,1484,11962
20150707,12610,12610,12570,12645,12535,12535,12590,-75,-20,810,12264
20150708,12535,12590,12480,12480,12095,12200,12280,-390,-310,3620,12570
20150709,12200,12280,12470,12580,12320,12515,12435,235,155,4228,14350
20150710,12515,12435,12585,12665,12495,12495,12555,60,120,2918,16336
20150713,12495,12555,12490,12565,12465,12515,12520,-40,-35,722,16346
20150714,12515,12520,12570,12600,12500,12500,12545,-20,25,856,16572
20150715,12500,12545,12510,12550,12510,12510,12530,-35,-15,492,16854
20150716,12510,12530,12535,12755,12485,12600,12605,70,75,5892,19654
20150717,12600,12605,12580,12610,12550,12610,12570,5,-35,1560,19496
20150720,12610,12570,12550,12575,12520,12545,12530,-25,-40,686,19568
20150721,12545,12530,12510,12540,12500,12515,12510,-15,-20,644,19590
20150722,12515,12510,12470,12490,12400,12410,12425,-100,-85,4482,22106
20150723,12410,12425,12375,12400,12325,12395,12350,-30,-75,2410,23480
20150724,12395,12350,12335,12340,12295,12295,12310,-55,-40,3534,25638
20150727,12295,12310,12300,12370,12275,12275,12320,-35,10,3296,28280
20150728,12275,12320,12250,12335,12195,12330,12280,10,-40,2736,29802
20150729,12330,12280,12345,12450,12345,12360,12375,80,95,4178,32108
20150730,12360,12375,12335,12350,12280,12290,12310,-85,-65,3426,34410
20150731,12290,12310,12255,12305,12235,12280,12285,-30,-25,4042,36600
20150803,12280,12285,12300,12335,12100,12160,12205,-125,-80,9656,39490
20150804,12160,12205,12130,12230,12115,12230,12180,25,-25,3796,39396
20150805,12230,12180,12270,12270,12160,12190,12195,10,15,4102,38400
20150806,12190,12195,12160,12190,12090,12100,12135,-95,-60,5214,40982
20150807,12100,12135,12030,12055,11985,12010,12025,-125,-110,10018,46400
20150810,12010,12025,12070,12090,12000,12030,12025,5,0,2594,46088
20150811,12030,12025,12030,12155,12020,12095,12115,70,90,5606,46874
20150812,12095,12115,12085,12230,12060,12215,12175,100,60,5938,49242
20150813,12215,12175,12250,12340,12180,12210,12250,35,75,8532,53242
20150814,12210,12250,12185,12205,12150,12165,12170,-85,-80,4624,56198
20150817,12165,12170,12180,12210,12090,12125,12140,-45,-30,3904,55262
20150818,12125,12140,12100,12135,12040,12050,12075,-90,-65,3318,55980
20150819,12050,12075,12040,12050,11950,12005,11995,-70,-80,7876,56924
20150820,12005,11995,11995,12095,11995,12090,12025,95,30,8290,60546
20150821,12090,12025,12140,12160,12025,12040,12065,15,40,8918,62000
20150824,12040,12065,12010,12050,11830,11840,11915,-225,-150,18442,68734
20150825,11840,11915,11830,11915,11805,11875,11875,-40,-40,20258,77570
20150826,11875,11875,11970,12030,11855,11870,11895,-5,20,18914,80888
20150827,11870,11895,11870,11905,11825,11890,11870,-5,-25,10982,83828
20150828,11890,11870,11925,11985,11875,11950,11930,80,60,12182,87554
20150831,11950,11930,12000,12030,11895,11915,11960,-15,30,15434,91704
20150901,11915,11960,11900,11930,11805,11835,11850,-125,-110,17158,97240
20150902,11835,11850,11835,11895,11805,11880,11855,30,5,4866,97818
20150907,11880,11855,11850,11945,11845,11935,11895,80,40,7604,97484
20150908,11935,11895,11910,11950,11905,11940,11920,45,25,11902,99320
20150909,11940,11920,11960,12115,11960,12115,12055,195,135,20742,100338
20150910,12115,12055,12105,12230,11990,12045,12050,-10,-5,16180,100902
20150911,12045,12050,12045,12100,12005,12085,12070,35,20,8718,102034
20150914,12085,12070,12035,12095,12020,12050,12055,-20,-15,9172,103954
20150915,12050,12055,11985,12030,11910,11910,11960,-145,-95,17814,108156
20150916,11910,11960,11945,11985,11915,11970,11950,10,-10,10102,109964
20150917,11970,11950,11970,12005,11945,12000,11975,50,25,11498,112270
20150918,12000,11975,11970,12080,11965,12050,12030,75,55,16044,113462
20150921,12050,12030,12040,12075,11900,11920,11985,-110,-45,35218,118154
20150922,11920,11985,11945,11945,11835,11890,11885,-95,-100,29346,124214
20150923,11890,11885,11840,11840,11755,11805,11805,-80,-80,46148,135920
20150924,11805,11805,11780,11840,11745,11800,11790,-5,-15,35156,141582
20150925,11800,11790,11765,11900,11760,11825,11825,35,35,33610,141518
20150928,11825,11825,11810,11825,11730,11750,11770,-75,-55,19054,147980
20150929,11750,11770,11720,11745,11610,11660,11660,-110,-110,42198,149716
20150930,11660,11660,11700,11750,11585,11680,11645,20,-15,31818,151322
20151008,11680,11645,11695,11695,11475,11490,11555,-155,-90,39416,161154
20151009,11490,11555,11465,11635,11380,11600,11500,45,-55,93630,159706
20151012,11600,11500,11670,11725,11545,11615,11610,115,110,69212,171046
20151013,11615,11610,11615,11615,11450,11500,11510,-110,-100,52728,174826
20151014,11500,11510,11470,11590,11310,11335,11415,-175,-95,76170,183428
20151015,11335,11415,11345,11400,11220,11295,11330,-120,-85,60556,183856
20151016,11295,11330,11250,11305,11180,11195,11235,-135,-95,51974,179100
20151019,11195,11235,11195,11280,11085,11090,11195,-145,-40,78744,163602
20151020,11090,11195,11085,11125,10980,11010,11040,-185,-155,66288,152426
20151021,11010,11040,11015,11035,10765,10825,10880,-215,-160,108088,145658
20151022,10825,10880,10815,10865,10700,10705,10785,-175,-95,85598,140072
20151023,10705,10785,10730,10820,10350,10630,10550,-155,-235,189824,125098
20151026,10630,10550,10670,10670,10400,10470,10475,-80,-75,115984,118646
20151027,10470,10475,10480,10580,10425,10530,10510,55,35,71756,113806
20151028,10530,10510,10530,10650,10300,10330,10445,-180,-65,67894,110340
20151029,10330,10445,10205,10450,10205,10365,10360,-80,-85,60506,102596
20151030,10365,10360,10345,10405,10315,10375,10360,15,0,29702,98018
20151102,10375,10360,10365,10410,10305,10355,10345,-5,-15,18682,93708
20151103,10355,10345,10355,10450,10335,10380,10390,35,45,17740,90408
20151104,10380,10390,10375,10525,10345,10525,10420,135,30,20558,87158
20151105,10525,10420,10525,10650,10470,10560,10555,140,135,28960,82618
20151106,10560,10555,10550,10615,10490,10540,10545,-15,-10,13832,80454
20151109,10540,10545,10555,10620,10470,10540,10560,-5,15,12420,79152
20151110,10540,10560,10535,10570,10245,10300,10345,-260,-215,23436,78904
20151111,10300,10345,10285,10305,10000,10065,10115,-280,-230,24318,73422
20151112,10065,10115,10125,10195,10080,10155,10120,40,5,11604,71966
20151113,10155,10120,10030,10230,9965,10185,10155,65,35,15578,69502
20151116,10185,10155,10145,10280,10100,10155,10205,0,50,11370,69052
20151117,10155,10205,10115,10190,10050,10150,10105,-55,-100,13608,66856
20151118,10150,10105,10180,10215,10005,10080,10080,-25,-25,14548,65404
20151119,10080,10080,10060,10065,9855,9890,9945,-190,-135,10280,64200
20151120,9890,9945,9900,10150,9710,10030,9935,85,-10,20350,60904
20151123,10030,9935,10050,10135,9820,9950,9960,15,25,18286,59256
20151124,9950,9960,9845,9950,9735,9870,9825,-90,-135,14708,57692
20151125,9870,9825,9835,10075,9770,9950,9930,125,105,15548,55740
20151126,9950,9930,9875,10325,9840,10300,10190,370,260,26030,54634
20151127,10300,10190,10315,10530,10270,10440,10430,250,240,18698,51692
20151130,10440,10430,10420,10520,10165,10250,10300,-180,-130,12264,49308
al1601,20150116,13280,13280,,,,13340,13340,60,60,0,0
20150119,13340,13340,,,,13340,13340,0,0,0,0
20150120,13340,13340,,,,13340,13340,0,0,0,0
20150121,13340,13340,13325,13325,13315,13315,13315,-25,-25,8,8
20150122,13315,13315,,,,13355,13355,40,40,0,8
20150123,13355,13355,,,,13355,13355,0,0,0,8
20150126,13355,13355,13300,13300,13300,13300,13300,-55,-55,2,8
20150127,13300,13300,,,,13300,13300,0,0,0,8
20150128,13300,13300,,,,13300,13300,0,0,0,8
20150129,13300,13300,,,,13290,13290,-10,-10,0,8
20150130,13290,13290,,,,13290,13290,0,0,0,8
20150202,13290,13290,,,,13290,13290,0,0,0,8
20150203,13290,13290,13530,13530,13530,13530,13530,240,240,4,12
20150204,13530,13530,13615,13645,13360,13635,13595,105,65,42,22
20150205,13635,13595,13635,13710,13635,13660,13680,65,85,98,78
20150206,13660,13680,13715,13795,13705,13720,13730,40,50,106,164
20150209,13720,13730,13665,13665,13605,13610,13625,-120,-105,148,248
20150210,13610,13625,13580,13580,13550,13555,13550,-70,-75,36,248
20150211,13555,13550,13505,13510,13450,13450,13485,-100,-65,28,238
20150212,13450,13485,13385,13385,13355,13355,13365,-130,-120,12,250
20150213,13355,13365,13400,13475,13400,13460,13455,95,90,90,256
20150216,13460,13455,13455,13475,13450,13475,13455,20,0,30,264
20150217,13475,13455,13465,13510,13455,13510,13485,55,30,22,268
20150225,13510,13485,,,,13485,13485,0,0,0,268
20150226,13485,13485,13360,13360,13360,13360,13360,-125,-125,6,264
20150227,13360,13360,13370,13370,13370,13370,13370,10,10,2,262
20150302,13370,13370,13410,13440,13410,13440,13425,70,55,4,262
20150303,13440,13425,,,,13425,13425,0,0,0,262
20150304,13425,13425,,,,13375,13375,-50,-50,0,262
20150305,13375,13375,13355,13355,13355,13355,13355,-20,-20,4,264
20150306,13355,13355,,,,13400,13400,45,45,0,264
20150309,13400,13400,13330,13335,13330,13335,13330,-65,-70,28,242
20150310,13335,13330,,,,13330,13330,0,0,0,242
20150311,13330,13330,13300,13300,13300,13300,13300,-30,-30,2,242
20150312,13300,13300,13300,13565,13300,13465,13515,165,215,24,248
20150313,13465,13515,13455,13500,13430,13430,13465,-85,-50,58,250
20150316,13430,13465,13425,13425,13420,13420,13420,-45,-45,6,256
20150317,13420,13420,13400,13400,13380,13390,13390,-30,-30,12,258
20150318,13390,13390,13420,13420,13420,13420,13420,30,30,8,258
20150319,13420,13420,13505,13560,13465,13560,13485,140,65,16,258
20150320,13560,13485,13580,13580,13525,13525,13555,40,70,10,260
20150323,13525,13555,13530,13530,13500,13500,13500,-55,-55,82,262
20150324,13500,13500,13545,13550,13530,13530,13535,30,35,38,254
20150325,13530,13535,13530,13530,13480,13480,13505,-55,-30,4,254
20150326,13480,13505,,,,13505,13505,0,0,0,254
20150327,13505,13505,13485,13485,13485,13485,13485,-20,-20,30,280
20150330,13485,13485,13430,13430,13430,13430,13430,-55,-55,2,280
20150331,13430,13430,13510,13510,13510,13510,13510,80,80,8,288
20150401,13510,13510,13500,13505,13450,13505,13495,-5,-15,18,288
20150402,13505,13495,,,,13495,13495,0,0,0,288
20150403,13495,13495,13530,13530,13530,13530,13530,35,35,2,288
20150407,13530,13530,,,,13530,13530,0,0,0,288
20150408,13530,13530,,,,13530,13530,0,0,0,288
20150409,13530,13530,13390,13485,13320,13445,13405,-85,-125,38,272
20150410,13445,13405,,,,13405,13405,0,0,0,272
20150413,13405,13405,13370,13415,13305,13305,13355,-100,-50,12,262
20150414,13305,13355,13300,13300,13230,13230,13245,-125,-110,8,264
20150415,13230,13245,,,,13245,13245,0,0,0,264
20150416,13245,13245,13335,13340,13335,13340,13335,95,90,18,278
20150417,13340,13335,13420,13420,13420,13420,13420,85,85,2,278
20150420,13420,13420,13355,13355,13305,13305,13330,-115,-90,6,278
20150421,13305,13330,13330,13345,13255,13315,13320,-15,-10,24,290
20150422,13315,13320,13350,13350,13305,13305,13325,-15,5,40,304
20150423,13305,13325,13320,13320,13320,13320,13320,-5,-5,2,302
20150424,13320,13320,13465,13465,13465,13465,13465,145,145,2,304
20150427,13465,13465,13595,13595,13470,13545,13510,80,45,18,310
20150428,13545,13510,13570,13570,13385,13490,13480,-20,-30,6,308
20150429,13490,13480,13490,13550,13490,13500,13520,20,40,14,312
20150430,13500,13520,13425,13425,13425,13425,13425,-95,-95,2,312
20150504,13425,13425,13535,13535,13535,13535,13535,110,110,2,312
20150505,13535,13535,13580,13580,13550,13550,13550,15,15,26,312
20150506,13550,13550,13620,13835,13620,13775,13750,225,200,74,318
20150507,13775,13750,13700,13730,13685,13730,13705,-20,-45,20,320
20150508,13730,13705,13700,13720,13700,13720,13710,15,5,4,322
20150511,13720,13710,13730,13735,13655,13690,13695,-20,-15,38,324
20150512,13690,13695,13660,13660,13625,13625,13645,-70,-50,16,330
20150513,13625,13645,13630,13675,13615,13615,13655,-30,10,18,344
20150514,13615,13655,13610,13620,13530,13595,13590,-60,-65,108,328
20150515,13595,13590,13610,13610,13605,13605,13605,15,15,4,330
20150518,13605,13605,13625,13625,13625,13625,13625,20,20,22,352
20150519,13625,13625,13565,13565,13520,13525,13525,-100,-100,54,360
20150520,13525,13525,13515,13515,13445,13445,13465,-80,-60,146,432
20150521,13445,13465,13480,13575,13460,13510,13505,45,40,30,434
20150522,13510,13505,,,,13505,13505,0,0,0,434
20150525,13505,13505,,,,13505,13505,0,0,0,434
20150526,13505,13505,13490,13520,13490,13510,13495,5,-10,40,450
20150527,13510,13495,13475,13475,13430,13430,13450,-65,-45,8,448
20150528,13430,13450,13415,13435,13290,13430,13390,-20,-60,60,484
20150529,13430,13390,13440,13540,13415,13445,13445,55,55,12,484
20150601,13445,13445,13430,13455,13385,13455,13445,10,0,66,470
20150602,13455,13445,13425,13455,13425,13450,13435,5,-10,16,480
20150603,13450,13435,13440,13440,13400,13400,13415,-35,-20,46,488
20150604,13400,13415,13360,13370,13350,13370,13360,-45,-55,6,490
20150605,13370,13360,13370,13380,13295,13310,13365,-50,5,94,492
20150608,13310,13365,13230,13265,13225,13240,13240,-125,-125,30,486
20150609,13240,13240,13220,13230,13200,13215,13215,-25,-25,24,488
20150610,13215,13215,13250,13250,13215,13215,13235,0,20,20,492
20150611,13215,13235,13215,13220,13140,13140,13190,-95,-45,48,502
20150612,13140,13190,13120,13120,13035,13060,13065,-130,-125,138,588
20150615,13060,13065,13020,13045,12980,12990,12995,-75,-70,112,662
20150616,12990,12995,12945,13000,12935,12995,12970,0,-25,22,662
20150617,12995,12970,12910,12975,12895,12950,12945,-20,-25,102,640
20150618,12950,12945,12845,12925,12845,12900,12900,-45,-45,28,652
20150619,12900,12900,12915,12915,12885,12885,12890,-15,-10,64,702
20150623,12885,12890,12920,12930,12900,12930,12910,40,20,364,1066
20150624,12930,12910,12925,12940,12910,12920,12915,10,5,318,1242
20150625,12920,12915,12880,12880,12835,12870,12860,-45,-55,32,1256
20150626,12870,12860,12840,12845,12820,12820,12830,-40,-30,68,1288
20150629,12820,12830,12815,12820,12780,12800,12785,-30,-45,128,1302
20150630,12800,12785,12765,12770,12660,12685,12705,-100,-80,156,1388
20150701,12685,12705,12680,12715,12660,12660,12675,-45,-30,778,1640
20150702,12660,12675,12615,12885,12615,12750,12780,75,105,384,1828
20150703,12750,12780,12765,12795,12735,12770,12775,-10,-5,406,1840
20150706,12770,12775,12700,12730,12585,12610,12660,-165,-115,336,1770
20150707,12610,12660,12605,12660,12585,12585,12630,-75,-30,760,1790
20150708,12585,12630,12530,12585,12125,12245,12345,-385,-285,1666,2066
20150709,12245,12345,12400,12625,12375,12565,12475,220,130,942,2058
20150710,12565,12475,12695,12715,12550,12550,12625,75,150,780,2502
20150713,12550,12625,12530,12575,12525,12530,12550,-95,-75,102,2470
20150714,12530,12550,12620,12645,12600,12600,12630,50,80,134,2468
20150715,12600,12630,12600,12600,12560,12560,12580,-70,-50,28,2486
20150716,12560,12580,12565,12795,12520,12605,12665,25,85,1460,3150
20150717,12605,12665,12635,12635,12570,12590,12595,-75,-70,186,3140
20150720,12590,12595,12555,12575,12545,12560,12550,-35,-45,74,3096
20150721,12560,12550,12520,12550,12520,12545,12545,-5,-5,88,3088
20150722,12545,12545,12500,12520,12435,12435,12480,-110,-65,104,3078
20150723,12435,12480,12435,12435,12355,12430,12385,-50,-95,162,3080
20150724,12430,12385,12340,12360,12305,12305,12340,-80,-45,352,3224
20150727,12305,12340,12330,12370,12295,12295,12340,-45,0,254,3404
20150728,12295,12340,12280,12355,12215,12315,12300,-25,-40,246,3452
20150729,12315,12300,12380,12450,12370,12370,12395,70,95,522,3816
20150730,12370,12395,12345,12360,12285,12285,12320,-110,-75,508,4058
20150731,12285,12320,12255,12400,12255,12290,12300,-30,-20,594,4048
20150803,12290,12300,12320,12345,12150,12155,12245,-145,-55,954,4310
20150804,12155,12245,12200,12235,12190,12235,12210,-10,-35,766,4480
20150805,12235,12210,12245,12280,12195,12225,12220,15,10,1634,4582
20150806,12225,12220,12220,12220,12145,12145,12175,-75,-45,956,5264
20150807,12145,12175,12070,12105,12040,12065,12065,-110,-110,2018,6186
20150810,12065,12065,11980,12130,11960,12090,12055,25,-10,352,6254
20150811,12090,12055,12075,12195,12075,12140,12150,85,95,1018,6348
20150812,12140,12150,12115,12270,12115,12270,12220,120,70,320,6302
20150813,12270,12220,12285,12360,12220,12250,12305,30,85,2272,7232
20150814,12250,12305,12220,12255,12190,12200,12210,-105,-95,1042,7926
20150817,12200,12210,12215,12250,12130,12165,12190,-45,-20,1466,8282
20150818,12165,12190,12160,12170,12075,12080,12125,-110,-65,1588,8994
20150819,12080,12125,12095,12095,11995,12045,12020,-80,-105,2964,9796
20150820,12045,12020,12045,12125,12025,12115,12065,95,45,3238,10430
20150821,12115,12065,12120,12205,12055,12060,12110,-5,45,2034,11278
20150824,12060,12110,12045,12070,11845,11845,11950,-265,-160,3190,12476
20150825,11845,11950,11860,11925,11850,11895,11895,-55,-55,2550,13690
20150826,11895,11895,11975,11995,11875,11895,11905,0,10,4936,16930
20150827,11895,11905,11870,11915,11840,11910,11890,5,-15,2106,17524
20150828,11910,11890,11900,12005,11895,11965,11950,75,60,3412,18294
20150831,11965,11950,11980,12050,11915,11945,11970,-5,20,3158,19260
20150901,11945,11970,11915,11950,11840,11870,11890,-100,-80,3718,20690
20150902,11870,11890,11845,11915,11845,11915,11880,25,-10,1260,20920
20150907,11915,11880,11910,11970,11895,11965,11930,85,50,716,21042
20150908,11965,11930,11960,11970,11925,11965,11945,35,15,3002,22112
20150909,11965,11945,12020,12145,12015,12135,12095,190,150,5466,24110
20150910,12135,12095,12100,12250,12030,12080,12080,-15,-15,7530,27786
20150911,12080,12080,12040,12140,12040,12110,12115,30,35,3794,29354
20150914,12110,12115,12065,12130,12060,12090,12090,-25,-25,2466,29800
20150915,12090,12090,12060,12060,11935,11940,11980,-150,-110,5116,32640
20150916,11940,11980,11955,12005,11940,12000,11970,20,-10,930,32746
20150917,12000,11970,11995,12035,11970,12025,12005,55,35,3052,34484
20150918,12025,12005,12000,12100,11995,12080,12055,75,50,3146,34928
20150921,12080,12055,12075,12110,11930,11955,12025,-100,-30,6580,34366
20150922,11955,12025,11965,11980,11870,11930,11920,-95,-105,8260,39012
20150923,11930,11920,11840,11885,11795,11835,11845,-85,-75,11392,44330
20150924,11835,11845,11845,11860,11770,11830,11820,-15,-25,15516,51448
20150925,11830,11820,11805,11925,11805,11855,11845,35,25,11302,53354
20150928,11855,11845,11835,11850,11775,11780,11800,-65,-45,8278,58032
20150929,11780,11800,11750,11775,11645,11675,11685,-125,-115,22092,64566
20150930,11675,11685,11720,11750,11620,11715,11670,30,-15,12502,67618
20151008,11715,11670,11705,11705,11505,11510,11590,-160,-80,14296,73472
20151009,11510,11590,11500,11660,11390,11625,11525,35,-65,44708,79900
20151012,11625,11525,11715,11760,11575,11650,11635,125,110,34614,88940
20151013,11650,11635,11615,11640,11485,11520,11540,-115,-95,24476,93600
20151014,11520,11540,11480,11640,11350,11385,11450,-155,-90,33754,104810
20151015,11385,11450,11390,11440,11290,11340,11375,-110,-75,32108,111350
20151016,11340,11375,11300,11340,11205,11210,11270,-165,-105,37042,119178
20151019,11210,11270,11175,11295,11095,11105,11195,-165,-75,70074,133928
20151020,11105,11195,11060,11145,10990,11015,11055,-180,-140,68166,137410
20151021,11015,11055,10980,11040,10765,10825,10875,-230,-180,108672,148248
20151022,10825,10875,10790,10860,10700,10720,10780,-155,-95,114886,162658
20151023,10720,10780,10760,10830,10345,10620,10550,-160,-230,360684,189574
20151026,10620,10550,10600,10660,10380,10465,10465,-85,-85,357282,210262
20151027,10465,10465,10480,10580,10410,10525,10505,60,40,294012,215270
20151028,10525,10505,10530,10645,10275,10290,10430,-215,-75,333248,270278
20151029,10290,10430,10260,10425,10250,10345,10340,-85,-90,343486,260258
20151030,10345,10340,10310,10395,10295,10350,10340,10,0,190944,264788
20151102,10350,10340,10340,10390,10280,10315,10330,-25,-10,155648,272842
20151103,10315,10330,10340,10440,10315,10375,10370,45,40,171460,281060
20151104,10375,10370,10360,10520,10335,10510,10410,140,40,188926,262388
20151105,10510,10410,10485,10650,10460,10560,10560,150,150,307456,240998
20151106,10560,10560,10560,10625,10490,10545,10550,-15,-10,204850,237162
20151109,10545,10550,10550,10635,10475,10550,10565,0,15,227252,253638
20151110,10550,10565,10540,10575,10215,10270,10360,-295,-205,367240,294214
20151111,10270,10360,10245,10280,10010,10035,10100,-325,-260,449120,289988
20151112,10035,10100,10070,10180,10040,10130,10100,30,0,207274,273732
20151113,10130,10100,10020,10195,9910,10150,10100,50,0,266094,260302
20151116,10150,10100,10130,10245,10070,10105,10170,5,70,197318,249748
20151117,10105,10170,10085,10145,9985,10070,10045,-100,-125,288058,236438
20151118,10070,10045,10095,10155,9930,10025,10030,-20,-15,246388,237860
20151119,10025,10030,10020,10020,9780,9820,9895,-210,-135,300096,245892
20151120,9820,9895,9820,10090,9640,9935,9820,40,-75,486316,221828
20151123,9935,9820,9970,10065,9750,9870,9875,50,55,398088,208330
20151124,9870,9875,9845,9875,9620,9770,9735,-105,-140,397298,199496
20151125,9770,9735,9720,9955,9665,9865,9825,130,90,418088,195096
20151126,9865,9825,9800,10215,9735,10215,10060,390,235,478748,169674
20151127,10215,10060,10215,10460,10195,10425,10365,365,305,574658,151540
20151130,10425,10365,10400,10470,10080,10145,10275,-220,-90,531086,142358
al1602,20150216,13455,13455,,,,13455,13455,0,0,0,0
20150217,13455,13455,13560,13560,13560,13560,13560,105,105,6,6
20150225,13560,13560,,,,13560,13560,0,0,0,6
20150226,13560,13560,13375,13380,13375,13380,13375,-180,-185,10,10
20150227,13380,13375,13510,13510,13390,13390,13410,15,35,12,20
20150302,13390,13410,,,,13410,13410,0,0,0,20
20150303,13410,13410,13425,13475,13425,13460,13465,50,55,30,46
20150304,13460,13465,13395,13395,13395,13395,13395,-70,-70,4,46
20150305,13395,13395,,,,13370,13370,-25,-25,0,46
20150306,13370,13370,13380,13410,13380,13410,13395,40,25,4,46
20150309,13410,13395,,,,13395,13395,0,0,0,46
20150310,13395,13395,,,,13395,13395,0,0,0,46
20150311,13395,13395,13365,13380,13365,13380,13370,-15,-25,8,46
20150312,13380,13370,13375,13510,13330,13510,13380,140,10,40,74
20150313,13510,13380,13500,13535,13495,13495,13510,115,130,72,102
20150316,13495,13510,13415,13415,13410,13410,13410,-100,-100,10,112
20150317,13410,13410,13415,13415,13340,13370,13380,-40,-30,14,118
20150318,13370,13380,13360,13440,13360,13440,13430,60,50,84,150
20150319,13440,13430,13395,13550,13395,13545,13455,115,25,34,178
20150320,13545,13455,13780,13780,13605,13605,13710,150,255,10,176
20150323,13605,13710,,,,13690,13690,-20,-20,0,176
20150324,13690,13690,,,,13675,13675,-15,-15,0,176
20150325,13675,13675,13535,13535,13535,13535,13535,-140,-140,8,170
20150326,13535,13535,13500,13500,13500,13500,13500,-35,-35,80,242
20150327,13500,13500,13550,13550,13525,13525,13530,25,30,6,246
20150330,13525,13530,13510,13520,13510,13515,13515,-15,-15,10,250
20150331,13515,13515,13565,13585,13565,13585,13575,70,60,4,246
20150401,13585,13575,13545,13545,13545,13545,13545,-30,-30,2,246
20150402,13545,13545,,,,13545,13545,0,0,0,246
20150403,13545,13545,13560,13560,13375,13530,13500,-15,-45,12,248
20150407,13530,13500,,,,13500,13500,0,0,0,248
20150408,13500,13500,,,,13500,13500,0,0,0,248
20150409,13500,13500,13390,13405,13305,13305,13360,-195,-140,16,244
20150410,13305,13360,,,,13360,13360,0,0,0,244
20150413,13360,13360,13430,13455,13430,13435,13440,75,80,22,244
20150414,13435,13440,,,,13290,13290,-150,-150,0,244
20150415,13290,13290,,,,13290,13290,0,0,0,244
20150416,13290,13290,13375,13375,13375,13375,13375,85,85,2,244
20150417,13375,13375,,,,13375,13375,0,0,0,244
20150420,13375,13375,,,,13375,13375,0,0,0,244
20150421,13375,13375,13340,13340,13340,13340,13340,-35,-35,6,250
20150422,13340,13340,,,,13340,13340,0,0,0,250
20150423,13340,13340,,,,13340,13340,0,0,0,250
20150424,13340,13340,13445,13445,13445,13445,13445,105,105,2,252
20150427,13445,13445,13530,13565,13530,13565,13545,120,100,4,252
20150428,13565,13545,13505,13505,13505,13505,13505,-40,-40,2,252
20150429,13505,13505,13535,13535,13535,13535,13535,30,30,2,252
20150430,13535,13535,13540,13565,13540,13565,13555,30,20,8,250
20150504,13565,13555,,,,13555,13555,0,0,0,250
20150505,13555,13555,13590,13590,13590,13590,13590,35,35,2,250
20150506,13590,13590,13705,13795,13705,13785,13780,195,190,62,298
20150507,13785,13780,,,,13780,13780,0,0,0,298
20150508,13780,13780,13725,13725,13725,13725,13725,-55,-55,4,294
20150511,13725,13725,13720,13720,13720,13720,13720,-5,-5,2,296
20150512,13720,13720,13660,13660,13660,13660,13660,-60,-60,4,296
20150513,13660,13660,13655,13685,13650,13685,13660,25,0,6,302
20150514,13685,13660,,,,13660,13660,0,0,0,302
20150515,13660,13660,,,,13660,13660,0,0,0,302
20150518,13660,13660,13645,13645,13645,13645,13645,-15,-15,4,306
20150519,13645,13645,13605,13605,13605,13605,13605,-40,-40,2,306
20150520,13605,13605,13495,13495,13495,13495,13495,-110,-110,4,302
20150521,13495,13495,13460,13595,13460,13595,13505,100,10,6,302
20150522,13595,13505,,,,13505,13505,0,0,0,302
20150525,13505,13505,13510,13510,13510,13510,13510,5,5,2,302
20150526,13510,13510,,,,13510,13510,0,0,0,302
20150527,13510,13510,,,,13510,13510,0,0,0,302
20150528,13510,13510,,,,13510,13510,0,0,0,302
20150529,13510,13510,13515,13515,13515,13515,13515,5,5,2,302
20150601,13515,13515,13500,13500,13500,13500,13500,-15,-15,4,302
20150602,13500,13500,13490,13495,13490,13495,13490,-5,-10,66,282
20150603,13495,13490,13475,13475,13465,13465,13470,-25,-20,6,280
20150604,13465,13470,13405,13405,13405,13405,13405,-65,-65,4,280
20150605,13405,13405,13385,13385,13350,13350,13365,-55,-40,4,282
20150608,13350,13365,,,,13365,13365,0,0,0,282
20150609,13365,13365,13290,13290,13290,13290,13290,-75,-75,2,280
20150610,13290,13290,13420,13420,13335,13335,13385,45,95,10,286
20150611,13335,13385,13285,13290,13285,13290,13285,-95,-100,4,286
20150612,13290,13285,13115,13115,13115,13115,13115,-170,-170,4,282
20150615,13115,13115,13100,13100,13035,13035,13055,-80,-60,104,318
20150616,13035,13055,12980,13035,12980,13030,13015,-25,-40,98,310
20150617,13030,13015,12985,12985,12980,12980,12980,-35,-35,4,312
20150618,12980,12980,12980,12980,12980,12980,12980,0,0,8,314
20150619,12980,12980,12945,12945,12945,12945,12945,-35,-35,2,312
20150623,12945,12945,12960,12985,12960,12985,12965,40,20,16,320
20150624,12985,12965,12970,12970,12960,12970,12960,5,-5,106,408
20150625,12970,12960,12920,12920,12890,12905,12910,-55,-50,42,440
20150626,12905,12910,12885,12895,12885,12895,12885,-15,-25,6,444
20150629,12895,12885,12845,12845,12825,12835,12835,-50,-50,58,454
20150630,12835,12835,12745,12745,12720,12720,12720,-115,-115,26,470
20150701,12720,12720,12705,12705,12700,12705,12700,-15,-20,18,452
20150702,12705,12700,12960,12960,12800,12800,12845,100,145,94,506
20150703,12800,12845,12820,12820,12775,12775,12805,-70,-40,8,502
20150706,12775,12805,12785,12785,12645,12645,12735,-160,-70,36,518
20150707,12645,12735,12675,12675,12675,12675,12675,-60,-60,6,512
20150708,12675,12675,12405,12460,12210,12215,12370,-460,-305,108,560
20150709,12215,12370,12405,12650,12405,12555,12465,185,95,126,542
20150710,12555,12465,12560,12695,12560,12655,12610,190,145,128,594
20150713,12655,12610,12580,12580,12580,12580,12580,-30,-30,4,590
20150714,12580,12580,12670,12670,12670,12670,12670,90,90,6,584
20150715,12670,12670,,,,12620,12620,-50,-50,0,584
20150716,12620,12620,12610,12745,12570,12740,12680,120,60,20,576
20150717,12740,12680,12635,12635,12635,12635,12635,-45,-45,2,576
20150720,12635,12635,12590,12590,12585,12585,12585,-50,-50,4,572
20150721,12585,12585,12585,12585,12545,12585,12565,0,-20,10,562
20150722,12585,12565,12495,12500,12440,12440,12475,-125,-90,8,558
20150723,12440,12475,12415,12415,12415,12415,12415,-60,-60,2,556
20150724,12415,12415,12335,12370,12335,12370,12355,-45,-60,6,550
20150727,12370,12355,12380,12380,12380,12380,12380,25,25,2,550
20150728,12380,12380,12280,12380,12280,12380,12365,0,-15,18,558
20150729,12380,12365,12415,12525,12410,12410,12435,45,70,14,562
20150730,12410,12435,12370,12370,12335,12335,12350,-100,-85,4,558
20150731,12335,12350,12305,12355,12305,12305,12335,-45,-15,18,554
20150803,12305,12335,12290,12340,12190,12190,12275,-145,-60,36,532
20150804,12190,12275,12245,12285,12215,12240,12245,-35,-30,34,516
20150805,12240,12245,,,,12245,12245,0,0,0,516
20150806,12245,12245,12235,12310,12190,12215,12225,-30,-20,20,510
20150807,12215,12225,12130,12130,12095,12100,12100,-125,-125,70,498
20150810,12100,12100,12155,12155,12120,12120,12130,20,30,18,500
20150811,12120,12130,12140,12240,12140,12185,12185,55,55,18,506
20150812,12185,12185,,,,12185,12185,0,0,0,506
20150813,12185,12185,12370,12375,12255,12255,12330,70,145,98,518
20150814,12255,12330,12310,12310,12175,12240,12250,-90,-80,12,518
20150817,12240,12250,12240,12240,12120,12205,12185,-45,-65,6,520
20150818,12205,12185,12155,12180,12135,12165,12155,-20,-30,22,522
20150819,12165,12155,12065,12065,12050,12050,12055,-105,-100,100,518
20150820,12050,12055,12075,12150,12075,12150,12085,95,30,54,562
20150821,12150,12085,12165,12165,12105,12105,12150,20,65,10,558
20150824,12105,12150,11990,12005,11910,11910,11950,-240,-200,146,624
20150825,11910,11950,11905,11905,11900,11900,11900,-50,-50,62,686
20150826,11900,11900,11955,11965,11910,11925,11940,25,40,90,728
20150827,11925,11940,11910,11935,11910,11935,11930,-5,-10,26,748
20150828,11935,11930,12005,12005,11995,11995,11995,65,65,12,748
20150831,11995,11995,12010,12010,11970,11990,11985,-5,-10,158,820
20150901,11990,11985,11900,11900,11900,11900,11900,-85,-85,4,820
20150902,11900,11900,11930,11930,11920,11920,11925,20,25,24,820
20150907,11920,11925,11980,11980,11960,11960,11965,35,40,6,818
20150908,11960,11965,12010,12010,11960,11960,11980,-5,15,262,906
20150909,11960,11980,12130,12165,12100,12165,12150,185,170,374,988
20150910,12165,12150,12390,12390,12090,12110,12100,-40,-50,380,1254
20150911,12110,12100,12125,12190,12120,12185,12170,85,70,456,1652
20150914,12185,12170,12140,12170,12105,12115,12120,-55,-50,574,2086
20150915,12115,12120,12070,12070,11985,11990,12010,-130,-110,434,2410
20150916,11990,12010,11995,12010,11975,12010,11990,0,-20,62,2442
20150917,12010,11990,12030,12050,12025,12050,12040,60,50,338,2592
20150918,12050,12040,12060,12120,12060,12110,12115,70,75,86,2614
20150921,12110,12115,12090,12125,11980,11980,12050,-135,-65,322,2694
20150922,11980,12050,12000,12010,11910,11980,11945,-70,-105,1600,3610
20150923,11980,11945,11910,11910,11840,11880,11885,-65,-60,956,3988
20150924,11880,11885,11870,11880,11800,11860,11835,-25,-50,5396,6822
20150925,11860,11835,11845,11935,11825,11875,11870,40,35,806,6786
20150928,11875,11870,11855,11860,11805,11805,11825,-65,-45,886,6988
20150929,11805,11825,11790,11790,11680,11695,11710,-130,-115,1258,7376
20150930,11695,11710,11710,11750,11655,11740,11700,30,-10,808,7570
20151008,11740,11700,11715,11735,11535,11545,11630,-155,-70,4380,9766
20151009,11545,11630,11535,11670,11395,11640,11520,10,-110,16398,15960
20151012,11640,11520,11745,11815,11595,11675,11655,155,135,9002,15994
20151013,11675,11655,11655,11660,11515,11550,11555,-105,-100,5622,18406
20151014,11550,11555,11525,11645,11380,11410,11480,-145,-75,7112,20542
20151015,11410,11480,11415,11465,11325,11365,11410,-115,-70,5974,22776
20151016,11365,11410,11330,11375,11230,11245,11305,-165,-105,8680,27408
20151019,11245,11305,11230,11325,11115,11125,11215,-180,-90,16912,33464
20151020,11125,11215,11105,11160,11010,11030,11065,-185,-150,19190,41182
20151021,11030,11065,11025,11040,10775,10835,10885,-230,-180,29014,53846
20151022,10835,10885,10810,10865,10715,10725,10795,-160,-90,24624,58400
20151023,10725,10795,10775,10840,10360,10640,10560,-155,-235,49770,71686
20151026,10640,10560,10640,10665,10395,10480,10475,-80,-85,38442,78256
20151027,10480,10475,10475,10585,10420,10535,10510,60,35,54486,98712
20151028,10535,10510,10515,10645,10295,10305,10435,-205,-75,32504,102012
20151029,10305,10435,10270,10435,10255,10360,10340,-75,-95,41516,104472
20151030,10360,10340,10320,10400,10305,10365,10350,25,10,25454,107024
20151102,10365,10350,10370,10400,10295,10320,10340,-30,-10,24640,108880
20151103,10320,10340,10350,10450,10325,10380,10385,40,45,34342,115702
20151104,10380,10385,10380,10525,10350,10520,10420,135,35,55760,117890
20151105,10520,10420,10480,10650,10470,10575,10570,155,150,91724,119066
20151106,10575,10570,10530,10635,10505,10560,10565,-10,-5,66064,123278
20151109,10560,10565,10560,10650,10485,10580,10585,15,20,67450,117960
20151110,10580,10585,10550,10590,10255,10295,10410,-290,-175,89890,131826
20151111,10295,10410,10260,10300,10020,10040,10115,-370,-295,152952,158744
20151112,10040,10115,10095,10185,10045,10125,10100,10,-15,85888,170886
20151113,10125,10100,10030,10190,9930,10130,10090,30,-10,113424,177166
20151116,10130,10090,10130,10225,10060,10085,10155,-5,65,83346,173568
20151117,10085,10155,10060,10120,9950,10035,10010,-120,-145,143012,192964
20151118,10035,10010,10070,10120,9900,10000,9995,-10,-15,97762,196246
20151119,10000,9995,9995,9995,9780,9815,9875,-180,-120,102386,204448
20151120,9815,9875,9810,10045,9605,9885,9785,10,-90,277288,233302
20151123,9885,9785,9920,10010,9700,9810,9825,25,40,190074,232360
20151124,9810,9825,9810,9815,9550,9710,9670,-115,-155,254224,280714
20151125,9710,9670,9670,9900,9590,9805,9750,135,80,237152,284940
20151126,9805,9750,9750,10140,9680,10140,10005,390,255,339974,263642
20151127,10140,10005,10150,10405,10105,10365,10305,360,300,413112,242260
20151130,10365,10305,10360,10400,9985,10050,10165,-255,-140,384728,246002
al1603,20150317,13410,13410,,,,13410,13410,0,0,0,0
20150318,13410,13410,,,,13410,13410,0,0,0,0
20150319,13410,13410,,,,13465,13465,55,55,0,0
20150320,13465,13465,13680,13680,13525,13525,13605,60,140,10,10
20150323,13525,13605,13535,13625,13535,13595,13570,-10,-35,8,12
20150324,13595,13570,,,,13570,13570,0,0,0,12
20150325,13570,13570,,,,13570,13570,0,0,0,12
20150326,13570,13570,,,,13570,13570,0,0,0,12
20150327,13570,13570,,,,13570,13570,0,0,0,12
20150330,13570,13570,,,,13570,13570,0,0,0,12
20150331,13570,13570,13595,13595,13595,13595,13595,25,25,4,10
20150401,13595,13595,13580,13580,13580,13580,13580,-15,-15,6,8
20150402,13580,13580,,,,13580,13580,0,0,0,8
20150403,13580,13580,,,,13580,13580,0,0,0,8
20150407,13580,13580,,,,13580,13580,0,0,0,8
20150408,13580,13580,,,,13580,13580,0,0,0,8
20150409,13580,13580,13525,13545,13410,13545,13490,-35,-90,14,10
20150410,13545,13490,13470,13470,13470,13470,13470,-20,-20,2,10
20150413,13470,13470,13490,13500,13490,13500,13495,30,25,80,90
20150414,13500,13495,13305,13305,13305,13305,13305,-190,-190,2,90
20150415,13305,13305,,,,13305,13305,0,0,0,90
20150416,13305,13305,,,,13305,13305,0,0,0,90
20150417,13305,13305,13450,13485,13315,13460,13425,155,120,20,90
20150420,13460,13425,13375,13375,13375,13375,13375,-50,-50,6,90
20150421,13375,13375,13360,13360,13360,13360,13360,-15,-15,4,94
20150422,13360,13360,,,,13360,13360,0,0,0,94
20150423,13360,13360,,,,13360,13360,0,0,0,94
20150424,13360,13360,13470,13470,13470,13470,13470,110,110,10,104
20150427,13470,13470,,,,13470,13470,0,0,0,104
20150428,13470,13470,,,,13470,13470,0,0,0,104
20150429,13470,13470,13580,13580,13580,13580,13580,110,110,2,106
20150430,13580,13580,,,,13600,13600,20,20,0,106
20150504,13600,13600,,,,13600,13600,0,0,0,106
20150505,13600,13600,,,,13600,13600,0,0,0,106
20150506,13600,13600,13740,13875,13740,13875,13800,275,200,16,114
20150507,13875,13800,,,,13800,13800,0,0,0,114
20150508,13800,13800,,,,13800,13800,0,0,0,114
20150511,13800,13800,13745,13745,13745,13745,13745,-55,-55,4,118
20150512,13745,13745,,,,13745,13745,0,0,0,118
20150513,13745,13745,13680,13680,13680,13680,13680,-65,-65,4,122
20150514,13680,13680,,,,13680,13680,0,0,0,122
20150515,13680,13680,13675,13675,13675,13675,13675,-5,-5,4,122
20150518,13675,13675,,,,13675,13675,0,0,0,122
20150519,13675,13675,,,,13675,13675,0,0,0,122
20150520,13675,13675,,,,13675,13675,0,0,0,122
20150521,13675,13675,13520,13765,13520,13765,13700,90,25,8,126
20150522,13765,13700,13610,13610,13590,13590,13600,-110,-100,12,126
20150525,13590,13600,13555,13555,13555,13555,13555,-45,-45,2,124
20150526,13555,13555,,,,13555,13555,0,0,0,124
20150527,13555,13555,13640,13640,13525,13525,13580,-30,25,4,124
20150528,13525,13580,,,,13580,13580,0,0,0,124
20150529,13580,13580,13510,13575,13510,13575,13540,-5,-40,4,122
20150601,13575,13540,13460,13600,13460,13555,13530,15,-10,16,120
20150602,13555,13530,,,,13530,13530,0,0,0,120
20150603,13530,13530,13485,13565,13485,13565,13525,35,-5,4,120
20150604,13565,13525,13535,13535,13470,13480,13495,-45,-30,6,120
20150605,13480,13495,13450,13450,13450,13450,13450,-45,-45,2,122
20150608,13450,13450,,,,13450,13450,0,0,0,122
20150609,13450,13450,,,,13450,13450,0,0,0,122
20150610,13450,13450,13500,13500,13355,13375,13415,-75,-35,18,132
20150611,13375,13415,13400,13400,13300,13300,13360,-115,-55,8,140
20150612,13300,13360,,,,13185,13185,-175,-175,0,140
20150615,13185,13185,,,,13130,13130,-55,-55,0,140
20150616,13130,13130,13100,13100,13055,13090,13090,-40,-40,26,142
20150617,13090,13090,13095,13095,13080,13095,13090,5,0,6,144
20150618,13095,13090,13000,13060,13000,13060,13035,-30,-55,16,148
20150619,13060,13035,13030,13030,13030,13030,13030,-5,-5,2,150
20150623,13030,13030,13065,13065,13015,13020,13035,-10,5,28,160
20150624,13020,13035,13025,13035,13025,13025,13025,-10,-10,28,184
20150625,13025,13025,12960,12960,12955,12955,12955,-70,-70,52,192
20150626,12955,12955,12970,12970,12970,12970,12970,15,15,2,194
20150629,12970,12970,12915,12915,12870,12870,12890,-100,-80,4,196
20150630,12870,12890,12775,12775,12750,12750,12755,-140,-135,6,192
20150701,12750,12755,12745,12745,12745,12745,12745,-10,-10,4,190
20150702,12745,12745,12850,12850,12850,12850,12850,105,105,10,200
20150703,12850,12850,,,,12850,12850,0,0,0,200
20150706,12850,12850,12700,12700,12700,12700,12700,-150,-150,2,200
20150707,12700,12700,12740,12740,12740,12740,12740,40,40,6,206
20150708,12740,12740,12740,12740,12400,12405,12450,-335,-290,60,238
20150709,12405,12450,12500,12700,12500,12700,12625,250,175,26,254
20150710,12700,12625,12795,12795,12710,12710,12710,85,85,64,272
20150713,12710,12710,12680,12680,12520,12520,12600,-190,-110,4,274
20150714,12520,12600,,,,12600,12600,0,0,0,274
20150715,12600,12600,12670,12670,12670,12670,12670,70,70,4,274
20150716,12670,12670,,,,12730,12730,60,60,0,274
20150717,12730,12730,12665,12665,12665,12665,12665,-65,-65,2,274
20150720,12665,12665,,,,12615,12615,-50,-50,0,274
20150721,12615,12615,,,,12595,12595,-20,-20,0,274
20150722,12595,12595,12505,12505,12505,12505,12505,-90,-90,2,276
20150723,12505,12505,,,,12440,12440,-65,-65,0,276
20150724,12440,12440,,,,12380,12380,-60,-60,0,276
20150727,12380,12380,12400,12410,12400,12410,12405,30,25,4,276
20150728,12410,12405,12345,12450,12345,12450,12430,45,25,12,282
20150729,12450,12430,12470,12505,12470,12505,12485,75,55,4,280
20150730,12505,12485,12420,12425,12405,12410,12410,-75,-75,10,280
20150731,12410,12410,12375,12375,12365,12370,12370,-40,-40,24,282
20150803,12370,12370,12335,12335,12335,12335,12335,-35,-35,2,280
20150804,12335,12335,12275,12300,12275,12300,12290,-35,-45,12,280
20150805,12300,12290,12340,12340,12270,12335,12310,45,20,44,298
20150806,12335,12310,12285,12285,12245,12265,12260,-45,-50,22,302
20150807,12265,12260,12115,12115,12115,12115,12115,-145,-145,4,302
20150810,12115,12115,12190,12190,12165,12165,12180,50,65,6,302
20150811,12165,12180,12330,12330,12225,12225,12275,45,95,40,322
20150812,12225,12275,12295,12395,12290,12395,12340,120,65,42,342
20150813,12395,12340,12390,12440,12340,12365,12375,25,35,50,356
20150814,12365,12375,12295,12295,12290,12290,12290,-85,-85,12,360
20150817,12290,12290,12400,12400,12400,12400,12400,110,110,2,360
20150818,12400,12400,12180,12205,12175,12175,12190,-225,-210,70,424
20150819,12175,12190,12160,12160,12100,12100,12100,-90,-90,184,524
20150820,12100,12100,12245,12245,12175,12175,12200,75,100,6,524
20150821,12175,12200,,,,12265,12265,65,65,0,524
20150824,12265,12265,12085,12085,11945,11945,12020,-320,-245,82,554
20150825,11945,12020,,,,12000,12000,-20,-20,0,554
20150826,12000,12000,11895,12025,11895,11925,11990,-75,-10,30,572
20150827,11925,11990,11925,11970,11925,11970,11930,-20,-60,24,568
20150828,11970,11930,11945,12065,11945,12065,11965,135,35,28,570
20150831,12065,11965,,,,11980,11980,15,15,0,570
20150901,11980,11980,11965,12030,11960,11960,11990,-20,10,10,572
20150902,11960,11990,11960,11965,11960,11960,11960,-30,-30,86,618
20150907,11960,11960,12040,12040,11955,11970,11985,10,25,6,620
20150908,11970,11985,12035,12045,12010,12035,12030,50,45,18,620
20150909,12035,12030,12105,12230,12105,12145,12210,115,180,58,640
20150910,12145,12210,12235,12235,12150,12150,12175,-60,-35,40,648
20150911,12150,12175,12170,12235,12155,12220,12195,45,20,70,670
20150914,12220,12195,,,,12145,12145,-50,-50,0,670
20150915,12145,12145,12105,12105,12000,12030,12050,-115,-95,44,664
20150916,12030,12050,12065,12080,12055,12080,12070,30,20,10,660
20150917,12080,12070,12035,12100,12035,12090,12090,20,20,146,780
20150918,12090,12090,12070,12130,12070,12130,12100,40,10,4,780
20150921,12130,12100,12100,12130,12085,12085,12100,-15,0,30,800
20150922,12085,12100,12045,12045,11960,11960,11995,-140,-105,28,810
20150923,11960,11995,11895,11950,11890,11915,11925,-80,-70,28,838
20150924,11915,11925,11945,11950,11865,11900,11890,-25,-35,342,986
20150925,11900,11890,11885,11960,11885,11900,11935,10,45,178,1034
20150928,11900,11935,11850,11870,11840,11840,11845,-95,-90,154,1134
20150929,11840,11845,11770,11815,11710,11730,11740,-115,-105,410,1322
20150930,11730,11740,11770,11770,11690,11740,11725,0,-15,556,1574
20151008,11740,11725,11635,11675,11555,11555,11615,-170,-110,696,1964
20151009,11555,11615,11490,11690,11435,11660,11560,45,-55,2562,2940
20151012,11660,11560,11700,11720,11610,11690,11690,130,130,1752,4144
20151013,11690,11690,11655,11655,11545,11570,11590,-120,-100,732,4396
20151014,11570,11590,11540,11640,11415,11425,11485,-165,-105,1698,5274
20151015,11425,11485,11440,11485,11355,11395,11440,-90,-45,2874,6948
20151016,11395,11440,11365,11415,11270,11270,11360,-170,-80,4064,8476
20151019,11270,11360,11250,11355,11140,11160,11250,-200,-110,9230,12860
20151020,11160,11250,11140,11170,11025,11040,11085,-210,-165,11232,18446
20151021,11040,11085,11020,11030,10790,10835,10895,-250,-190,17812,29140
20151022,10835,10895,10800,10870,10730,10750,10805,-145,-90,13546,35850
20151023,10750,10805,10780,10850,10380,10670,10615,-135,-190,22276,45576
20151026,10670,10615,10680,10695,10420,10485,10495,-130,-120,13906,49674
20151027,10485,10495,10500,10600,10445,10560,10530,65,35,14878,57106
20151028,10560,10530,10595,10665,10320,10335,10455,-195,-75,11780,61086
20151029,10335,10455,10290,10450,10290,10375,10350,-80,-105,11564,63508
20151030,10375,10350,10350,10420,10335,10390,10380,40,30,7426,64134
20151102,10390,10380,10405,10410,10320,10345,10360,-35,-20,7612,66224
20151103,10345,10360,10355,10470,10350,10400,10415,40,55,10956,70862
20151104,10400,10415,10375,10545,10370,10540,10450,125,35,12898,71912
20151105,10540,10450,10495,10670,10490,10595,10595,145,145,30122,70660
20151106,10595,10595,10620,10660,10535,10590,10595,-5,0,17198,70986
20151109,10590,10595,10600,10675,10520,10600,10610,5,15,21108,73422
20151110,10600,10610,10600,10620,10300,10335,10450,-275,-160,40548,81432
20151111,10335,10450,10250,10340,10055,10075,10145,-375,-305,32148,90254
20151112,10075,10145,10115,10205,10070,10150,10130,5,-15,23268,94528
20151113,10150,10130,10120,10200,9945,10145,10110,15,-20,34810,95612
20151116,10145,10110,10135,10230,10060,10095,10160,-15,50,43260,105994
20151117,10095,10160,10050,10110,9950,10035,10015,-125,-145,45906,114196
20151118,10035,10015,10095,10120,9920,10015,10010,0,-5,36578,118082
20151119,10015,10010,9985,10000,9800,9825,9900,-185,-110,34792,121100
20151120,9825,9900,9810,10050,9625,9875,9790,-25,-110,103838,124638
20151123,9875,9790,9910,9995,9700,9805,9820,15,30,64726,124548
20151124,9805,9820,9795,9800,9565,9700,9670,-120,-150,64200,133224
20151125,9700,9670,9685,9885,9585,9795,9750,125,80,82236,136262
20151126,9795,9750,9760,10140,9675,10125,10015,375,265,164942,145904
20151127,10125,10015,10110,10415,10070,10320,10300,305,285,187170,133144
20151130,10320,10300,10400,10400,9930,10000,10120,-300,-180,164280,151012
al1604,20150416,13305,13305,,,,13305,13305,0,0,0,0
20150417,13305,13305,12300,13450,12300,13440,13040,135,-265,32,12
20150420,13440,13040,13555,13555,13555,13555,13555,515,515,2,10
20150421,13555,13555,13375,13375,13375,13375,13375,-180,-180,2,12
20150422,13375,13375,13485,13485,13235,13375,13350,0,-25,8,12
20150423,13375,13350,13380,13380,13380,13380,13380,30,30,2,12
20150424,13380,13380,,,,13490,13490,110,110,0,12
20150427,13490,13490,13600,13600,13600,13600,13600,110,110,2,12
20150428,13600,13600,,,,13600,13600,0,0,0,12
20150429,13600,13600,13605,13605,13600,13600,13600,0,0,12,20
20150430,13600,13600,13620,13620,13620,13620,13620,20,20,10,20
20150504,13620,13620,13670,13695,13660,13660,13675,40,55,6,22
20150505,13660,13675,,,,13675,13675,0,0,0,22
20150506,13675,13675,13775,13830,13775,13830,13795,155,120,8,30
20150507,13830,13795,13925,13925,13925,13925,13925,130,130,2,30
20150508,13925,13925,13790,13790,13790,13790,13790,-135,-135,4,28
20150511,13790,13790,,,,13790,13790,0,0,0,28
20150512,13790,13790,,,,13790,13790,0,0,0,28
20150513,13790,13790,13760,13760,13755,13755,13755,-35,-35,4,26
20150514,13755,13755,,,,13755,13755,0,0,0,26
20150515,13755,13755,13725,13785,13725,13785,13735,30,-20,10,32
20150518,13785,13735,,,,13735,13735,0,0,0,32
20150519,13735,13735,,,,13735,13735,0,0,0,32
20150520,13735,13735,,,,13735,13735,0,0,0,32
20150521,13735,13735,13635,13635,13635,13635,13635,-100,-100,2,32
20150522,13635,13635,,,,13635,13635,0,0,0,32
20150525,13635,13635,,,,13635,13635,0,0,0,32
20150526,13635,13635,,,,13635,13635,0,0,0,32
20150527,13635,13635,13600,13600,13560,13560,13580,-75,-55,4,32
20150528,13560,13580,13515,13515,13515,13515,13515,-65,-65,2,34
20150529,13515,13515,13595,13600,13595,13600,13595,85,80,4,32
20150601,13600,13595,,,,13595,13595,0,0,0,32
20150602,13595,13595,13605,13620,13545,13545,13595,-50,0,10,32
20150603,13545,13595,,,,13595,13595,0,0,0,32
20150604,13595,13595,13515,13515,13500,13500,13500,-95,-95,22,54
20150605,13500,13500,13500,13500,13500,13500,13500,0,0,60,114
20150608,13500,13500,13340,13340,13340,13340,13340,-160,-160,2,112
20150609,13340,13340,,,,13340,13340,0,0,0,112
20150610,13340,13340,13515,13515,13515,13515,13515,175,175,6,118
20150611,13515,13515,13325,13325,13325,13325,13325,-190,-190,2,118
20150612,13325,13325,,,,13280,13280,-45,-45,0,118
20150615,13280,13280,,,,13200,13200,-80,-80,0,118
20150616,13200,13200,13145,13155,13145,13155,13150,-45,-50,6,118
20150617,13155,13150,13145,13145,13120,13120,13125,-30,-25,6,118
20150618,13120,13125,13090,13090,13080,13085,13085,-40,-40,18,124
20150619,13085,13085,13055,13055,13045,13045,13050,-40,-35,14,134
20150623,13045,13050,13095,13095,13050,13085,13075,35,25,10,140
20150624,13085,13075,13090,13115,13035,13035,13075,-40,0,22,146
20150625,13035,13075,13010,13010,13010,13010,13010,-65,-65,20,146
20150626,13010,13010,12915,12925,12915,12925,12920,-85,-90,4,144
20150629,12925,12920,12945,12945,12880,12880,12910,-40,-10,4,140
20150630,12880,12910,12760,12760,12760,12760,12760,-150,-150,2,138
20150701,12760,12760,,,,12745,12745,-15,-15,0,138
20150702,12745,12745,12870,12870,12870,12870,12870,125,125,2,136
20150703,12870,12870,,,,12870,12870,0,0,0,136
20150706,12870,12870,12680,12680,12680,12680,12680,-190,-190,10,126
20150707,12680,12680,12765,12765,12700,12710,12715,30,35,36,130
20150708,12710,12715,12495,12525,12325,12345,12440,-370,-275,50,138
20150709,12345,12440,12625,12750,12625,12750,12710,310,270,28,152
20150710,12750,12710,,,,12795,12795,85,85,0,152
20150713,12795,12795,12765,12765,12765,12765,12765,-30,-30,2,152
20150714,12765,12765,12700,12700,12700,12700,12700,-65,-65,2,152
20150715,12700,12700,,,,12770,12770,70,70,0,152
20150716,12770,12770,,,,12830,12830,60,60,0,152
20150717,12830,12830,12755,12755,12720,12720,12740,-110,-90,8,148
20150720,12720,12740,12665,12665,12665,12665,12665,-75,-75,2,148
20150721,12665,12665,,,,12645,12645,-20,-20,0,148
20150722,12645,12645,12615,12750,12615,12750,12680,105,35,4,152
20150723,12750,12680,12550,12550,12530,12530,12530,-150,-150,12,160
20150724,12530,12530,,,,12470,12470,-60,-60,0,160
20150727,12470,12470,12440,12460,12390,12460,12430,-10,-40,6,162
20150728,12460,12430,,,,12455,12455,25,25,0,162
20150729,12455,12455,12375,12575,12375,12500,12535,45,80,100,210
20150730,12500,12535,12360,12460,12360,12460,12435,-75,-100,44,222
20150731,12460,12435,12430,12435,12430,12435,12430,0,-5,4,220
20150803,12435,12430,12365,12385,12300,12300,12335,-130,-95,80,226
20150804,12300,12335,12325,12325,12310,12325,12320,-10,-15,20,220
20150805,12325,12320,12345,12345,12345,12345,12345,25,25,2,222
20150806,12345,12345,12290,12305,12290,12305,12295,-40,-50,6,222
20150807,12305,12295,,,,12145,12145,-150,-150,0,222
20150810,12145,12145,12175,12205,12175,12200,12195,55,50,10,222
20150811,12200,12195,12205,12310,12205,12255,12255,60,60,34,212
20150812,12255,12255,,,,12255,12255,0,0,0,212
20150813,12255,12255,12365,12390,12360,12360,12370,105,115,22,222
20150814,12360,12370,,,,12285,12285,-85,-85,0,222
20150817,12285,12285,12315,12315,12265,12265,12310,-20,25,20,216
20150818,12265,12310,12200,12200,12200,12200,12200,-110,-110,4,220
20150819,12200,12200,12145,12150,12145,12150,12145,-50,-55,20,222
20150820,12150,12145,12175,12175,12175,12175,12175,30,30,2,222
20150821,12175,12175,12185,12185,12180,12180,12180,5,5,8,226
20150824,12180,12180,12130,12165,12005,12005,12080,-175,-100,40,242
20150825,12005,12080,11865,11995,11865,11960,11965,-120,-115,52,276
20150826,11960,11965,11950,11950,11950,11950,11950,-15,-15,2,274
20150827,11950,11950,12000,12000,12000,12000,12000,50,50,2,274
20150828,12000,12000,,,,12000,12000,0,0,0,274
20150831,12000,12000,,,,12000,12000,0,0,0,274
20150901,12000,12000,,,,12000,12000,0,0,0,274
20150902,12000,12000,,,,12000,12000,0,0,0,274
20150907,12000,12000,,,,12000,12000,0,0,0,274
20150908,12000,12000,,,,12000,12000,0,0,0,274
20150909,12000,12000,,,,12000,12000,0,0,0,274
20150910,12000,12000,,,,12000,12000,0,0,0,274
20150911,12000,12000,12200,12200,12200,12200,12200,200,200,2,276
20150914,12200,12200,,,,12200,12200,0,0,0,276
20150915,12200,12200,12195,12200,12075,12075,12185,-125,-15,58,328
20150916,12075,12185,12065,12065,12065,12065,12065,-120,-120,4,328
20150917,12065,12065,,,,12065,12065,0,0,0,328
20150918,12065,12065,12200,12200,12200,12200,12200,135,135,2,330
20150921,12200,12200,12050,12085,12050,12085,12050,-115,-150,44,330
20150922,12085,12050,12080,12090,11980,12090,12065,40,15,64,326
20150923,12090,12065,11960,12000,11945,11965,11965,-100,-100,150,388
20150924,11965,11965,11730,11990,11730,11945,11935,-20,-30,136,504
20150925,11945,11935,11930,11995,11920,11965,11955,30,20,26,500
20150928,11965,11955,11865,11865,11865,11865,11865,-90,-90,2,498
20150929,11865,11865,11800,11800,11725,11755,11755,-110,-110,104,502
20150930,11755,11755,11720,11755,11665,11755,11730,0,-25,50,528
20151008,11755,11730,11670,11705,11600,11600,11660,-130,-70,82,522
20151009,11600,11660,11490,11725,11460,11725,11565,65,-95,506,716
20151012,11725,11565,11765,11765,11655,11680,11715,115,150,534,900
20151013,11680,11715,11660,11680,11585,11630,11645,-85,-70,1280,1960
20151014,11630,11645,11605,11660,11445,11465,11560,-180,-85,1954,2946
20151015,11465,11560,11480,11515,11380,11410,11480,-150,-80,1856,3622
20151016,11410,11480,11400,11435,11320,11330,11380,-150,-100,452,3888
20151019,11330,11380,11330,11395,11180,11185,11310,-195,-70,1718,4864
20151020,11185,11310,11180,11190,11040,11055,11085,-255,-225,2950,6882
20151021,11055,11085,11120,11120,10800,10860,10895,-225,-190,9082,13424
20151022,10860,10895,10820,10885,10760,10770,10820,-125,-75,4526,16126
20151023,10770,10820,10810,10865,10430,10695,10620,-125,-200,3074,17782
20151026,10695,10620,10690,10690,10465,10510,10525,-110,-95,2682,18842
20151027,10510,10525,10545,10620,10470,10585,10545,60,20,4552,21168
20151028,10585,10545,10625,10680,10350,10350,10470,-195,-75,2944,22366
20151029,10350,10470,10445,10465,10305,10395,10375,-75,-95,1980,22794
20151030,10395,10375,10385,10435,10370,10415,10400,40,25,2330,23422
20151102,10415,10400,10420,10425,10350,10360,10380,-40,-20,1044,23904
20151103,10360,10380,10390,10485,10380,10420,10430,40,50,1216,24548
20151104,10420,10430,10430,10535,10405,10535,10465,105,35,3140,24820
20151105,10535,10465,10530,10710,10520,10620,10640,155,175,4828,24586
20151106,10620,10640,10570,10680,10570,10620,10635,-20,-5,2852,25288
20151109,10620,10635,10620,10700,10550,10630,10635,-5,0,6220,27402
20151110,10630,10635,10630,10650,10345,10375,10465,-260,-170,15476,31768
20151111,10375,10465,10345,10350,10090,10115,10175,-350,-290,14130,35864
20151112,10115,10175,10150,10240,10100,10170,10155,-5,-20,6820,38318
20151113,10170,10155,10100,10225,10005,10165,10130,10,-25,6912,39810
20151116,10165,10130,10155,10255,10080,10105,10190,-25,60,5208,40304
20151117,10105,10190,10075,10130,9975,10060,10020,-130,-170,11814,44992
20151118,10060,10020,10070,10130,9950,10040,10020,20,0,8358,46682
20151119,10040,10020,10000,10015,9830,9855,9920,-165,-100,11350,49878
20151120,9855,9920,9850,10060,9650,9895,9795,-25,-125,30122,55372
20151123,9895,9795,9945,10005,9720,9810,9830,15,35,14476,57414
20151124,9810,9830,9795,9810,9585,9725,9690,-105,-140,15392,59216
20151125,9725,9690,9655,9890,9610,9795,9775,105,85,16652,61372
20151126,9795,9775,9780,10165,9635,10100,10020,325,245,57512,66434
20151127,10100,10020,10115,10420,10055,10290,10290,270,270,62550,66668
20151130,10290,10290,10270,10300,9910,9960,10080,-330,-210,64800,69020
al1605,20150518,13735,13735,,,,13735,13735,0,0,0,0
20150519,13735,13735,,,,13735,13735,0,0,0,0
20150520,13735,13735,,,,13735,13735,0,0,0,0
20150521,13735,13735,,,,13665,13665,-70,-70,0,0
20150522,13665,13665,13660,13660,13660,13660,13660,-5,-5,2,2
20150525,13660,13660,13615,13615,13615,13615,13615,-45,-45,2,4
20150526,13615,13615,,,,13615,13615,0,0,0,4
20150527,13615,13615,13550,13620,13550,13620,13585,5,-30,4,4
20150528,13620,13585,13565,13565,13545,13550,13550,-35,-35,8,12
20150529,13550,13550,13635,13635,13635,13635,13635,85,85,6,18
20150601,13635,13635,13605,13625,13605,13625,13615,-10,-20,12,26
20150602,13625,13615,,,,13615,13615,0,0,0,26
20150603,13615,13615,13625,13695,13625,13695,13670,80,55,6,24
20150604,13695,13670,13615,13615,13590,13590,13600,-80,-70,4,20
20150605,13590,13600,13505,13505,13500,13500,13500,-100,-100,58,78
20150608,13500,13500,13525,13525,13470,13495,13495,-5,-5,92,160
20150609,13495,13495,,,,13495,13495,0,0,0,160
20150610,13495,13495,13485,13565,13480,13480,13510,-15,15,16,166
20150611,13480,13510,13435,13435,13435,13435,13435,-75,-75,4,166
20150612,13435,13435,13360,13360,13360,13360,13360,-75,-75,2,166
20150615,13360,13360,13125,13135,13125,13135,13125,-225,-235,12,166
20150616,13135,13125,,,,13125,13125,0,0,0,166
20150617,13125,13125,,,,13125,13125,0,0,0,166
20150618,13125,13125,,,,13085,13085,-40,-40,0,166
20150619,13085,13085,13115,13145,13030,13145,13110,60,25,92,198
20150623,13145,13110,13130,13130,13100,13100,13115,-10,5,62,230
20150624,13100,13115,13140,13140,13120,13130,13130,15,15,38,256
20150625,13130,13130,13080,13080,13080,13080,13080,-50,-50,2,256
20150626,13080,13080,13040,13040,13015,13015,13025,-65,-55,10,258
20150629,13015,13025,,,,13015,13015,-10,-10,0,258
20150630,13015,13015,12925,12925,12805,12865,12850,-150,-165,16,262
20150701,12865,12850,12850,12860,12815,12815,12840,-35,-10,14,262
20150702,12815,12840,13030,13030,12765,12940,12990,100,150,28,282
20150703,12940,12990,12985,12985,12945,12945,12965,-45,-25,4,282
20150706,12945,12965,,,,12770,12770,-195,-195,0,282
20150707,12770,12770,12735,12790,12735,12790,12760,20,-10,4,280
20150708,12790,12760,12515,12515,12335,12335,12445,-425,-315,14,280
20150709,12335,12445,12535,12830,12535,12800,12750,355,305,34,298
20150710,12800,12750,,,,12750,12750,0,0,0,298
20150713,12750,12750,12810,12810,12735,12740,12785,-10,35,36,304
20150714,12740,12785,,,,12785,12785,0,0,0,304
20150715,12785,12785,12755,12755,12755,12755,12755,-30,-30,6,304
20150716,12755,12755,,,,12815,12815,60,60,0,304
20150717,12815,12815,,,,12725,12725,-90,-90,0,304
20150720,12725,12725,,,,12650,12650,-75,-75,0,304
20150721,12650,12650,,,,12630,12630,-20,-20,0,304
20150722,12630,12630,12705,12745,12505,12505,12655,-125,25,10,308
20150723,12505,12655,12550,12550,12535,12540,12540,-115,-115,28,304
20150724,12540,12540,12510,12510,12485,12485,12495,-55,-45,4,304
20150727,12485,12495,12500,12500,12500,12500,12500,5,5,24,280
20150728,12500,12500,12475,12510,12380,12510,12450,10,-50,10,280
20150729,12510,12450,12645,12645,12550,12550,12565,100,115,46,284
20150730,12550,12565,,,,12460,12460,-105,-105,0,284
20150731,12460,12460,12485,12485,12485,12485,12485,25,25,2,282
20150803,12485,12485,,,,12390,12390,-95,-95,0,282
20150804,12390,12390,,,,12375,12375,-15,-15,0,282
20150805,12375,12375,12395,12405,12395,12405,12400,30,25,4,282
20150806,12405,12400,,,,12400,12400,0,0,0,282
20150807,12400,12400,,,,12250,12250,-150,-150,0,282
20150810,12250,12250,12225,12230,12225,12230,12225,-20,-25,14,290
20150811,12230,12225,12245,12320,12245,12310,12290,85,65,6,288
20150812,12310,12290,,,,12290,12290,0,0,0,288
20150813,12290,12290,12400,12400,12400,12400,12400,110,110,2,290
20150814,12400,12400,,,,12315,12315,-85,-85,0,290
20150817,12315,12315,,,,12315,12315,0,0,0,290
20150818,12315,12315,,,,12315,12315,0,0,0,290
20150819,12315,12315,12170,12170,12170,12170,12170,-145,-145,2,292
20150820,12170,12170,,,,12170,12170,0,0,0,292
20150821,12170,12170,12275,12275,12275,12275,12275,105,105,2,290
20150824,12275,12275,12065,12065,12065,12065,12065,-210,-210,2,288
20150825,12065,12065,11895,12000,11895,11995,11935,-70,-130,168,286
20150826,11995,11935,12070,12070,11930,12030,12025,95,90,86,284
20150827,12030,12025,12000,12075,12000,12020,12040,-5,15,8,288
20150828,12020,12040,12080,12080,12080,12080,12080,40,40,4,290
20150831,12080,12080,12140,12140,12140,12140,12140,60,60,4,294
20150901,12140,12140,,,,12050,12050,-90,-90,0,294
20150902,12050,12050,,,,12020,12020,-30,-30,0,294
20150907,12020,12020,,,,12020,12020,0,0,0,294
20150908,12020,12020,,,,12020,12020,0,0,0,294
20150909,12020,12020,12120,12235,12120,12235,12170,215,150,32,298
20150910,12235,12170,,,,12170,12170,0,0,0,298
20150911,12170,12170,12280,12280,12280,12280,12280,110,110,2,298
20150914,12280,12280,,,,12270,12270,-10,-10,0,298
20150915,12270,12270,,,,12255,12255,-15,-15,0,298
20150916,12255,12255,12050,12100,12050,12100,12065,-155,-190,12,294
20150917,12100,12065,,,,12085,12085,20,20,0,294
20150918,12085,12085,12225,12225,12160,12160,12190,75,105,4,298
20150921,12160,12190,12355,12355,12355,12355,12355,165,165,2,296
20150922,12355,12355,12050,12090,12050,12090,12080,-265,-275,14,296
20150923,12090,12080,12005,12005,12005,12005,12005,-75,-75,2,296
20150924,12005,12005,,,,11985,11985,-20,-20,0,296
20150925,11985,11985,11985,11995,11985,11995,11990,10,5,10,296
20150928,11995,11990,11960,11960,11915,11915,11940,-75,-50,32,308
20150929,11915,11940,11815,11815,11815,11815,11815,-125,-125,4,308
20150930,11815,11815,11780,11795,11730,11795,11775,-20,-40,54,306
20151008,11795,11775,11685,11750,11610,11670,11730,-105,-45,204,412
20151009,11670,11730,11550,11775,11530,11770,11690,40,-40,158,518
20151012,11770,11690,11705,11705,11700,11700,11700,10,10,72,538
20151013,11700,11700,11660,11660,11635,11635,11645,-65,-55,10,546
20151014,11635,11645,11700,11700,11505,11505,11545,-140,-100,48,584
20151015,11505,11545,11550,11550,11415,11465,11515,-80,-30,298,820
20151016,11465,11515,11460,11465,11360,11370,11420,-145,-95,872,1380
20151019,11370,11420,11450,11450,11220,11220,11335,-200,-85,420,1694
20151020,11220,11335,11230,11240,11080,11085,11185,-250,-150,1578,2698
20151021,11085,11185,11065,11080,10835,10855,10915,-330,-270,2080,3198
20151022,10855,10915,10855,10955,10785,10815,10830,-100,-85,2210,4256
20151023,10815,10830,10860,10880,10450,10710,10700,-120,-130,3450,5592
20151026,10710,10700,10590,10615,10480,10550,10545,-150,-155,2382,5956
20151027,10550,10545,10565,10650,10500,10600,10605,55,60,3324,8274
20151028,10600,10605,10620,10710,10380,10385,10505,-220,-100,1750,8826
20151029,10385,10505,10415,10500,10370,10420,10405,-85,-100,1628,9886
20151030,10420,10405,10385,10460,10375,10440,10415,35,10,1350,10172
20151102,10440,10415,10525,10525,10370,10380,10395,-35,-20,508,10256
20151103,10380,10395,10405,10505,10400,10430,10455,35,60,1116,10398
20151104,10430,10455,10460,10590,10415,10590,10500,135,45,2102,11494
20151105,10590,10500,10535,10720,10535,10650,10665,150,165,3726,12234
20151106,10650,10665,10660,10700,10590,10650,10640,-15,-25,2174,12786
20151109,10650,10640,10645,10745,10575,10650,10660,10,20,2642,13870
20151110,10650,10660,10665,10680,10390,10410,10520,-250,-140,5986,16128
20151111,10410,10520,10280,10405,10135,10160,10215,-360,-305,13016,23088
20151112,10160,10215,10195,10285,10150,10210,10195,-5,-20,3862,24550
20151113,10210,10195,10180,10265,10055,10200,10165,5,-30,5996,26208
20151116,10200,10165,10190,10285,10120,10145,10210,-20,45,5320,26808
20151117,10145,10210,10105,10165,9995,10080,10055,-130,-155,6510,28998
20151118,10080,10055,10120,10150,9975,10060,10035,5,-20,4256,29786
20151119,10060,10035,10055,10055,9870,9890,9945,-145,-90,8814,31412
20151120,9890,9945,9870,10080,9690,9910,9810,-35,-135,14630,33270
20151123,9910,9810,9900,10010,9735,9815,9850,5,40,10914,35462
20151124,9815,9850,9800,9810,9600,9730,9700,-120,-150,15614,38126
20151125,9730,9700,9730,9900,9630,9805,9775,105,75,12496,39782
20151126,9805,9775,9695,10165,9690,10090,10015,315,240,30878,45084
20151127,10090,10015,10090,10415,10055,10250,10270,235,255,48158,51134
20151130,10250,10270,10220,10275,9900,9935,10045,-335,-225,46522,62788
al1606,20150616,13125,13125,,,,13125,13125,0,0,0,0
20150617,13125,13125,,,,13125,13125,0,0,0,0
20150618,13125,13125,,,,13125,13125,0,0,0,0
20150619,13125,13125,13190,13190,13165,13175,13165,50,40,32,28
20150623,13175,13165,,,,13170,13170,5,5,0,28
20150624,13170,13170,13210,13210,13180,13180,13195,10,25,6,32
20150625,13180,13195,13090,13100,13090,13100,13095,-95,-100,4,34
20150626,13100,13095,13085,13085,13070,13070,13080,-25,-15,14,42
20150629,13070,13080,12945,13090,12945,13090,13015,10,-65,4,42
20150630,13090,13015,,,,12850,12850,-165,-165,0,42
20150701,12850,12850,,,,12840,12840,-10,-10,0,42
20150702,12840,12840,13065,13065,12985,12985,13025,145,185,8,44
20150703,12985,13025,,,,13025,13025,0,0,0,44
20150706,13025,13025,12800,12800,12800,12800,12800,-225,-225,6,44
20150707,12800,12800,,,,12790,12790,-10,-10,0,44
20150708,12790,12790,12505,12505,12280,12280,12435,-510,-355,14,46
20150709,12280,12435,12535,12755,12535,12720,12710,285,275,32,68
20150710,12720,12710,12750,12945,12750,12865,12870,155,160,16,70
20150713,12865,12870,12755,12755,12755,12755,12755,-115,-115,24,66
20150714,12755,12755,,,,12755,12755,0,0,0,66
20150715,12755,12755,,,,12725,12725,-30,-30,0,66
20150716,12725,12725,,,,12785,12785,60,60,0,66
20150717,12785,12785,,,,12695,12695,-90,-90,0,66
20150720,12695,12695,,,,12620,12620,-75,-75,0,66
20150721,12620,12620,12760,12760,12760,12760,12760,140,140,2,64
20150722,12760,12760,,,,12785,12785,25,25,0,64
20150723,12785,12785,,,,12665,12665,-120,-120,0,64
20150724,12665,12665,,,,12570,12570,-95,-95,0,64
20150727,12570,12570,12505,12505,12505,12505,12505,-65,-65,4,66
20150728,12505,12505,,,,12455,12455,-50,-50,0,66
20150729,12455,12455,12680,12680,12680,12680,12680,225,225,2,64
20150730,12680,12680,,,,12575,12575,-105,-105,0,64
20150731,12575,12575,12510,12510,12495,12495,12495,-80,-80,10,70
20150803,12495,12495,12400,12400,12385,12385,12390,-110,-105,4,72
20150804,12385,12390,,,,12375,12375,-15,-15,0,72
20150805,12375,12375,12435,12435,12435,12435,12435,60,60,4,76
20150806,12435,12435,,,,12435,12435,0,0,0,76
20150807,12435,12435,,,,12285,12285,-150,-150,0,76
20150810,12285,12285,12215,12235,12215,12230,12225,-55,-60,6,78
20150811,12230,12225,,,,12290,12290,65,65,0,78
20150812,12290,12290,12425,12425,12425,12425,12425,135,135,12,72
20150813,12425,12425,,,,12425,12425,0,0,0,72
20150814,12425,12425,12470,12470,12230,12230,12350,-195,-75,12,72
20150817,12230,12350,12365,12365,12365,12365,12365,15,15,2,70
20150818,12365,12365,,,,12365,12365,0,0,0,70
20150819,12365,12365,,,,12365,12365,0,0,0,70
20150820,12365,12365,12380,12380,12260,12260,12320,-105,-45,4,68
20150821,12260,12320,12265,12280,12260,12280,12265,-40,-55,6,68
20150824,12280,12265,12225,12250,12120,12250,12195,-15,-70,6,70
20150825,12250,12195,12100,12100,12100,12100,12100,-95,-95,2,70
20150826,12100,12100,12055,12065,12055,12055,12055,-45,-45,8,68
20150827,12055,12055,,,,12070,12070,15,15,0,68
20150828,12070,12070,,,,12070,12070,0,0,0,68
20150831,12070,12070,,,,12070,12070,0,0,0,68
20150901,12070,12070,,,,12070,12070,0,0,0,68
20150902,12070,12070,,,,12040,12040,-30,-30,0,68
20150907,12040,12040,,,,12040,12040,0,0,0,68
20150908,12040,12040,,,,12040,12040,0,0,0,68
20150909,12040,12040,12165,12165,12165,12165,12165,125,125,2,70
20150910,12165,12165,,,,12165,12165,0,0,0,70
20150911,12165,12165,,,,12270,12270,105,105,0,70
20150914,12270,12270,12300,12300,12300,12300,12300,30,30,62,130
20150915,12300,12300,12165,12165,12035,12035,12100,-265,-200,4,130
20150916,12035,12100,12025,12025,12025,12025,12025,-75,-75,2,132
20150917,12025,12025,,,,12045,12045,20,20,0,132
20150918,12045,12045,12245,12245,12245,12245,12245,200,200,2,132
20150921,12245,12245,12060,12200,12060,12200,12105,-45,-140,6,132
20150922,12200,12105,,,,12105,12105,0,0,0,132
20150923,12105,12105,12020,12020,12020,12020,12020,-85,-85,2,132
20150924,12020,12020,11990,11990,11990,11990,11990,-30,-30,2,130
20150925,11990,11990,,,,11990,11990,0,0,0,130
20150928,11990,11990,,,,11990,11990,0,0,0,130
20150929,11990,11990,11815,11815,11815,11815,11815,-175,-175,2,130
20150930,11815,11815,11830,11830,11830,11830,11830,15,15,2,130
20151008,11830,11830,11750,11750,11685,11685,11735,-145,-95,10,134
20151009,11685,11735,,,,11735,11735,0,0,0,134
20151012,11735,11735,,,,11735,11735,0,0,0,134
20151013,11735,11735,11635,11705,11635,11660,11655,-75,-80,44,144
20151014,11660,11655,11615,11625,11555,11555,11605,-100,-50,24,156
20151015,11555,11605,11570,11570,11570,11570,11570,-35,-35,100,256
20151016,11570,11570,11480,11480,11410,11410,11450,-160,-120,22,262
20151019,11410,11450,11270,11320,11270,11295,11285,-155,-165,10,268
20151020,11295,11285,11265,11265,11110,11130,11150,-155,-135,150,406
20151021,11130,11150,11080,11080,10885,10885,10950,-265,-200,364,500
20151022,10885,10950,10865,10945,10830,10850,10850,-100,-100,214,612
20151023,10850,10850,10900,10900,10465,10730,10745,-120,-105,1148,1170
20151026,10730,10745,10580,10650,10500,10620,10570,-125,-175,378,1368
20151027,10620,10570,10560,10660,10480,10640,10600,70,30,1700,2418
20151028,10640,10600,10670,10710,10400,10400,10540,-200,-60,146,2486
20151029,10400,10540,10470,10510,10410,10440,10435,-100,-105,546,2830
20151030,10440,10435,10435,10480,10420,10435,10460,0,25,76,2832
20151102,10435,10460,10480,10495,10380,10400,10405,-60,-55,206,2994
20151103,10400,10405,10460,10530,10460,10470,10490,65,85,232,3060
20151104,10470,10490,10425,10580,10425,10580,10490,90,0,1008,3598
20151105,10580,10490,10560,10710,10560,10635,10685,145,195,600,3840
20151106,10635,10685,10635,10710,10620,10640,10650,-45,-35,114,3842
20151109,10640,10650,10655,10810,10630,10690,10690,40,40,70,3842
20151110,10690,10690,10650,10655,10450,10450,10500,-240,-190,850,4290
20151111,10450,10500,10370,10370,10185,10200,10270,-300,-230,1528,5416
20151112,10200,10270,10180,10320,10105,10250,10235,-20,-35,378,5600
20151113,10250,10235,10110,10280,10110,10235,10225,0,-10,728,5666
20151116,10235,10225,10270,10300,10150,10170,10235,-55,10,3060,7082
20151117,10170,10235,10110,10160,10010,10100,10090,-135,-145,5524,10872
20151118,10100,10090,10120,10155,10000,10090,10095,0,5,1072,11266
20151119,10090,10095,10035,10045,9905,9920,9975,-175,-120,2992,12604
20151120,9920,9975,9855,10075,9715,9940,9785,-35,-190,3984,13832
20151123,9940,9785,9980,10025,9765,9820,9845,35,60,2082,14774
20151124,9820,9845,9800,9800,9625,9780,9700,-65,-145,3024,15424
20151125,9780,9700,9780,9910,9650,9835,9810,135,110,1584,16236
20151126,9835,9810,9740,10200,9740,10100,10060,290,250,7290,18296
20151127,10100,10060,10140,10460,10070,10235,10275,175,215,14574,24310
20151130,10235,10275,10120,10245,9890,9930,10010,-345,-265,16546,32414
al1607,20150716,12725,12725,,,,12785,12785,60,60,0,0
20150717,12785,12785,,,,12695,12695,-90,-90,0,0
20150720,12695,12695,,,,12695,12695,0,0,0,0
20150721,12695,12695,,,,12835,12835,140,140,0,0
20150722,12835,12835,,,,12835,12835,0,0,0,0
20150723,12835,12835,,,,12715,12715,-120,-120,0,0
20150724,12715,12715,12565,12565,12565,12565,12565,-150,-150,2,2
20150727,12565,12565,12485,12750,12485,12750,12615,185,50,8,2
20150728,12750,12615,,,,12565,12565,-50,-50,0,2
20150729,12565,12565,,,,12790,12790,225,225,0,2
20150730,12790,12790,,,,12790,12790,0,0,0,2
20150731,12790,12790,12500,12580,12500,12530,12535,-260,-255,6,8
20150803,12530,12535,12465,12475,12380,12380,12430,-155,-105,34,10
20150804,12380,12430,12435,12435,12435,12435,12435,5,5,2,10
20150805,12435,12435,,,,12435,12435,0,0,0,10
20150806,12435,12435,,,,12435,12435,0,0,0,10
20150807,12435,12435,,,,12285,12285,-150,-150,0,10
20150810,12285,12285,,,,12285,12285,0,0,0,10
20150811,12285,12285,12485,12485,12485,12485,12485,200,200,2,10
20150812,12485,12485,12455,12475,12385,12385,12425,-100,-60,18,10
20150813,12385,12425,12625,12625,12360,12525,12495,100,70,26,12
20150814,12525,12495,,,,12415,12415,-80,-80,0,12
20150817,12415,12415,12510,12510,12340,12340,12425,-75,10,12,12
20150818,12340,12425,,,,12425,12425,0,0,0,12
20150819,12425,12425,,,,12365,12365,-60,-60,0,12
20150820,12365,12365,,,,12365,12365,0,0,0,12
20150821,12365,12365,,,,12365,12365,0,0,0,12
20150824,12365,12365,,,,12295,12295,-70,-70,0,12
20150825,12295,12295,12195,12195,11985,12055,12085,-240,-210,66,42
20150826,12055,12085,,,,12040,12040,-45,-45,0,42
20150827,12040,12040,12060,12065,12060,12065,12060,25,20,4,40
20150828,12065,12060,12095,12185,12095,12145,12140,85,80,72,84
20150831,12145,12140,12115,12115,12115,12115,12115,-25,-25,2,82
20150901,12115,12115,12100,12100,12095,12095,12095,-20,-20,8,82
20150902,12095,12095,12050,12050,12035,12035,12040,-60,-55,4,82
20150907,12035,12040,12125,12125,12125,12125,12125,85,85,2,82
20150908,12125,12125,12140,12155,12130,12130,12140,5,15,140,206
20150909,12130,12140,12280,12345,12280,12345,12320,205,180,124,284
20150910,12345,12320,,,,12320,12320,0,0,0,284
20150911,12320,12320,12325,12350,12325,12350,12335,30,15,4,282
20150914,12350,12335,,,,12335,12335,0,0,0,282
20150915,12335,12335,,,,12285,12285,-50,-50,0,282
20150916,12285,12285,,,,12275,12275,-10,-10,0,282
20150917,12275,12275,,,,12295,12295,20,20,0,282
20150918,12295,12295,,,,12495,12495,200,200,0,282
20150921,12495,12495,,,,12355,12355,-140,-140,0,282
20150922,12355,12355,,,,12080,12080,-275,-275,0,282
20150923,12080,12080,12095,12095,12095,12095,12095,15,15,2,280
20150924,12095,12095,,,,12075,12075,-20,-20,0,280
20150925,12075,12075,12110,12110,12110,12110,12110,35,35,2,280
20150928,12110,12110,,,,12110,12110,0,0,0,280
20150929,12110,12110,11905,11905,11850,11880,11880,-230,-230,8,280
20150930,11880,11880,11885,11885,11885,11885,11885,5,5,2,278
20151008,11885,11885,,,,11790,11790,-95,-95,0,278
20151009,11790,11790,11600,11805,11595,11800,11765,10,-25,74,338
20151012,11800,11765,,,,11765,11765,0,0,0,338
20151013,11765,11765,11705,11705,11705,11705,11705,-60,-60,2,340
20151014,11705,11705,,,,11705,11705,0,0,0,340
20151015,11705,11705,,,,11555,11555,-150,-150,0,340
20151016,11555,11555,11460,11460,11460,11460,11460,-95,-95,2,340
20151019,11460,11460,11410,11415,11410,11410,11410,-50,-50,26,364
20151020,11410,11410,,,,11275,11275,-135,-135,0,364
20151021,11275,11275,11130,11130,10935,10935,10995,-340,-280,280,424
20151022,10935,10995,10835,10930,10835,10875,10860,-120,-135,298,606
20151023,10875,10860,10890,10890,10500,10750,10795,-110,-65,604,1102
20151026,10750,10795,10570,10630,10570,10630,10595,-165,-200,54,1120
20151027,10630,10595,10595,10715,10570,10685,10670,90,75,816,1676
20151028,10685,10670,10605,10610,10510,10510,10565,-160,-105,36,1678
20151029,10510,10565,10500,10510,10430,10470,10465,-95,-100,394,1934
20151030,10470,10465,10495,10500,10495,10500,10495,35,30,68,1974
20151102,10500,10495,10500,10610,10425,10440,10490,-55,-5,216,2068
20151103,10440,10490,10480,10550,10470,10500,10520,10,30,50,2100
20151104,10500,10520,10520,10570,10490,10570,10530,50,10,394,2246
20151105,10570,10530,10600,10750,10600,10685,10720,155,190,234,2372
20151106,10685,10720,10660,10725,10655,10705,10685,-15,-35,52,2384
20151109,10705,10685,10675,10805,10675,10715,10700,30,15,48,2376
20151110,10715,10700,10655,10655,10475,10475,10535,-225,-165,90,2430
20151111,10475,10535,10335,10440,10225,10225,10310,-310,-225,126,2530
20151112,10225,10310,10175,10330,10175,10330,10255,20,-55,100,2508
20151113,10330,10255,10160,10310,10160,10235,10230,-20,-25,356,2546
20151116,10235,10230,10305,10305,10230,10230,10255,0,25,26,2568
20151117,10230,10255,10165,10165,10025,10100,10095,-155,-160,212,2630
20151118,10100,10095,10090,10170,10020,10090,10100,-5,5,212,2708
20151119,10090,10100,10060,10075,9960,9960,10045,-140,-55,414,3046
20151120,9960,10045,9865,10080,9745,9950,9825,-95,-220,1256,3480
20151123,9950,9825,10000,10005,9805,9870,9880,45,55,282,3464
20151124,9870,9880,9730,9810,9650,9800,9725,-80,-155,274,3496
20151125,9800,9725,9750,9920,9670,9840,9815,115,90,696,3614
20151126,9840,9815,9770,10205,9770,10120,9940,305,125,3644,5520
20151127,10120,9940,10150,10335,10075,10230,10180,290,240,2272,6598
20151130,10230,10180,10235,10235,9905,9940,9975,-240,-205,4062,8386
al1608,20150818,12425,12425,,,,12425,12425,0,0,0,0
20150819,12425,12425,12250,12250,12250,12250,12250,-175,-175,2,2
20150820,12250,12250,,,,12205,12205,-45,-45,0,2
20150821,12205,12205,,,,12250,12250,45,45,0,2
20150824,12250,12250,,,,12250,12250,0,0,0,2
20150825,12250,12250,,,,12250,12250,0,0,0,2
20150826,12250,12250,,,,12205,12205,-45,-45,0,2
20150827,12205,12205,12030,12030,12030,12030,12030,-175,-175,2,4
20150828,12030,12030,,,,12030,12030,0,0,0,4
20150831,12030,12030,,,,12030,12030,0,0,0,4
20150901,12030,12030,,,,12010,12010,-20,-20,0,4
20150902,12010,12010,,,,11955,11955,-55,-55,0,4
20150907,11955,11955,12125,12260,12125,12260,12190,305,235,4,8
20150908,12260,12190,12285,12285,12160,12160,12195,-30,5,10,8
20150909,12160,12195,12325,12410,12325,12400,12365,205,170,50,54
20150910,12400,12365,,,,12365,12365,0,0,0,54
20150911,12365,12365,,,,12380,12380,15,15,0,54
20150914,12380,12380,,,,12380,12380,0,0,0,54
20150915,12380,12380,,,,12175,12175,-205,-205,0,54
20150916,12175,12175,,,,12095,12095,-80,-80,0,54
20150917,12095,12095,12365,12365,12365,12365,12365,270,270,2,54
20150918,12365,12365,,,,12365,12365,0,0,0,54
20150921,12365,12365,12275,12275,12275,12275,12275,-90,-90,2,52
20150922,12275,12275,12205,12205,12195,12195,12195,-80,-80,6,54
20150923,12195,12195,,,,12210,12210,15,15,0,54
20150924,12210,12210,,,,12175,12175,-35,-35,0,54
20150925,12175,12175,,,,12210,12210,35,35,0,54
20150928,12210,12210,12025,12025,12025,12025,12025,-185,-185,2,52
20150929,12025,12025,,,,11800,11800,-225,-225,0,52
20150930,11800,11800,11910,11910,11670,11765,11780,-35,-20,6,52
20151008,11765,11780,,,,11685,11685,-95,-95,0,52
20151009,11685,11685,,,,11685,11685,0,0,0,52
20151012,11685,11685,,,,11685,11685,0,0,0,52
20151013,11685,11685,11730,11730,11730,11730,11730,45,45,2,52
20151014,11730,11730,,,,11680,11680,-50,-50,0,52
20151015,11680,11680,,,,11595,11595,-85,-85,0,52
20151016,11595,11595,11525,11525,11480,11480,11510,-115,-85,6,58
20151019,11480,11510,11525,11525,11405,11405,11465,-105,-45,4,58
20151020,11405,11465,11380,11380,11225,11225,11275,-240,-190,20,62
20151021,11225,11275,11185,11185,10970,10980,11050,-295,-225,340,202
20151022,10980,11050,10905,10960,10860,10895,10885,-155,-165,58,218
20151023,10895,10885,10925,10925,10600,10795,10790,-90,-95,186,358
20151026,10795,10790,11160,11160,10580,10610,10810,-180,20,12,358
20151027,10610,10810,10700,10720,10700,10720,10700,-90,-110,756,1108
20151028,10720,10700,10625,10625,10480,10480,10510,-220,-190,54,1162
20151029,10480,10510,10520,10520,10460,10490,10505,-20,-5,382,1280
20151030,10490,10505,10500,10510,10500,10510,10505,5,0,268,1504
20151102,10510,10505,10515,10525,10440,10440,10510,-65,5,36,1486
20151103,10440,10510,10435,10545,10435,10545,10510,35,0,18,1484
20151104,10545,10510,10510,10620,10510,10620,10570,110,60,898,2238
20151105,10620,10570,10610,10750,10610,10665,10725,95,155,218,2312
20151106,10665,10725,10725,10725,10695,10695,10710,-30,-15,18,2312
20151109,10695,10710,10750,10760,10730,10740,10745,30,35,20,2308
20151110,10740,10745,10655,10685,10500,10515,10535,-230,-210,188,2292
20151111,10515,10535,10510,10510,10230,10275,10340,-260,-195,164,2324
20151112,10275,10340,10265,10680,10265,10295,10380,-45,40,46,2332
20151113,10295,10380,10220,10325,10220,10280,10225,-100,-155,342,2564
20151116,10280,10225,10335,10335,10235,10235,10265,10,40,6,2558
20151117,10235,10265,10145,10175,10085,10175,10120,-90,-145,20,2560
20151118,10175,10120,10200,10200,10050,10100,10080,-20,-40,122,2558
20151119,10100,10080,10220,10220,9955,9990,10100,-90,20,852,2854
20151120,9990,10100,9920,10115,9775,10070,9965,-30,-135,794,2718
20151123,10070,9965,10015,10075,9850,9860,9905,-105,-60,412,2996
20151124,9860,9905,9800,9830,9680,9800,9750,-105,-155,112,3064
20151125,9800,9750,9850,9900,9700,9860,9805,110,55,202,3108
20151126,9860,9805,9820,10195,9785,10100,10010,295,205,1818,4146
20151127,10100,10010,10100,10410,10100,10235,10220,225,210,762,4244
20151130,10235,10220,10185,10185,9910,9950,9995,-270,-225,922,4704
al1609,20150916,12175,12175,,,,12095,12095,-80,-80,0,0
20150917,12095,12095,,,,12365,12365,270,270,0,0
20150918,12365,12365,,,,12570,12570,205,205,0,0
20150921,12570,12570,,,,12475,12475,-95,-95,0,0
20150922,12475,12475,,,,12395,12395,-80,-80,0,0
20150923,12395,12395,12110,12110,12110,12110,12110,-285,-285,2,2
20150924,12110,12110,,,,12075,12075,-35,-35,0,2
20150925,12075,12075,,,,12110,12110,35,35,0,2
20150928,12110,12110,,,,12110,12110,0,0,0,2
20150929,12110,12110,,,,11880,11880,-230,-230,0,2
20150930,11880,11880,,,,11860,11860,-20,-20,0,2
20151008,11860,11860,,,,11765,11765,-95,-95,0,2
20151009,11765,11765,,,,11765,11765,0,0,0,2
20151012,11765,11765,,,,11765,11765,0,0,0,2
20151013,11765,11765,,,,11765,11765,0,0,0,2
20151014,11765,11765,11700,11700,11625,11625,11660,-140,-105,4,4
20151015,11625,11660,11515,11515,11515,11515,11515,-145,-145,2,4
20151016,11515,11515,11505,11505,11480,11480,11495,-35,-20,28,28
20151019,11480,11495,11610,11610,11360,11360,11465,-135,-30,14,36
20151020,11360,11465,11285,11285,11255,11285,11275,-180,-190,10,38
20151021,11285,11275,11160,11160,10980,10980,11115,-295,-160,18,44
20151022,10980,11115,10815,10995,10815,10885,10940,-230,-175,78,106
20151023,10885,10940,10900,10955,10550,10810,10820,-130,-120,376,390
20151026,10810,10820,10600,10685,10600,10685,10645,-135,-175,52,434
20151027,10685,10645,10710,10740,10705,10740,10715,95,70,1054,1400
20151028,10740,10715,10800,10800,10530,10530,10645,-185,-70,60,1422
20151029,10530,10645,10540,10560,10475,10520,10510,-125,-135,136,1424
20151030,10520,10510,10545,10545,10505,10530,10530,20,20,38,1448
20151102,10530,10530,10560,10660,10465,10480,10575,-50,45,62,1442
20151103,10480,10575,10535,10560,10475,10560,10525,-15,-50,20,1438
20151104,10560,10525,10560,10650,10505,10650,10565,125,40,870,2220
20151105,10650,10565,10655,10765,10655,10700,10730,135,165,368,2370
20151106,10700,10730,10740,10740,10740,10740,10740,10,10,2,2372
20151109,10740,10740,10740,10740,10730,10740,10735,0,-5,10,2368
20151110,10740,10735,10695,10695,10565,10565,10640,-170,-95,74,2360
20151111,10565,10640,10565,10565,10260,10285,10360,-355,-280,148,2442
20151112,10285,10360,10285,10360,10285,10360,10325,0,-35,30,2452
20151113,10360,10325,10215,10330,10215,10330,10270,5,-55,170,2480
20151116,10330,10270,10335,10335,10305,10305,10330,35,60,202,2676
20151117,10305,10330,10190,10190,10070,10115,10140,-215,-190,38,2692
20151118,10115,10140,10170,10175,10055,10125,10140,-15,0,14,2690
20151119,10125,10140,10080,10080,9980,10010,10045,-130,-95,98,2716
20151120,10010,10045,9845,10125,9845,10020,9980,-25,-65,68,2722
20151123,10020,9980,10035,10095,9790,9865,9980,-115,0,84,2764
20151124,9865,9980,9800,9835,9765,9835,9795,-145,-185,18,2776
20151125,9835,9795,9885,9900,9700,9900,9835,105,40,130,2784
20151126,9900,9835,9820,10225,9795,10110,9925,275,90,1528,3928
20151127,10110,9925,10110,10320,10090,10295,10215,370,290,186,3912
20151130,10295,10215,10120,10130,9900,9950,10015,-265,-200,224,3994
al1610,20151016,11515,11515,11740,11740,11420,11520,11545,5,30,16,12
20151019,11520,11545,,,,11410,11410,-135,-135,0,12
20151020,11410,11410,11320,11320,11320,11320,11320,-90,-90,2,14
20151021,11320,11320,11140,11160,11030,11040,11105,-280,-215,26,26
20151022,11040,11105,10945,11005,10910,10960,10960,-145,-145,46,66
20151023,10960,10960,10970,10970,10580,10840,10825,-120,-135,332,354
20151026,10840,10825,10750,10750,10625,10650,10695,-175,-130,12,360
20151027,10650,10695,10715,10750,10710,10750,10715,55,20,244,564
20151028,10750,10715,10635,10635,10530,10530,10615,-185,-100,16,578
20151029,10530,10615,10560,10560,10460,10510,10540,-105,-75,116,626
20151030,10510,10540,10500,10570,10495,10570,10540,30,0,18,632
20151102,10570,10540,10585,10635,10405,10480,10555,-60,15,76,668
20151103,10480,10555,10580,10580,10550,10570,10555,15,0,22,668
20151104,10570,10555,10595,10680,10595,10680,10605,125,50,846,1432
20151105,10680,10605,10670,10765,10670,10680,10740,75,135,374,1716
20151106,10680,10740,10750,10760,10740,10750,10745,10,5,40,1734
20151109,10750,10745,10790,10790,10745,10745,10785,0,40,126,1852
20151110,10745,10785,10720,10720,10550,10550,10660,-235,-125,342,2086
20151111,10550,10660,10405,10495,10260,10260,10325,-400,-335,496,2070
20151112,10260,10325,10260,10385,10260,10385,10330,60,5,60,2098
20151113,10385,10330,10260,10410,10215,10300,10260,-30,-70,652,2606
20151116,10300,10260,10320,10355,10230,10255,10260,-5,0,130,2642
20151117,10255,10260,10245,10245,10080,10160,10135,-100,-125,104,2644
20151118,10160,10135,10190,10240,10060,10140,10105,5,-30,146,2684
20151119,10140,10105,10045,10120,9990,10100,10065,-5,-40,286,2786
20151120,10100,10065,9995,10160,9805,10030,9960,-35,-105,1184,3576
20151123,10030,9960,9885,10060,9800,9910,9900,-50,-60,500,3780
20151124,9910,9900,9845,9910,9725,9845,9810,-55,-90,532,3658
20151125,9845,9810,9820,9950,9740,9880,9780,70,-30,1528,4552
20151126,9880,9780,9870,10170,9790,10080,9915,300,135,1858,5864
20151127,10080,9915,10120,10310,10040,10260,10220,345,305,462,5678
20151130,10260,10220,10185,10235,9905,9960,9990,-260,-230,338,5780
al1611,20151117,10260,10260,,,,10135,10135,-125,-125,0,0
20151118,10135,10135,10100,10100,10100,10100,10100,-35,-35,4,4
20151119,10100,10100,10100,10100,10050,10050,10050,-50,-50,82,86
20151120,10050,10050,10015,10050,10010,10050,10025,0,-25,10,86
20151123,10050,10025,10005,10005,9900,9935,9920,-90,-105,88,122
20151124,9935,9920,9795,9825,9680,9825,9765,-95,-155,30,122
20151125,9825,9765,9860,9870,9830,9840,9840,75,75,36,134
20151126,9840,9840,9845,10230,9825,10100,10115,260,275,212,232
20151127,10100,10115,10150,10495,10090,10235,10270,120,155,264,370
20151130,10235,10270,10200,10200,9905,9950,9990,-320,-280,348,490
au1501,20150105,242.2,241.4,236.25,246.85,236.2,236.2,241.3,-5.2,-.1,24,126
20150106,236.2,241.3,239.15,239.15,239.15,239.15,239.15,-2.15,-2.15,12,114
20150107,239.15,239.15,,,,239.15,239.15,0,0,0,114
20150108,239.15,239.15,246,246,242.5,242.5,244.15,3.35,5,42,78
20150109,242.5,244.15,244,244,242,242,243,-2.15,-1.15,12,72
20150112,242,243,253.15,253.15,245.5,245.55,249.3,2.55,6.3,24,60
20150113,245.55,249.3,,,,249.3,249.3,0,0,0,60
20150114,249.3,249.3,,,,249.3,249.3,0,0,0,60
20150115,249.3,249.3,,,,249.3,249.3,0,0,0,60
au1502,20150105,240.6,241.35,239.3,240.1,238.6,240.1,239.55,-1.25,-1.8,24,140
20150106,240.1,239.55,240.25,242.75,240.25,242.75,241.55,3.2,2,136,156
20150107,242.75,241.55,243.15,244.65,241.55,243.6,243,2.05,1.45,260,150
20150108,243.6,243,242.75,243.95,242.25,242.8,243.15,-.2,.15,88,132
20150109,242.8,243.15,242.75,244,242.75,243.5,243.4,.35,.25,76,128
20150112,243.5,243.4,243.25,246.8,243.25,246.65,245.15,3.25,1.75,44,108
20150113,246.65,245.15,244.25,247.9,244.25,247.25,246.4,2.1,1.25,56,112
20150114,247.25,246.4,248.5,248.5,245.1,246,246.85,-.4,.45,88,128
20150115,246,246.85,246.05,248.1,245.45,245.8,246.5,-1.05,-.35,32,130
20150116,245.8,246.5,250.25,258,250.1,251.9,251.85,5.4,5.35,264,134
20150119,251.9,251.85,252.35,256.5,252.35,256,255.35,4.15,3.5,80,142
20150120,256,255.35,256.15,256.4,255.95,255.95,256.1,.6,.75,8,138
20150121,255.95,256.1,259.2,260.7,257.95,260.05,259.65,3.95,3.55,88,152
20150122,260.05,259.65,260.8,260.8,256.55,256.55,258.4,-3.1,-1.25,84,128
20150123,256.55,258.4,257.55,265,257.55,259.35,260.8,.95,2.4,3126,452
20150126,259.35,260.8,259.85,260.75,257.05,260,259.8,-.8,-1,294,268
20150127,260,259.8,258.55,258.55,257.1,257.2,257.2,-2.6,-2.6,134,152
20150128,257.2,257.2,259.6,259.65,259.6,259.65,259.6,2.45,2.4,4,148
20150129,259.65,259.6,259.1,259.1,257.75,258,258.25,-1.6,-1.35,68,94
20150130,258,258.25,253.7,255.95,245.3,252.45,252.7,-5.8,-5.55,70,66
20150202,252.45,252.7,,,,255.85,255.85,3.15,3.15,0,66
20150203,255.85,255.85,,,,255.85,255.85,0,0,0,66
20150204,255.85,255.85,257,257,254,254,255.1,-1.85,-.75,30,36
20150205,254,255.1,263.95,263.95,251.05,251.05,257,-4.05,1.9,24,30
20150206,251.05,257,,,,257,257,0,0,0,30
20150209,257,257,,,,257,257,0,0,0,30
20150210,257,257,,,,257,257,0,0,0,30
au1503,20150105,240.65,240.65,240.15,240.15,240.15,240.15,240.15,-.5,-.5,2,2
20150106,240.15,240.15,,,,242.15,242.15,2,2,0,2
20150107,242.15,242.15,243.55,243.55,243.55,243.55,243.55,1.4,1.4,2,4
20150108,243.55,243.55,242.7,245.45,242.7,245.45,244.05,1.9,.5,4,2
20150109,245.45,244.05,,,,244.3,244.3,.25,.25,0,2
20150112,244.3,244.3,245.6,247,243.15,247,244.9,2.7,.6,10,6
20150113,247,244.9,247.65,248.75,247.65,248.75,248.2,3.85,3.3,4,4
20150114,248.75,248.2,,,,248.65,248.65,.45,.45,0,4
20150115,248.65,248.65,248.6,250.25,245.15,246.15,247.05,-2.5,-1.6,10,4
20150116,246.15,247.05,253.05,253.05,251.05,252.55,252.45,5.5,5.4,32,8
20150119,252.55,252.45,253,253,252.7,252.7,252.85,.25,.4,4,4
20150120,252.7,252.85,255.8,257.55,255.8,257.55,256.65,4.7,3.8,4,6
20150121,257.55,256.65,256.85,262.1,256.5,259.75,259.15,3.1,2.5,44,4
20150122,259.75,259.15,259.95,260,258.7,258.85,259.45,-.3,.3,14,12
20150123,258.85,259.45,262.15,262.2,259.55,260.4,260.9,.95,1.45,10,10
20150126,260.4,260.9,262.2,262.5,258.35,262.5,260.5,1.6,-.4,12,16
20150127,262.5,260.5,258.4,258.4,257.35,257.35,257.6,-3.15,-2.9,8,10
20150128,257.35,257.6,260.05,260.05,260.05,260.05,260.05,2.45,2.45,2,10
20150129,260.05,260.05,,,,258.7,258.7,-1.35,-1.35,0,10
20150130,258.7,258.7,,,,253.15,253.15,-5.55,-5.55,0,10
20150202,253.15,253.15,,,,253.15,253.15,0,0,0,10
20150203,253.15,253.15,,,,253.15,253.15,0,0,0,10
20150204,253.15,253.15,,,,252.4,252.4,-.75,-.75,0,10
20150205,252.4,252.4,,,,254.25,254.25,1.85,1.85,0,10
20150206,254.25,254.25,256.35,257.55,256.35,257.55,256.95,3.3,2.7,4,10
20150209,257.55,256.95,249.2,249.2,249.2,249.2,249.2,-7.75,-7.75,2,8
20150210,249.2,249.2,,,,249.2,249.2,0,0,0,8
20150211,249.2,249.2,,,,249.2,249.2,0,0,0,8
20150212,249.2,249.2,,,,249.2,249.2,0,0,0,8
20150213,249.2,249.2,,,,249.2,249.2,0,0,0,8
20150216,249.2,249.2,,,,249.2,249.2,0,0,0,8
20150217,249.2,249.2,245.45,247.85,245.45,247.85,246.65,-1.35,-2.55,4,6
20150225,247.85,246.65,244.6,245.1,244.15,245.1,244.6,-1.55,-2.05,10,0
20150226,245.1,244.6,,,,244.6,244.6,0,0,0,0
20150227,244.6,244.6,,,,244.6,244.6,0,0,0,0
20150302,244.6,244.6,,,,244.6,244.6,0,0,0,0
20150303,244.6,244.6,,,,244.6,244.6,0,0,0,0
20150304,244.6,244.6,,,,244.6,244.6,0,0,0,0
20150305,244.6,244.6,,,,244.6,244.6,0,0,0,0
20150306,244.6,244.6,,,,244.6,244.6,0,0,0,0
20150309,244.6,244.6,,,,244.6,244.6,0,0,0,0
20150310,244.6,244.6,,,,244.6,244.6,0,0,0,0
20150311,244.6,244.6,,,,244.6,244.6,0,0,0,0
20150312,244.6,244.6,,,,244.6,244.6,0,0,0,0
20150313,244.6,244.6,,,,244.6,244.6,0,0,0,0
20150316,244.6,244.6,,,,244.6,244.6,0,0,0,0
au1504,20150105,241.9,241.75,240.05,241.4,240.05,241.4,240.8,-.35,-.95,24,30
20150106,241.4,240.8,,,,242.8,242.8,2,2,0,30
20150107,242.8,242.8,,,,242.8,242.8,0,0,0,30
20150108,242.8,242.8,,,,243.25,243.25,.45,.45,0,30
20150109,243.25,243.25,,,,244.05,244.05,.8,.8,0,30
20150112,244.05,244.05,244,244,243.8,243.8,243.85,-.25,-.2,8,30
20150113,243.8,243.85,247.6,247.95,247.6,247.95,247.7,4.1,3.85,6,32
20150114,247.95,247.7,248.7,249,245.85,246.1,247.6,-1.6,-.1,20,30
20150115,246.1,247.6,,,,246.45,246.45,-1.15,-1.15,0,30
20150116,246.45,246.45,252.55,252.55,252.05,252.05,252.3,5.6,5.85,4,30
20150119,252.05,252.3,254.05,257.55,254.05,257.55,255.5,5.25,3.2,10,32
20150120,257.55,255.5,257.4,257.4,256.5,257.1,256.95,1.6,1.45,10,34
20150121,257.1,256.95,258.6,262.3,258.6,262.3,260.85,5.35,3.9,14,30
20150122,262.3,260.85,258.35,259.5,258.3,259.35,258.7,-1.5,-2.15,20,34
20150123,259.35,258.7,259.5,261.85,259.5,260.15,260.4,1.45,1.7,98,102
20150126,260.15,260.4,260.2,261.75,259.2,261.15,260.45,.75,.05,46,106
20150127,261.15,260.45,259.55,259.95,257.8,257.8,259.4,-2.65,-1.05,12,98
20150128,257.8,259.4,260.75,260.75,259.65,259.65,260.2,.25,.8,4,98
20150129,259.65,260.2,259.95,259.95,259.25,259.25,259.6,-.95,-.6,4,98
20150130,259.25,259.6,253.85,253.85,253.85,253.85,253.85,-5.75,-5.75,2,98
20150202,253.85,253.85,255.7,258.85,254.75,258.6,257.8,4.75,3.95,78,116
20150203,258.6,257.8,258.2,258.4,257.05,258.4,257.55,.6,-.25,20,116
20150204,258.4,257.55,257.5,257.6,254.6,254.6,255.9,-2.95,-1.65,24,114
20150205,254.6,255.9,256.25,257.15,256.25,256.7,256.7,.8,.8,26,114
20150206,256.7,256.7,255.75,255.75,255.75,255.75,255.75,-.95,-.95,2,112
20150209,255.75,255.75,256.95,256.95,249.3,250.8,252.65,-4.95,-3.1,120,120
20150210,250.8,252.65,249.65,251.3,249.4,251.3,249.95,-1.35,-2.7,18,118
20150211,251.3,249.95,249.75,249.9,248.55,249.9,249.3,-.05,-.65,40,124
20150212,249.9,249.3,247,247,246.95,247,246.95,-2.3,-2.35,8,130
20150213,247,246.95,245.55,247.65,245.55,247.65,246.5,.7,-.45,8,128
20150216,247.65,246.5,250.3,250.3,248.05,249.15,249.15,2.65,2.65,22,134
20150217,249.15,249.15,249.4,249.4,248.1,248.35,248.85,-.8,-.3,24,126
20150225,248.35,248.85,244.9,244.9,244.15,244.15,244.5,-4.7,-4.35,4,126
20150226,244.15,244.5,243.65,244.85,243.65,244.85,244.3,.35,-.2,20,126
20150227,244.85,244.3,244.6,245.25,244.6,245.15,245.05,.85,.75,60,72
20150302,245.15,245.05,246.5,248,246.5,248,247.55,2.95,2.5,16,60
20150303,248,247.55,245.5,246.3,244.6,245.55,245.4,-2,-2.15,24,62
20150304,245.55,245.4,245.2,245.5,244.35,245.5,245,.1,-.4,14,60
20150305,245.5,245,244.7,244.8,244.05,244.6,244.45,-.4,-.55,14,58
20150306,244.6,244.45,,,,244.45,244.45,0,0,0,58
20150309,244.45,244.45,239.65,239.65,237.35,238.3,238.65,-6.15,-5.8,40,58
20150310,238.3,238.65,236.45,236.7,235.95,236.7,236.3,-1.95,-2.35,26,60
20150311,236.7,236.3,236.2,236.75,236.2,236.75,236.55,.45,.25,6,56
20150312,236.75,236.55,234.45,235.35,234.3,235.35,234.55,-1.2,-2,10,54
20150313,235.35,234.55,,,,234.55,234.55,0,0,0,54
20150316,234.55,234.55,235.1,236.5,235.1,236.5,235.7,1.95,1.15,14,54
20150317,236.5,235.7,236.5,236.5,233.6,234.85,235,-.85,-.7,8,56
20150318,234.85,235,232.6,233.35,232.6,233.35,232.85,-1.65,-2.15,6,58
20150319,233.35,232.85,236.05,236.35,236.05,236.25,236.2,3.4,3.35,44,58
20150320,236.25,236.2,235.3,235.3,235,235,235.15,-1.2,-1.05,4,56
20150323,235,235.15,240.25,246.8,238.15,238.35,239.85,3.2,4.7,60,58
20150324,238.35,239.85,239.05,243.2,235.65,239.75,238.65,-.1,-1.2,22,56
20150325,239.75,238.65,240.35,240.35,238.45,239.45,239.35,.8,.7,30,56
20150326,239.45,239.35,241.95,241.95,237.35,240.65,240.5,1.3,1.15,44,64
20150327,240.65,240.5,238.65,242.6,238.65,240.8,240.85,.3,.35,118,44
20150330,240.8,240.85,239.25,239.3,238.15,238.7,238.95,-2.15,-1.9,38,24
20150331,238.7,238.95,237.5,237.5,237,237,237.1,-1.95,-1.85,8,18
20150401,237,237.1,,,,237.1,237.1,0,0,0,18
20150402,237.1,237.1,240,240,240,240,240,2.9,2.9,6,18
20150403,240,240,,,,240,240,0,0,0,18
20150407,240,240,,,,240,240,0,0,0,18
20150408,240,240,,,,240,240,0,0,0,18
20150409,240,240,,,,240,240,0,0,0,18
20150410,240,240,,,,240,240,0,0,0,18
20150413,240,240,,,,240,240,0,0,0,18
20150414,240,240,238.5,238.5,238.5,238.5,238.5,-1.5,-1.5,18,0
20150415,238.5,238.5,,,,238.5,238.5,0,0,0,0
au1505,20150216,246.5,246.5,245.45,251.8,245.45,251.8,248.6,5.3,2.1,4,2
20150217,251.8,248.6,,,,248.3,248.3,-.3,-.3,0,2
20150225,248.3,248.3,244.05,247.15,243.85,247.15,245.5,-1.15,-2.8,16,2
20150226,247.15,245.5,245.65,246,245.65,246,245.8,.5,.3,4,2
20150227,246,245.8,248.25,248.25,245.15,248.2,246.8,2.4,1,20,4
20150302,248.2,246.8,248.1,250.45,247.35,248.85,248.95,2.05,2.15,100,12
20150303,248.85,248.95,248.95,248.95,244.25,246.65,246.8,-2.3,-2.15,14,14
20150304,246.65,246.8,245.8,248.05,245.5,246.75,247.1,-.05,.3,550,66
20150305,246.75,247.1,245.3,245.3,245.1,245.1,245.2,-2,-1.9,6,60
20150306,245.1,245.2,245.75,245.75,243.2,244.5,243.85,-.7,-1.35,46,40
20150309,244.5,243.85,242.35,242.35,239.1,239.1,240.75,-4.75,-3.1,24,34
20150310,239.1,240.75,,,,240.75,240.75,0,0,0,34
20150311,240.75,240.75,238.3,238.85,237.5,237.5,238.25,-3.25,-2.5,48,36
20150312,237.5,238.25,237.5,237.95,235.15,236.75,236.3,-1.5,-1.95,16,32
20150313,236.75,236.3,237.45,237.45,234.4,236.45,236.6,.15,.3,12,34
20150316,236.45,236.6,235.6,238.15,235.6,236.35,237.05,-.25,.45,54,20
20150317,236.35,237.05,236.8,236.8,235.2,235.2,236.25,-1.85,-.8,90,18
20150318,235.2,236.25,232.15,236.55,232.15,234.8,234.5,-1.45,-1.75,24,22
20150319,234.8,234.5,232.5,238.9,232.5,238.6,236.1,4.1,1.6,24,22
20150320,238.6,236.1,235.55,237.7,235.55,237.35,236.6,1.25,.5,94,26
20150323,237.35,236.6,240.15,240.5,238.25,240.5,239.4,3.9,2.8,16,26
20150324,240.5,239.4,240,240.25,239.7,239.75,239.75,.35,.35,62,66
20150325,239.75,239.75,241.95,242.2,239.9,240,241.1,.25,1.35,32,76
20150326,240,241.1,241.75,243.45,241.1,243.45,241.95,2.35,.85,24,78
20150327,243.45,241.95,241.5,242.95,241.5,241.75,242.15,-.2,.2,20,78
20150330,241.75,242.15,240.1,240.1,240.1,240.1,240.1,-2.05,-2.05,26,52
20150331,240.1,240.1,239.2,239.2,236.1,237.1,237.5,-3,-2.6,14,50
20150401,237.1,237.5,237.95,237.95,237,237,237.6,-.5,.1,20,42
20150402,237,237.6,237.6,241.7,237.6,240.85,240.1,3.25,2.5,14,42
20150403,240.85,240.1,240.5,240.85,239.55,240.6,240.35,.5,.25,12,40
20150407,240.6,240.35,242.45,242.95,242.15,242.95,242.55,2.6,2.2,16,34
20150408,242.95,242.55,243.4,243.4,240.95,242.3,242.35,-.25,-.2,24,34
20150409,242.3,242.35,,,,239.5,239.5,-2.85,-2.85,0,34
20150410,239.5,239.5,251,251,237.55,238.85,240.4,-.65,.9,16,34
20150413,238.85,240.4,241.25,241.8,240.8,240.8,241.35,.4,.95,22,28
20150414,240.8,241.35,240.5,241.3,239.95,239.95,240.45,-1.4,-.9,14,26
20150415,239.95,240.45,239.2,239.2,239.2,239.2,239.2,-1.25,-1.25,2,26
20150416,239.2,239.2,241,241,240,240,240.5,.8,1.3,4,26
20150417,240,240.5,242.05,242.05,235.25,239.55,240.15,-.95,-.35,14,28
20150420,239.55,240.15,241.3,241.4,241.3,241.4,241.3,1.25,1.15,10,24
20150421,241.4,241.3,240.45,240.45,238.5,239.7,239.6,-1.6,-1.7,56,24
20150422,239.7,239.6,239.75,240.95,239.45,240.5,240.25,.9,.65,36,16
20150423,240.5,240.25,240.1,240.1,233.45,237.9,237.3,-2.35,-2.95,22,20
20150424,237.9,237.3,237.8,240.65,233.25,239.05,238.25,1.75,.95,92,34
20150427,239.05,238.25,238,238,236,237.45,237.05,-.8,-1.2,30,26
20150428,237.45,237.05,238,241.45,237.4,240.45,239.2,3.4,2.15,18,24
20150429,240.45,239.2,240.5,243.2,238.95,240.7,241.1,1.5,1.9,34,6
20150430,240.7,241.1,241.85,244.25,236.25,236.25,239.65,-4.85,-1.45,26,6
20150504,236.25,239.65,,,,239.65,239.65,0,0,0,6
20150505,239.65,239.65,,,,239.65,239.65,0,0,0,6
20150506,239.65,239.65,,,,239.65,239.65,0,0,0,6
20150507,239.65,239.65,237.9,237.9,237.9,237.9,237.9,-1.75,-1.75,6,6
20150508,237.9,237.9,,,,237.9,237.9,0,0,0,6
20150511,237.9,237.9,,,,237.9,237.9,0,0,0,6
20150512,237.9,237.9,,,,237.9,237.9,0,0,0,6
20150513,237.9,237.9,,,,237.9,237.9,0,0,0,6
20150514,237.9,237.9,242.05,242.05,242.05,242.05,242.05,4.15,4.15,234,240
20150515,242.05,242.05,,,,242.05,242.05,0,0,0,240
au1506,20150105,241.65,242.65,240,242.5,240,242.15,241.4,-.5,-1.25,61846,199292
20150106,242.15,241.4,240.95,245,240.35,244.45,242.8,3.05,1.4,237512,214248
20150107,244.45,242.8,244.7,247.3,243.8,245.25,245.35,2.45,2.55,237538,214320
20150108,245.25,245.35,245.2,246.2,244.3,244.5,245.2,-.85,-.15,176986,216874
20150109,244.5,245.2,245,246.15,244.55,245.15,245.35,-.05,.15,148366,217668
20150112,245.15,245.35,244.7,248.7,243.95,247.75,246.35,2.4,1,271728,229588
20150113,247.75,246.35,246.35,250,246,249,248.1,2.65,1.75,197054,233632
20150114,249,248.1,249.5,250.5,246.3,247.9,248.5,-.2,.4,249476,229310
20150115,247.9,248.5,248,250.1,246.35,246.75,248.3,-1.75,-.2,288116,227196
20150116,246.75,248.3,251.85,253.75,251,253.65,252.45,5.35,4.15,403772,237232
20150119,253.65,252.45,253.8,259,253.5,257.85,256.7,5.4,4.25,381174,239050
20150120,257.85,256.7,258,258.3,256.85,257.65,257.5,.95,.8,139018,238328
20150121,257.65,257.5,260.55,263,259.15,262.2,260.75,4.7,3.25,294908,239610
20150122,262.2,260.75,262.15,263.2,258.05,259.05,260.5,-1.7,-.25,349310,236052
20150123,259.05,260.5,259.55,262.85,258.95,261.4,261.1,.9,.6,380550,242060
20150126,261.4,261.1,261.6,262.55,259.25,261.6,261.15,.5,.05,237780,242814
20150127,261.6,261.15,259.85,260.6,258.3,259.9,259.45,-1.25,-1.7,225122,244742
20150128,259.9,259.45,259.75,261.95,259.05,260.8,260.55,1.35,1.1,219708,245924
20150129,260.8,260.55,261.2,261.75,258.6,259.3,260,-1.25,-.55,204518,241628
20150130,259.3,260,256.55,257.7,252.75,255.05,255.4,-4.95,-4.6,332588,222422
20150202,255.05,255.4,255.8,260,254.6,259.1,257.45,3.7,2.05,291006,226434
20150203,259.1,257.45,258,259.6,256.75,259.4,258.1,1.95,.65,212940,223518
20150204,259.4,258.1,258,258.2,254.9,256.35,256.35,-1.75,-1.75,288614,228788
20150205,256.35,256.35,257,258.3,255.3,257.5,256.95,1.15,.6,232176,226486
20150206,257.5,256.95,256.05,256.85,255,256.7,256,-.25,-.95,178268,227854
20150209,256.7,256,256.25,260.25,249.7,251.4,252.1,-4.6,-3.9,419660,227334
20150210,251.4,252.1,251.45,252.4,250.6,252.05,251.6,-.05,-.5,140404,223390
20150211,252.05,251.6,251.15,251.45,250,250.8,250.7,-.8,-.9,163350,223966
20150212,250.8,250.7,250.7,250.85,247.35,247.85,248.7,-2.85,-2,204948,224192
20150213,247.85,248.7,248.25,249.65,247.55,249.45,248.45,.75,-.25,179138,215430
20150216,249.45,248.45,248.55,250.75,248.45,250.3,249.75,1.85,1.3,142798,213136
20150217,250.3,249.75,250.15,250.75,248.8,249,250.1,-.75,.35,70090,210000
20150225,249,250.1,245.5,246.55,245.5,246.3,246,-3.8,-4.1,38726,211012
20150226,246.3,246,245.85,246.75,244.1,246.45,245.65,.45,-.35,127444,216280
20150227,246.45,245.65,247.5,248.15,245.7,246.65,246.75,1,1.1,137716,222660
20150302,246.65,246.75,246.3,249.75,246.3,249.3,248.15,2.55,1.4,206588,227628
20150303,249.3,248.15,248.4,249.05,243.85,247.05,246.95,-1.1,-1.2,234398,223844
20150304,247.05,246.95,247.4,248.35,245.75,246.7,246.8,-.25,-.15,198668,210838
20150305,246.7,246.8,246.35,246.9,245,245.65,245.9,-1.15,-.9,162428,202582
20150306,245.65,245.9,245.4,246.9,244.4,245,245.45,-.9,-.45,147354,197516
20150309,245,245.45,244.65,244.85,238.25,239.9,240.8,-5.55,-4.65,327884,202522
20150310,239.9,240.8,239.65,240.3,237.1,237.5,238.8,-3.3,-2,153080,201910
20150311,237.5,238.8,238.7,239.4,237.2,238.25,238.25,-.55,-.55,175340,210238
20150312,238.25,238.25,237.45,238.8,235.05,238.4,236.5,.15,-1.75,251356,205228
20150313,238.4,236.5,236.85,237.9,235.75,237.2,237,.7,.5,145612,205186
20150316,237.2,237,237.5,238.3,236.05,238,236.95,1,-.05,152944,207076
20150317,238,236.95,236.4,237.25,235.65,236.25,236.3,-.7,-.65,155364,212226
20150318,236.25,236.3,235.1,241.35,224.5,233.65,234.85,-2.65,-1.45,334944,207576
20150319,233.65,234.85,233.3,239.55,233.3,237.75,236.2,2.9,1.35,228062,205168
20150320,237.75,236.2,235.75,238.15,235.75,237.4,237,1.2,.8,176958,203432
20150323,237.4,237,236.95,241.1,236.95,240.1,239.7,3.1,2.7,229898,201292
20150324,240.1,239.7,240.2,241.9,239.8,241.1,241,1.4,1.3,167166,200064
20150325,241.1,241,241.85,242.55,240.5,241.15,241.25,.15,.25,262864,199772
20150326,241.15,241.25,243,243.95,242.1,243.9,242.85,2.65,1.6,169740,202018
20150327,243.9,242.85,243.85,244.25,242.75,243.25,243.6,.4,.75,156580,195698
20150330,243.25,243.6,242.8,243.15,240.3,240.4,241.75,-3.2,-1.85,199746,190546
20150331,240.4,241.75,239.3,239.9,237.85,237.85,239,-3.9,-2.75,175542,188526
20150401,237.85,239,239.3,239.65,237.75,238.35,238.75,-.65,-.25,165432,190284
20150402,238.35,238.75,239.95,243.05,239.5,242.95,241.55,4.2,2.8,244050,193926
20150403,242.95,241.55,242.4,242.65,240.2,241.75,241.35,.2,-.2,173668,182772
20150407,241.75,241.35,243.15,244.1,243.15,243.9,243.75,2.55,2.4,48968,183068
20150408,243.9,243.75,243.5,244.2,242.65,243.75,243.55,0,-.2,123654,183796
20150409,243.75,243.55,243,243.65,239.7,240.5,241.75,-3.05,-1.8,185616,180862
20150410,240.5,241.75,240.9,241.2,239.5,240.25,240.1,-1.5,-1.65,134150,180468
20150413,240.25,240.1,242.4,243.6,242,242.65,242.8,2.55,2.7,166920,172632
20150414,242.65,242.8,242.65,243.05,239.15,240.15,241.25,-2.65,-1.55,172328,181184
20150415,240.15,241.25,239.2,242.7,239.05,240.1,240.25,-1.15,-1,159376,176908
20150416,240.1,240.25,240.1,242.6,239.8,241.75,241.15,1.5,.9,162448,172594
20150417,241.75,241.15,242.05,242.15,239.85,240.85,240.8,-.3,-.35,162154,174318
20150420,240.85,240.8,241.3,242.9,240.95,242.75,241.55,1.95,.75,141530,172528
20150421,242.75,241.55,240.45,241.2,239.45,239.9,240.1,-1.65,-1.45,167564,174398
20150422,239.9,240.1,241.05,241.65,240,241.2,240.8,1.1,.7,139054,165958
20150423,241.2,240.8,240.4,240.45,236.95,237.4,238.3,-3.4,-2.5,275116,176366
20150424,237.4,238.3,237.65,239.4,237.2,238.9,238.25,.6,-.05,156290,165370
20150427,238.9,238.25,237.6,238.1,235.5,236.55,236.5,-1.7,-1.75,211312,168400
20150428,236.55,236.5,237.65,242.5,237.35,240.75,240.4,4.25,3.9,264478,140582
20150429,240.75,240.4,241.5,243.65,240.85,242.45,242.6,2.05,2.2,191776,129284
20150430,242.45,242.6,242.3,243.15,240.5,241.2,242,-1.4,-.6,179948,119576
20150504,241.2,242,236.55,237.95,236,237.55,237.3,-4.45,-4.7,60848,110848
20150505,237.55,237.3,237.65,240,237.65,238.5,238.7,1.2,1.4,107084,105984
20150506,238.5,238.7,240.5,240.65,239,239.75,240,1.05,1.3,103940,101680
20150507,239.75,240,240,240.25,237.35,237.45,238.95,-2.55,-1.05,106484,100754
20150508,237.45,238.95,237.05,238.35,236.75,237.95,237.65,-1,-1.3,78760,96638
20150511,237.95,237.65,238.7,239.3,237.7,238.05,238.45,.4,.8,80878,92746
20150512,238.05,238.45,238.55,239.05,236.55,237.45,237.7,-1,-.75,78586,90822
20150513,237.45,237.7,239.65,240,238.3,239.45,239,1.75,1.3,73436,83142
20150514,239.45,239,241.05,243.8,241.05,243.7,242.05,4.7,3.05,117572,76434
20150515,243.7,242.05,243.65,244.7,242.9,243.65,243.65,1.6,1.6,79178,66934
20150518,243.65,243.65,242.95,246.05,242.6,245.4,244.05,1.75,.4,51626,61134
20150519,245.4,244.05,245.4,245.6,243.5,244,244.55,-.05,.5,39960,54194
20150520,244,244.55,242.55,242.85,240.15,240.75,241.55,-3.8,-3,45814,48310
20150521,240.75,241.55,241.75,242.3,241.05,241.6,241.7,.05,.15,20038,46218
20150522,241.6,241.7,240.25,241.5,239.85,241.3,240.65,-.4,-1.05,18188,43114
20150525,241.3,240.65,240.9,241.15,239.95,241,240.6,.35,-.05,20962,36434
20150526,241,240.6,240.9,241.8,238.95,239,240.75,-1.6,.15,16482,32980
20150527,239,240.75,237.95,238.35,236.95,238.05,237.75,-2.7,-3,23322,27348
20150528,238.05,237.75,237.35,237.85,237.05,237.4,237.45,-.35,-.3,13192,22352
20150529,237.4,237.45,237.15,237.5,235.8,236.3,236.9,-1.15,-.55,14308,15418
20150601,236.3,236.9,236.95,237.7,236.05,236.05,236.8,-.85,-.1,4780,12510
20150602,236.05,236.8,236.2,238.3,234.85,235.5,236.05,-1.3,-.75,4080,11622
20150603,235.5,236.05,236.05,236.7,235.6,236.35,236.2,.3,.15,3732,9054
20150604,236.35,236.2,236.2,236.2,234.2,234.35,234.55,-1.85,-1.65,1896,8646
20150605,234.35,234.55,233.85,234.45,232.2,234.3,233.8,-.25,-.75,1368,8148
20150608,234.3,233.8,231.7,234.55,231.35,232.85,232.75,-.95,-1.05,234,8064
20150609,232.85,232.75,232.3,234.05,232.3,234,233.55,1.25,.8,600,7902
20150610,234,233.55,233.65,235.95,233.5,234.7,234.45,1.15,.9,906,7548
20150611,234.7,234.45,235.1,236,235.1,235.8,235.8,1.35,1.35,72,7542
20150612,235.8,235.8,236,236,235.05,235.05,235.5,-.75,-.3,12,7530
20150615,235.05,235.5,234.55,234.55,234.05,234.5,234.35,-1,-1.15,120,7530
au1507,20150416,240.25,240.25,,,,241.15,241.15,.9,.9,0,0
20150417,241.15,241.15,242.5,242.5,237.5,241.3,240.1,.15,-1.05,160,44
20150420,241.3,240.1,242.55,244,241.7,243.4,242.45,3.3,2.35,38,30
20150421,243.4,242.45,238.25,242.45,238.25,239.65,241.2,-2.8,-1.25,22,30
20150422,239.65,241.2,240.95,240.95,240.1,240.35,240.4,-.85,-.8,14,26
20150423,240.35,240.4,238.6,238.75,238.6,238.75,238.65,-1.65,-1.75,6,24
20150424,238.75,238.65,238.7,238.7,238.7,238.7,238.7,.05,.05,4,20
20150427,238.7,238.7,,,,236.95,236.95,-1.75,-1.75,0,20
20150428,236.95,236.95,238.35,243.75,238.35,240.5,241.1,3.55,4.15,12,18
20150429,240.5,241.1,242.8,244.1,239.6,243.3,242.75,2.2,1.65,16,16
20150430,243.3,242.75,242.55,242.55,242.55,242.55,242.55,-.2,-.2,2,18
20150504,242.55,242.55,238.95,239.35,238.95,239.35,239.15,-3.2,-3.4,4,20
20150505,239.35,239.15,240.9,242.3,239.25,240.7,241.05,1.55,1.9,38,36
20150506,240.7,241.05,241.85,241.85,239.8,241.05,241.25,0,.2,16,40
20150507,241.05,241.25,238.75,238.75,238.75,238.75,238.75,-2.5,-2.5,2,40
20150508,238.75,238.75,238.35,239.95,238.3,239.95,238.85,1.2,.1,6,38
20150511,239.95,238.85,239.65,239.65,239.05,239.05,239.35,.2,.5,4,36
20150512,239.05,239.35,239.3,239.3,239.3,239.3,239.3,-.05,-.05,2,36
20150513,239.3,239.3,239.55,241.95,239.45,241.25,240.5,1.95,1.2,124,40
20150514,241.25,240.5,241.25,245,240.2,245,243.1,4.5,2.6,182,20
20150515,245,243.1,,,,244.7,244.7,1.6,1.6,0,20
20150518,244.7,244.7,244.6,247.95,244.6,247.05,246.1,2.35,1.4,22,24
20150519,247.05,246.1,247.35,247.35,244.95,244.95,246.15,-1.15,.05,4,28
20150520,244.95,246.15,243.5,243.5,243.5,243.5,243.5,-2.65,-2.65,2,28
20150521,243.5,243.5,242.95,244,242,242.55,243.1,-.95,-.4,20,26
20150522,242.55,243.1,241.1,241.1,241.1,241.1,241.1,-2,-2,2,26
20150525,241.1,241.1,240.45,242.3,240.45,241.05,241.25,-.05,.15,14,28
20150526,241.05,241.25,,,,241.4,241.4,.15,.15,0,28
20150527,241.4,241.4,,,,238.4,238.4,-3,-3,0,28
20150528,238.4,238.4,238.8,239.7,238.25,239.7,238.9,1.3,.5,6,30
20150529,239.7,238.9,236.4,239.65,236.4,238.65,239,-.25,.1,28,38
20150601,238.65,239,239.85,239.85,239.85,239.85,239.85,.85,.85,2,40
20150602,239.85,239.85,241.9,241.9,237.05,238,238.45,-1.85,-1.4,26,48
20150603,238,238.45,,,,238.6,238.6,.15,.15,0,48
20150604,238.6,238.6,,,,236.9,236.9,-1.7,-1.7,0,48
20150605,236.9,236.9,236.45,237.25,236.05,236.4,236.8,-.5,-.1,54,76
20150608,236.4,236.8,233.75,236.5,233.75,235.85,235.3,-.95,-1.5,48,94
20150609,235.85,235.3,235.35,235.85,235.35,235.5,235.65,.2,.35,30,108
20150610,235.5,235.65,234.85,237.2,234.85,236.1,236,.45,.35,34,110
20150611,236.1,236,237.9,238.2,236.25,238.2,237.7,2.2,1.7,14,106
20150612,238.2,237.7,,,,237.4,237.4,-.3,-.3,0,106
20150615,237.4,237.4,237.4,237.95,235.4,236.65,236.75,-.75,-.65,28,110
20150616,236.65,236.75,237.25,237.8,236.6,237.55,237.25,.8,.5,28,106
20150617,237.55,237.25,235.15,238,231.9,234.35,234.35,-2.9,-2.9,56,108
20150618,234.35,234.35,237.05,237.4,237.05,237.4,237.15,3.05,2.8,12,104
20150619,237.4,237.15,239.4,241.8,238.5,239,239.65,1.85,2.5,54,90
20150623,239,239.65,239.35,239.35,234.45,237.85,237.5,-1.8,-2.15,70,84
20150624,237.85,237.5,234.9,235.95,234.35,235.95,235.25,-1.55,-2.25,8,80
20150625,235.95,235.25,241.1,241.1,230.05,235.3,235.4,.05,.15,52,72
20150626,235.3,235.4,238.95,238.95,234.05,235,235.3,-.4,-.1,42,74
20150629,235,235.3,236.05,236.7,234.1,236.7,235.55,1.4,.25,44,60
20150630,236.7,235.55,241.4,241.4,229.9,234.05,236.1,-1.5,.55,82,48
20150701,234.05,236.1,228.05,233,228.05,233,231.75,-3.1,-4.35,24,30
20150702,233,231.75,,,,231.75,231.75,0,0,0,30
20150703,231.75,231.75,,,,231.75,231.75,0,0,0,30
20150706,231.75,231.75,,,,231.75,231.75,0,0,0,30
20150707,231.75,231.75,232.5,235,232.5,235,233.75,3.25,2,12,24
20150708,235,233.75,223.4,223.4,223.2,223.2,223.3,-10.55,-10.45,12,24
20150709,223.2,223.3,230.95,230.95,230.95,230.95,230.95,7.65,7.65,12,24
20150710,230.95,230.95,229.95,235.9,229.95,230.5,232.65,-.45,1.7,42,24
20150713,230.5,232.65,,,,232.65,232.65,0,0,0,24
20150714,232.65,232.65,,,,232.65,232.65,0,0,0,24
20150715,232.65,232.65,,,,232.65,232.65,0,0,0,24
au1508,20150105,242.6,243.15,241.4,242,241.4,242,241.6,-1.15,-1.55,8,40
20150106,242,241.6,244,245.4,244,245.4,244.65,3.8,3.05,10,40
20150107,245.4,244.65,245.1,245.15,245.1,245.15,245.1,.5,.45,4,36
20150108,245.15,245.1,,,,245.1,245.1,0,0,0,36
20150109,245.1,245.1,245.35,245.9,245.35,245.55,245.65,.45,.55,12,42
20150112,245.55,245.65,245.55,249.05,244.4,249.05,247.35,3.4,1.7,44,42
20150113,249.05,247.35,247.55,250.35,247.5,249.15,249.1,1.8,1.75,50,58
20150114,249.15,249.1,249.15,250.35,246.8,248.15,248.6,-.95,-.5,70,50
20150115,248.15,248.6,248.45,250.25,247.3,247.3,249.2,-1.3,.6,24,44
20150116,247.3,249.2,252.25,253.35,251.5,253.3,252.55,4.1,3.35,88,92
20150119,253.3,252.55,256.3,258,256.3,258,257.35,5.45,4.8,26,96
20150120,258,257.35,257.65,258,257.1,258,257.6,.65,.25,34,80
20150121,258,257.6,259.5,263.15,259.5,262.25,260.7,4.65,3.1,36,94
20150122,262.25,260.7,263.2,263.2,259.4,259.4,260.95,-1.3,.25,176,92
20150123,259.4,260.95,259.7,262.45,259.7,261.35,261.6,.4,.65,26,92
20150126,261.35,261.6,,,,261.6,261.6,0,0,0,92
20150127,261.6,261.6,259.25,259.75,259.2,259.2,259.35,-2.4,-2.25,28,90
20150128,259.2,259.35,259.85,260.6,259.85,260.2,260.1,.85,.75,8,88
20150129,260.2,260.1,,,,259.8,259.8,-.3,-.3,0,88
20150130,259.8,259.8,257.65,257.65,253.95,254.85,255.75,-4.95,-4.05,22,84
20150202,254.85,255.75,,,,258.8,258.8,3.05,3.05,0,84
20150203,258.8,258.8,258.1,259.2,258.1,259,258.6,.2,-.2,18,84
20150204,259,258.6,255.6,256.05,255.6,256.05,255.85,-2.55,-2.75,6,82
20150205,256.05,255.85,258.5,258.5,258.1,258.1,258.3,2.25,2.45,4,80
20150206,258.1,258.3,257.2,257.2,256.9,256.9,257.05,-1.4,-1.25,6,80
20150209,256.9,257.05,257.25,257.25,251.2,252.1,253.2,-4.95,-3.85,94,62
20150210,252.1,253.2,252.1,252.75,252.1,252.75,252.4,-.45,-.8,4,62
20150211,252.75,252.4,252.75,252.75,251,251,252,-1.4,-.4,22,60
20150212,251,252,248.85,248.85,248.1,248.85,248.45,-3.15,-3.55,32,52
20150213,248.85,248.45,,,,248.75,248.75,.3,.3,0,52
20150216,248.75,248.75,250.1,250.1,250.1,250.1,250.1,1.35,1.35,2,50
20150217,250.1,250.1,250.95,251.15,250.2,250.2,250.7,.1,.6,22,48
20150225,250.2,250.7,,,,248.6,248.6,-2.1,-2.1,0,48
20150226,248.6,248.6,246.35,246.7,246.35,246.7,246.5,-1.9,-2.1,4,46
20150227,246.7,246.5,247.8,247.8,246.8,247.75,247.6,1.25,1.1,12,50
20150302,247.75,247.6,247.4,250.2,247.4,250.2,249.1,2.6,1.5,10,48
20150303,250.2,249.1,248.7,248.7,247.55,247.8,247.85,-1.3,-1.25,14,44
20150304,247.8,247.85,,,,247.85,247.85,0,0,0,44
20150305,247.85,247.85,,,,247.85,247.85,0,0,0,44
20150306,247.85,247.85,,,,247.85,247.85,0,0,0,44
20150309,247.85,247.85,,,,245,245,-2.85,-2.85,0,44
20150310,245,245,240.4,240.4,238.65,238.65,239.55,-6.35,-5.45,220,238
20150311,238.65,239.55,,,,239.55,239.55,0,0,0,238
20150312,239.55,239.55,237.45,239.45,237.25,239.45,237.75,-.1,-1.8,14,236
20150313,239.45,237.75,238.15,238.95,238.15,238.9,238.6,1.15,.85,10,236
20150316,238.9,238.6,238.5,238.65,238.5,238.65,238.55,.05,-.05,4,236
20150317,238.65,238.55,238.45,238.65,237.7,238.3,238.2,-.25,-.35,64,242
20150318,238.3,238.2,236.1,238.45,235.05,235.45,236.65,-2.75,-1.55,20,240
20150319,235.45,236.65,236.25,240.8,235.55,239.65,238.3,3,1.65,86,266
20150320,239.65,238.3,238.25,239.4,238.25,238.85,238.9,.55,.6,104,276
20150323,238.85,238.9,241.15,241.95,241.15,241.75,241.3,2.85,2.4,32,278
20150324,241.75,241.3,241.7,243.2,241,241.8,241.25,.5,-.05,320,206
20150325,241.8,241.25,241.65,243,241.2,242.1,242.1,.85,.85,22,202
20150326,242.1,242.1,243.1,244.05,243.1,244.05,243.6,1.95,1.5,42,168
20150327,244.05,243.6,244.3,244.45,243.6,243.8,244.1,.2,.5,18,156
20150330,243.8,244.1,243.1,243.1,241.55,241.55,242.05,-2.55,-2.05,8,156
20150331,241.55,242.05,240.25,240.25,238.35,238.35,239.25,-3.7,-2.8,38,140
20150401,238.35,239.25,239.7,240.35,238.9,239.75,239.55,.5,.3,54,144
20150402,239.75,239.55,239.75,243.1,239.75,243.05,241.5,3.5,1.95,68,142
20150403,243.05,241.5,242.7,242.7,240.85,241.8,241.8,.3,.3,16,134
20150407,241.8,241.8,244,244,244,244,244,2.2,2.2,2,134
20150408,244,244,244.15,244.15,243.3,243.3,243.7,-.7,-.3,14,138
20150409,243.3,243.7,241.65,241.65,241.65,241.65,241.65,-2.05,-2.05,4,134
20150410,241.65,241.65,240.85,241.25,240.85,241.25,241.1,-.4,-.55,6,134
20150413,241.25,241.1,242.95,243.95,242.95,243,243.25,1.9,2.15,10,136
20150414,243,243.25,242.85,242.85,240.25,240.25,241.65,-3,-1.6,20,134
20150415,240.25,241.65,241.8,241.8,240.7,240.8,241.4,-.85,-.25,62,130
20150416,240.8,241.4,242.1,242.1,242.1,242.1,242.1,.7,.7,6,134
20150417,242.1,242.1,242.1,242.6,240.95,241.45,241.55,-.65,-.55,22,126
20150420,241.45,241.55,241.45,242.85,241.45,242.85,242,1.3,.45,22,126
20150421,242.85,242,241.1,241.1,240.45,240.8,240.85,-1.2,-1.15,16,126
20150422,240.8,240.85,241.7,241.75,241.7,241.75,241.7,.9,.85,4,126
20150423,241.75,241.7,239,239.55,238,238,238.85,-3.7,-2.85,164,138
20150424,238,238.85,238.6,239.8,237.5,239.8,239,.95,.15,92,128
20150427,239.8,239,237.45,238.25,236.4,237.7,237.1,-1.3,-1.9,142,190
20150428,237.7,237.1,238.35,242.35,238.35,241.35,241.35,4.25,4.25,186,108
20150429,241.35,241.35,243.85,243.85,243.1,243.65,243.55,2.3,2.2,118,150
20150430,243.65,243.55,244,244,242.2,242.35,243.3,-1.2,-.25,110,122
20150504,242.35,243.3,236.9,239.2,236.9,239.15,238.5,-4.15,-4.8,84,144
20150505,239.15,238.5,240.45,240.7,239.55,240.2,240.1,1.7,1.6,54,160
20150506,240.2,240.1,241.75,242.15,241.25,241.5,241.55,1.4,1.45,28,152
20150507,241.5,241.55,242.1,242.1,239.65,239.75,240.4,-1.8,-1.15,30,150
20150508,239.75,240.4,237.75,239.25,237.75,239.2,238.45,-1.2,-1.95,20,156
20150511,239.2,238.45,240.55,240.55,239.3,240.05,239.6,1.6,1.15,38,168
20150512,240.05,239.6,240.7,240.7,238.5,238.6,238.95,-1,-.65,38,172
20150513,238.6,238.95,240.55,241.05,240.3,241.05,240.55,2.1,1.6,28,156
20150514,241.05,240.55,243.8,245.7,242.55,244.45,244.05,3.9,3.5,100,140
20150515,244.45,244.05,245.45,246.25,245.05,245.05,245.4,1,1.35,46,144
20150518,245.05,245.4,245.15,247.85,245.15,247.6,246.65,2.2,1.25,60,154
20150519,247.6,246.65,246.85,247.85,245.5,245.75,246.6,-.9,-.05,128,144
20150520,245.75,246.6,243.9,243.9,242.55,242.6,242.85,-4,-3.75,22,142
20150521,242.6,242.85,243.3,243.3,242.95,242.95,243.15,.1,.3,8,144
20150522,242.95,243.15,241.8,242.5,241.8,242.5,242.05,-.65,-1.1,18,152
20150525,242.5,242.05,242.5,242.5,241.65,242.2,242.25,.15,.2,10,144
20150526,242.2,242.25,242.5,242.5,241.55,241.55,242.15,-.7,-.1,14,146
20150527,241.55,242.15,238.95,239.8,238,239.8,239,-2.35,-3.15,36,150
20150528,239.8,239,238.95,239.05,238.9,239,238.95,0,-.05,18,146
20150529,239,238.95,237.9,239.75,237.9,239.5,239.1,.55,.15,28,148
20150601,239.5,239.1,239.65,240.75,238.55,239.25,239.8,.15,.7,24,150
20150602,239.25,239.8,239.25,243.15,238.25,238.8,240.5,-1,.7,166,174
20150603,238.8,240.5,239.2,240,238.3,238.8,239.35,-1.7,-1.15,140,196
20150604,238.8,239.35,239.35,239.35,236.9,237.55,237.9,-1.8,-1.45,28,198
20150605,237.55,237.9,236.25,237.2,235.6,236.2,236.35,-1.7,-1.55,58,210
20150608,236.2,236.35,233.75,236.85,233.75,235.85,235.6,-.5,-.75,106,252
20150609,235.85,235.6,236.1,236.35,235.75,236.35,235.95,.75,.35,108,290
20150610,236.35,235.95,236.95,237.15,236.1,237.15,236.65,1.2,.7,84,288
20150611,237.15,236.65,238.75,238.75,237.05,237.5,238,.85,1.35,32,284
20150612,237.5,238,237.1,237.2,236.2,236.7,236.85,-1.3,-1.15,44,284
20150615,236.7,236.85,235.6,237,235.6,236.35,236.5,-.5,-.35,48,284
20150616,236.35,236.5,237.3,238.05,236.25,237.75,237.1,1.25,.6,80,282
20150617,237.75,237.1,236.85,237.2,235.2,236,235.9,-1.1,-1.2,88,286
20150618,236,235.9,236.5,238.05,225.45,237.35,236.4,1.45,.5,224,248
20150619,237.35,236.4,246.6,247.3,238.3,239.35,240.4,2.95,4,214,246
20150623,239.35,240.4,236.75,237.7,236.75,237,237.3,-3.4,-3.1,46,240
20150624,237,237.3,236.1,236.3,235.3,236,235.75,-1.3,-1.55,44,244
20150625,236,235.75,235,236,234.8,235.4,235.25,-.35,-.5,34,244
20150626,235.4,235.25,235,235.35,235,235.35,235.25,.1,0,16,250
20150629,235.35,235.25,235.2,237.05,234.85,236.85,236.15,1.6,.9,24,248
20150630,236.85,236.15,235.85,236.8,233.8,233.8,235.55,-2.35,-.6,42,236
20150701,233.8,235.55,234,235.9,233.85,234.65,234.75,-.9,-.8,112,240
20150702,234.65,234.75,234,234.1,232.75,233.15,233.45,-1.6,-1.3,24,238
20150703,233.15,233.45,231.85,233.6,231.85,233.6,232.85,.15,-.6,18,242
20150706,233.6,232.85,233.4,234.05,232.6,233.25,233.1,.4,.25,116,298
20150707,233.25,233.1,232.5,233.3,232,233.15,232.85,.05,-.25,36,302
20150708,233.15,232.85,229.35,231.7,226.9,229,229.5,-3.85,-3.35,368,268
20150709,229,229.5,230.8,235,230.8,233.35,233.3,3.85,3.8,268,220
20150710,233.35,233.3,233.3,233.6,231.4,233.05,232.75,-.25,-.55,18,212
20150713,233.05,232.75,231.65,233.7,231.65,233,232.95,.25,.2,22,210
20150714,233,232.95,229.9,232.85,229.85,230.9,231.35,-2.05,-1.6,152,170
20150715,230.9,231.35,231.15,232.15,230.75,230.85,231.35,-.5,0,12,166
20150716,230.85,231.35,229.25,231.1,228.45,229.8,229.85,-1.55,-1.5,144,208
20150717,229.8,229.85,229.95,229.95,228.6,228.6,229.35,-1.25,-.5,84,170
20150720,228.6,229.35,225.65,227.05,220.9,223.65,223.05,-5.7,-6.3,62,158
20150721,223.65,223.05,221.45,223.7,219.85,220.2,221.15,-2.85,-1.9,96,160
20150722,220.2,221.15,221.65,221.7,218,219.05,220.15,-2.1,-1,52,164
20150723,219.05,220.15,219.05,220.6,215.05,219.15,218.45,-1,-1.7,80,170
20150724,219.15,218.45,218.25,219.15,215.05,216.4,216.4,-2.05,-2.05,38,162
20150727,216.4,216.4,217.15,221.45,212.35,219.4,219.1,3,2.7,84,164
20150728,219.4,219.1,219.75,221.95,217.85,217.85,219.75,-1.25,.65,30,152
20150729,217.85,219.75,218.9,220.4,218.5,218.55,219.35,-1.2,-.4,22,152
20150730,218.55,219.35,219.45,221.85,215.65,217,217.8,-2.35,-1.55,100,82
20150731,217,217.8,219.35,219.95,214.4,215.5,216.55,-2.3,-1.25,90,78
20150803,215.5,216.55,212.4,217.8,212.25,216.2,214.95,-.35,-1.6,48,90
20150804,216.2,214.95,,,,214.95,214.95,0,0,0,90
20150805,214.95,214.95,218.75,218.75,216.7,217.85,217.5,2.9,2.55,30,84
20150806,217.85,217.5,216,216,216,216,216,-1.5,-1.5,6,78
20150807,216,216,,,,216,216,0,0,0,78
20150810,216,216,213.5,218.4,213.5,218.4,215.95,2.4,-.05,12,72
20150811,218.4,215.95,223.95,223.95,217.6,221.9,221.15,5.95,5.2,18,72
20150812,221.9,221.15,226.15,226.15,226.15,226.15,226.15,5,5,6,72
20150813,226.15,226.15,,,,226.15,226.15,0,0,0,72
20150814,226.15,226.15,,,,229,229,2.85,2.85,0,72
20150817,229,229,,,,229,229,0,0,0,72
au1509,20150616,236.5,236.5,239.45,241.95,233.55,238.45,238.85,1.95,2.35,18,2
20150617,238.45,238.85,238.9,238.9,234.25,234.25,237.35,-4.6,-1.5,6,4
20150618,234.25,237.35,,,,237.35,237.35,0,0,0,4
20150619,237.35,237.35,238.95,243.85,238.6,243.5,242.6,6.15,5.25,24,22
20150623,243.5,242.6,241.65,241.65,238,239,239.55,-3.6,-3.05,14,22
20150624,239,239.55,236.95,239.35,235.85,237.15,237.65,-2.4,-1.9,56,40
20150625,237.15,237.65,238.2,238.2,234.05,235.15,236.8,-2.5,-.85,110,46
20150626,235.15,236.8,236.95,236.95,235.4,236.05,236.05,-.75,-.75,22,36
20150629,236.05,236.05,238.1,239.2,237.05,238.05,237.85,2,1.8,10,38
20150630,238.05,237.85,239.5,239.5,237.15,237.25,237.95,-.6,.1,6,36
20150701,237.25,237.95,236.35,236.35,236.35,236.35,236.35,-1.6,-1.6,2,34
20150702,236.35,236.35,233.25,233.25,233.25,233.25,233.25,-3.1,-3.1,10,44
20150703,233.25,233.25,235.35,235.6,235.35,235.6,235.35,2.35,2.1,12,36
20150706,235.6,235.35,236.6,236.6,236.5,236.5,236.55,1.15,1.2,4,38
20150707,236.5,236.55,,,,236.3,236.3,-.25,-.25,0,38
20150708,236.3,236.3,224.55,234.35,224.55,230.35,231.2,-5.95,-5.1,72,42
20150709,230.35,231.2,220.25,237.2,220.25,234.8,232.65,3.6,1.45,44,42
20150710,234.8,232.65,235.8,236.1,231,233.55,234.15,.9,1.5,130,38
20150713,233.55,234.15,236.05,236.05,231,235.25,233.75,1.1,-.4,22,36
20150714,235.25,233.75,232.65,232.65,230.1,231.15,231.4,-2.6,-2.35,8,42
20150715,231.15,231.4,232.45,232.8,231.1,232.2,232.1,.8,.7,8,40
20150716,232.2,232.1,230.65,231.15,229.15,231.15,229.95,-.95,-2.15,14,36
20150717,231.15,229.95,231.95,231.95,229.25,229.25,230.25,-.7,.3,6,34
20150720,229.25,230.25,225.05,230.8,219.8,224.4,225.5,-5.85,-4.75,146,38
20150721,224.4,225.5,219.45,224.45,219.45,222.7,221.85,-2.8,-3.65,20,36
20150722,222.7,221.85,218.05,222.95,213.95,218.7,220.3,-3.15,-1.55,274,40
20150723,218.7,220.3,220.15,221.55,217.6,220.25,219.55,-.05,-.75,44,44
20150724,220.25,219.55,219.25,221.9,216.15,217.65,218.45,-1.9,-1.1,142,42
20150727,217.65,218.45,218.1,222.3,214.2,221.6,219.65,3.15,1.2,274,56
20150728,221.6,219.65,220.25,221,216.55,220.5,219.85,.85,.2,34,44
20150729,220.5,219.85,217.05,222.5,217.05,220.55,219.9,.7,.05,24,48
20150730,220.55,219.9,219.65,220.25,217.65,217.85,218.5,-2.05,-1.4,58,88
20150731,217.85,218.5,218.8,219.75,217.05,219.75,218.25,1.25,-.25,22,80
20150803,219.75,218.25,218.25,222,217.05,219.65,219.35,1.4,1.1,42,64
20150804,219.65,219.35,221.25,221.25,216.8,216.85,218.2,-2.5,-1.15,40,72
20150805,216.85,218.2,219,220.95,217.05,217.05,218.3,-1.15,.1,28,70
20150806,217.05,218.3,217.65,218.25,216.85,217.3,217.45,-1,-.85,28,64
20150807,217.3,217.45,218,218,218,218,218,.55,.55,2,64
20150810,218,218,,,,218.8,218.8,.8,.8,0,64
20150811,218.8,218.8,222.6,225.95,221.95,224.25,223.6,5.45,4.8,28,72
20150812,224.25,223.6,229.35,233.75,223.95,233.2,229.1,9.6,5.5,104,72
20150813,233.2,229.1,231.5,235.95,231.5,232.25,233.7,3.15,4.6,88,74
20150814,232.25,233.7,229.45,234.45,228.4,229.7,231.75,-4,-1.95,110,78
20150817,229.7,231.75,231.9,232.7,227.55,231.9,230.25,.15,-1.5,122,92
20150818,231.9,230.25,232.35,232.5,230.1,230.4,230.95,.15,.7,62,72
20150819,230.4,230.95,227.05,230.95,227.05,230.3,229.75,-.65,-1.2,26,72
20150820,230.3,229.75,229.75,238.3,229.75,235.15,233.9,5.4,4.15,168,48
20150821,235.15,233.9,232.45,243.2,232.45,238.05,238.9,4.15,5,152,64
20150824,238.05,238.9,237.55,241.8,237.1,238.85,239.4,-.05,.5,252,106
20150825,238.85,239.4,238.05,242.95,236.3,237.65,238.9,-1.75,-.5,196,128
20150826,237.65,238.9,239.55,239.55,229.7,235,235.9,-3.9,-3,322,94
20150827,235,235.9,234,234,230.1,232.65,233,-3.25,-2.9,118,126
20150828,232.65,233,233.3,236.85,230.35,233.65,232.45,.65,-.55,136,92
20150831,233.65,232.45,233.6,235.6,231.35,234.2,234.2,1.75,1.75,102,12
20150901,234.2,234.2,238.9,238.9,238.9,238.9,238.9,4.7,4.7,12,12
20150902,238.9,238.9,238,238,237.8,237.8,237.85,-1.1,-1.05,18,6
20150907,237.8,237.85,228,228,228,228,228,-9.85,-9.85,6,0
20150908,228,228,,,,228,228,0,0,0,0
20150909,228,228,,,,228,228,0,0,0,0
20150910,228,228,,,,228,228,0,0,0,0
20150911,228,228,,,,228,228,0,0,0,0
20150914,228,228,,,,228,228,0,0,0,0
20150915,228,228,,,,228,228,0,0,0,0
au1510,20150105,243.25,243.85,241.65,242.65,241.6,242.65,241.85,-1.2,-2,18,62
20150106,242.65,241.85,241.8,244.8,241.8,244.8,243.7,2.95,1.85,22,66
20150107,244.8,243.7,245.6,248.65,245,246.15,247.3,2.45,3.6,54,56
20150108,246.15,247.3,246,246.8,246,246.25,246.15,-1.05,-1.15,12,56
20150109,246.25,246.15,246.15,246.15,245.65,245.85,245.85,-.3,-.3,12,46
20150112,245.85,245.85,247.95,249.15,247.95,249.15,248.5,3.3,2.65,12,42
20150113,249.15,248.5,249.9,250.2,249.5,249.5,249.8,1,1.3,10,42
20150114,249.5,249.8,246.9,246.9,246.9,246.9,246.9,-2.9,-2.9,2,42
20150115,246.9,246.9,248.75,248.75,247.35,247.35,247.8,.45,.9,14,44
20150116,247.35,247.8,252.65,253.8,252,253.8,252.75,6,4.95,28,48
20150119,253.8,252.75,258.45,258.55,257.15,257.95,258.05,5.2,5.3,28,48
20150120,257.95,258.05,258.15,258.2,257.75,257.75,258.05,-.3,0,8,44
20150121,257.75,258.05,261.8,263.3,260.45,263.15,262.1,5.1,4.05,16,40
20150122,263.15,262.1,260,260.75,259.75,259.75,260.2,-2.35,-1.9,10,46
20150123,259.75,260.2,262.1,263.5,261.25,262.8,262.55,2.6,2.35,20,50
20150126,262.8,262.55,262.8,262.8,262.25,262.5,262.45,-.05,-.1,8,44
20150127,262.5,262.45,259.5,259.9,259.2,259.2,259.5,-3.25,-2.95,18,50
20150128,259.2,259.5,261.45,261.45,261.45,261.45,261.45,1.95,1.95,2,50
20150129,261.45,261.45,261.55,261.55,259.6,259.6,261.2,-1.85,-.25,14,38
20150130,259.6,261.2,256.35,256.35,254.4,255.7,255.2,-5.5,-6,12,40
20150202,255.7,255.2,258.6,258.6,258.6,258.6,258.6,3.4,3.4,2,40
20150203,258.6,258.6,258.95,259.2,258.7,259.2,259,.6,.4,18,46
20150204,259.2,259,258,258,255.75,256.25,256.3,-2.75,-2.7,22,44
20150205,256.25,256.3,258.2,258.6,257.25,258.05,258.1,1.75,1.8,14,40
20150206,258.05,258.1,256.85,257.5,255.1,257.5,256.45,-.6,-1.65,12,50
20150209,257.5,256.45,258.1,258.1,249.15,251.85,252.65,-4.6,-3.8,52,58
20150210,251.85,252.65,251.95,253.3,251.75,252.9,252.65,.25,0,18,56
20150211,252.9,252.65,251.35,251.35,251.3,251.3,251.3,-1.35,-1.35,4,54
20150212,251.3,251.3,250.9,250.9,250,250,250.45,-1.3,-.85,4,52
20150213,250,250.45,249.9,249.9,249.9,249.9,249.9,-.55,-.55,2,50
20150216,249.9,249.9,,,,249.9,249.9,0,0,0,50
20150217,249.9,249.9,251.05,251.05,251.05,251.05,251.05,1.15,1.15,6,52
20150225,251.05,251.05,247.05,247.05,247.05,247.05,247.05,-4,-4,4,52
20150226,247.05,247.05,246.65,246.65,246.2,246.65,246.45,-.4,-.6,12,52
20150227,246.65,246.45,247.5,247.5,247.5,247.5,247.5,1.05,1.05,2,54
20150302,247.5,247.5,251.2,251.2,251.2,251.2,251.2,3.7,3.7,4,50
20150303,251.2,251.2,246.2,249.65,246.2,248.3,247.7,-2.9,-3.5,8,50
20150304,248.3,247.7,248.55,248.55,248.25,248.25,248.4,.55,.7,4,54
20150305,248.25,248.4,246.7,247.2,246.45,247.2,246.75,-1.2,-1.65,6,52
20150306,247.2,246.75,246.4,247.1,246.3,246.3,246.6,-.45,-.15,6,48
20150309,246.3,246.6,245,245,240.25,241.1,241.2,-5.5,-5.4,36,58
20150310,241.1,241.2,240.2,240.5,238.7,238.7,239.45,-2.5,-1.75,38,66
20150311,238.7,239.45,240.2,240.2,239.1,239.1,239.8,-.35,.35,18,64
20150312,239.1,239.8,237.65,239.4,237.55,239.4,237.95,-.4,-1.85,10,66
20150313,239.4,237.95,240.2,240.2,240.2,240.2,240.2,2.25,2.25,2,64
20150316,240.2,240.2,238.8,238.8,238.45,238.45,238.6,-1.75,-1.6,4,64
20150317,238.45,238.6,,,,238.6,238.6,0,0,0,64
20150318,238.6,238.6,,,,238.6,238.6,0,0,0,64
20150319,238.6,238.6,,,,238.6,238.6,0,0,0,64
20150320,238.6,238.6,239.6,240.55,239.6,240.55,240.2,1.95,1.6,6,66
20150323,240.55,240.2,240.9,242.75,240.85,242.25,241.7,2.05,1.5,18,72
20150324,242.25,241.7,,,,241.7,241.7,0,0,0,72
20150325,241.7,241.7,243.55,243.55,242.2,242.3,242.75,.6,1.05,14,72
20150326,242.3,242.75,243.6,243.6,243.4,243.45,243.45,.7,.7,20,72
20150327,243.45,243.45,244.7,244.7,243.45,243.45,243.85,0,.4,6,72
20150330,243.45,243.85,,,,243.85,243.85,0,0,0,72
20150331,243.85,243.85,239.4,239.4,239.4,239.4,239.4,-4.45,-4.45,2,70
20150401,239.4,239.4,239.45,239.9,239.1,239.75,239.45,.35,.05,10,74
20150402,239.75,239.45,240.9,243.8,240.8,243.8,242.55,4.35,3.1,32,70
20150403,243.8,242.55,242.05,242.05,242.05,242.05,242.05,-.5,-.5,2,70
20150407,242.05,242.05,245.05,245.1,244.75,244.75,244.95,2.7,2.9,6,66
20150408,244.75,244.95,244.9,244.9,244.9,244.9,244.9,-.05,-.05,4,62
20150409,244.9,244.9,242,244.75,239,241.95,241.45,-2.95,-3.45,1062,88
20150410,241.95,241.45,241.05,241.05,241.05,241.05,241.05,-.4,-.4,6,82
20150413,241.05,241.05,,,,241.05,241.05,0,0,0,82
20150414,241.05,241.05,241.8,244.2,241.2,241.2,242.85,.15,1.8,202,84
20150415,241.2,242.85,242.35,242.35,241,241.1,242.05,-1.75,-.8,68,84
20150416,241.1,242.05,241.35,243.7,241.15,242.55,242.4,.5,.35,30,78
20150417,242.55,242.4,241.85,242.05,241.55,241.9,241.8,-.5,-.6,12,76
20150420,241.9,241.8,243,243,242.3,242.3,242.65,.5,.85,4,72
20150421,242.3,242.65,,,,241.5,241.5,-1.15,-1.15,0,72
20150422,241.5,241.5,241.75,241.9,241.7,241.9,241.8,.4,.3,20,74
20150423,241.9,241.8,239,239.2,238.6,238.6,238.9,-3.2,-2.9,10,68
20150424,238.6,238.9,239.7,241.15,239.6,241.15,240.4,2.25,1.5,52,92
20150427,241.15,240.4,238.85,239.65,237.3,238.95,238.55,-1.45,-1.85,108,86
20150428,238.95,238.55,241.8,244.35,241.35,242.8,242.5,4.25,3.95,46,86
20150429,242.8,242.5,244.8,245.6,243.5,244.25,244.4,1.75,1.9,48,80
20150430,244.25,244.4,244.25,244.25,243,243.45,243.75,-.95,-.65,34,82
20150504,243.45,243.75,238.9,240,237.9,239.6,239.35,-4.15,-4.4,44,90
20150505,239.6,239.35,241.1,241.6,240.3,240.35,240.7,1,1.35,26,88
20150506,240.35,240.7,242.75,242.9,242,242.3,242.4,1.6,1.7,18,92
20150507,242.3,242.4,240.75,240.75,240.25,240.25,240.5,-2.15,-1.9,4,96
20150508,240.25,240.5,240.25,252,238.75,240,244.7,-.5,4.2,470,136
20150511,240,244.7,240.85,241.75,239.9,240.5,240.8,-4.2,-3.9,68,114
20150512,240.5,240.8,239.1,240,239.1,239.35,239.55,-1.45,-1.25,56,114
20150513,239.35,239.55,241.35,241.55,240.5,240.85,240.9,1.3,1.35,30,98
20150514,240.85,240.9,244.9,246,243.85,245.65,245.35,4.75,4.45,530,190
20150515,245.65,245.35,246.25,246.7,245.2,245.5,245.9,.15,.55,92,138
20150518,245.5,245.9,245.95,248.65,245.7,248.65,246.85,2.75,.95,36,132
20150519,248.65,246.85,247.4,247.95,246.45,246.75,247.15,-.1,.3,58,112
20150520,246.75,247.15,245.6,245.6,243.1,243.35,244.1,-3.8,-3.05,64,112
20150521,243.35,244.1,244.45,244.8,243.9,244.15,244.25,.05,.15,66,122
20150522,244.15,244.25,241.65,243.95,241.65,243.6,243.1,-.65,-1.15,38,126
20150525,243.6,243.1,242.9,243.55,242.9,243.05,243.15,-.05,.05,18,124
20150526,243.05,243.15,243.6,244.15,241.6,241.8,242.95,-1.35,-.2,36,136
20150527,241.8,242.95,240,240.85,239.05,240.85,239.9,-2.1,-3.05,76,138
20150528,240.85,239.9,239.85,240.55,239.85,240.05,240.2,.15,.3,40,124
20150529,240.05,240.2,239.5,240.65,239.05,240.35,239.9,.15,-.3,78,124
20150601,240.35,239.9,240.95,241.2,239.1,239.95,240.4,.05,.5,78,140
20150602,239.95,240.4,240.7,243,240,240.4,241.8,0,1.4,160,200
20150603,240.4,241.8,241.4,241.5,240.35,240.35,241.15,-1.45,-.65,104,220
20150604,240.35,241.15,240.15,240.15,237.8,238.7,238.95,-2.45,-2.2,68,208
20150605,238.7,238.95,237.7,237.85,236.6,237.85,236.95,-1.1,-2,64,200
20150608,237.85,236.95,235.85,237.65,234.75,236.65,236.25,-.3,-.7,62,188
20150609,236.65,236.25,236.95,237.9,236.7,237.65,237.4,1.4,1.15,32,194
20150610,237.65,237.4,238.55,238.55,237.5,238.4,237.9,1,.5,42,178
20150611,238.4,237.9,240.2,240.2,239.25,239.25,239.45,1.35,1.55,12,172
20150612,239.25,239.45,237.9,239.1,237.9,238.55,238.5,-.9,-.95,6,170
20150615,238.55,238.5,,,,238.5,238.5,0,0,0,170
20150616,238.5,238.5,238.75,240.25,238.6,239.85,239.35,1.35,.85,46,170
20150617,239.85,239.35,,,,239.35,239.35,0,0,0,170
20150618,239.35,239.35,237.65,239.5,237.65,239.5,238.7,.15,-.65,50,192
20150619,239.5,238.7,241.8,242,241.1,241.8,241.65,3.1,2.95,36,168
20150623,241.8,241.65,238.6,238.6,238.6,238.6,238.6,-3.05,-3.05,2,168
20150624,238.6,238.6,237.3,237.7,236.85,237.7,237.4,-.9,-1.2,10,170
20150625,237.7,237.4,237.75,237.75,236.95,237.75,237.4,.35,0,122,198
20150626,237.75,237.4,237.75,237.75,236.75,236.75,237.05,-.65,-.35,18,190
20150629,236.75,237.05,236.15,238.7,236.15,238.7,238.05,1.65,1,22,176
20150630,238.7,238.05,237,237.85,236.95,237.1,237.35,-.95,-.7,52,166
20150701,237.1,237.35,236.1,236.75,235.7,236.25,236.25,-1.1,-1.1,12,162
20150702,236.25,236.25,236.25,236.25,234.75,234.85,235.4,-1.4,-.85,28,162
20150703,234.85,235.4,235,235.55,232.8,235.45,235.05,.05,-.35,34,152
20150706,235.45,235.05,235.5,235.5,235.35,235.35,235.4,.3,.35,4,154
20150707,235.35,235.4,235.35,236.45,235.35,235.5,235.85,.1,.45,10,150
20150708,235.5,235.85,233.3,233.3,228.7,230,230.3,-5.85,-5.55,70,146
20150709,230,230.3,241.8,241.8,231.85,234.9,235.7,4.6,5.4,66,146
20150710,234.9,235.7,235.4,235.4,234.25,234.65,234.6,-1.05,-1.1,32,156
20150713,234.65,234.6,233.5,234.5,233.5,233.6,233.9,-1,-.7,10,156
20150714,233.6,233.9,232.3,233.55,232.3,232.55,232.95,-1.35,-.95,14,156
20150715,232.55,232.95,232.95,232.95,232.3,232.35,232.5,-.6,-.45,10,154
20150716,232.35,232.5,230.25,230.5,230,230,230.3,-2.5,-2.2,10,150
20150717,230,230.3,,,,230.6,230.6,.3,.3,0,150
20150720,230.6,230.6,227,227.95,221.55,224.25,224.15,-6.35,-6.45,72,160
20150721,224.25,224.15,223.25,223.25,221.05,221.05,221.85,-3.1,-2.3,84,170
20150722,221.05,221.85,221.75,223.45,219,220.6,222.05,-1.25,.2,82,192
20150723,220.6,222.05,218.7,221,218.7,220.5,219.8,-1.55,-2.25,34,180
20150724,220.5,219.8,219.7,220.6,216.05,217.9,218.2,-1.9,-1.6,112,226
20150727,217.9,218.2,217.75,222,217.75,222,220.4,3.8,2.2,98,176
20150728,222,220.4,219.9,222.05,219.9,220.05,220.95,-.35,.55,24,166
20150729,220.05,220.95,220.9,221.05,220.4,221,220.7,.05,-.25,24,160
20150730,221,220.7,220.35,221.85,217.1,217.3,219.7,-3.4,-1,52,178
20150731,217.3,219.7,218.2,220.35,217,219.6,218.35,-.1,-1.35,62,172
20150803,219.6,218.35,216.55,220.8,216.55,219.45,219.3,1.1,.95,32,172
20150804,219.45,219.3,219.6,219.6,217,218.45,217.7,-.85,-1.6,48,182
20150805,218.45,217.7,218.8,219.35,217.8,217.85,218.45,.15,.75,26,166
20150806,217.85,218.45,218.7,218.95,217.75,217.95,218.25,-.5,-.2,52,180
20150807,217.95,218.25,217.8,219.75,217.8,219.75,218.9,1.5,.65,18,176
20150810,219.75,218.9,219.8,220.7,219.8,220.7,220.05,1.8,1.15,30,180
20150811,220.7,220.05,223.15,226,222.6,225.85,224.2,5.8,4.15,148,164
20150812,225.85,224.2,226.8,234,225.85,232.95,231.45,8.75,7.25,146,178
20150813,232.95,231.45,234,235.25,231.7,233,233.7,1.55,2.25,148,172
20150814,233,233.7,232.05,232.5,230,231.8,231.1,-1.9,-2.6,98,146
20150817,231.8,231.1,233.5,233.5,219.5,231,230.55,-.1,-.55,120,142
20150818,231,230.55,,,,231,231,.45,.45,0,142
20150819,231,231,231.25,231.85,230.8,231.85,231.2,.85,.2,34,142
20150820,231.85,231.2,232.5,235.9,232.5,235.6,234.1,4.4,2.9,82,146
20150821,235.6,234.1,236.3,242.25,236.3,239.75,239.55,5.65,5.45,138,156
20150824,239.75,239.55,240.3,241.8,238.35,238.4,240.15,-1.15,.6,166,154
20150825,238.4,240.15,240.4,242.55,237.2,237.2,240.05,-2.95,-.1,82,144
20150826,237.2,240.05,237.45,237.65,234.2,235.25,235.35,-4.8,-4.7,104,136
20150827,235.25,235.35,232,233.9,230.9,233.5,232.55,-1.85,-2.8,90,112
20150828,233.5,232.55,231.75,235.85,230.45,233.55,233.4,1,.85,342,114
20150831,233.55,233.4,233.55,235.95,232.75,233.5,234.3,.1,.9,52,106
20150901,233.5,234.3,232.55,236.4,232.55,235.5,234.95,1.2,.65,78,106
20150902,235.5,234.95,236,237.15,234,235.15,235.25,.2,.3,96,104
20150907,235.15,235.25,231.8,231.8,231.25,231.7,231.5,-3.55,-3.75,46,106
20150908,231.7,231.5,230.9,232.55,230.4,231.1,231,-.4,-.5,56,108
20150909,231.1,231,231.75,232.15,231.35,231.45,231.7,.45,.7,44,110
20150910,231.45,231.7,229.7,229.7,227.6,228.9,228.6,-2.8,-3.1,88,94
20150911,228.9,228.6,229.4,229.4,228.05,228.4,228.55,-.2,-.05,38,114
20150914,228.4,228.55,226.55,228.4,226.55,227.75,227.85,-.8,-.7,26,116
20150915,227.75,227.85,228.2,228.5,227.85,227.85,228.1,0,.25,20,108
20150916,227.85,228.1,227.5,227.75,227.5,227.75,227.55,-.35,-.55,8,104
20150917,227.75,227.55,229.15,231.45,229.15,231.05,230.5,3.5,2.95,34,110
20150918,231.05,230.5,230.1,233,230.1,232.5,231.7,2,1.2,56,100
20150921,232.5,231.7,233.35,234,233.35,234,233.55,2.3,1.85,30,98
20150922,234,233.55,231.95,239,231.95,234,234,.45,.45,36,92
20150923,234,234,231.05,232.5,230.35,232.25,231.75,-1.75,-2.25,96,88
20150924,232.25,231.75,233.65,234.75,233.25,234.75,233.65,3,1.9,22,80
20150925,234.75,233.65,235.6,238.75,235.6,236.7,238.2,3.05,4.55,818,530
20150928,236.7,238.2,236.35,236.7,235.4,235.5,236.3,-2.7,-1.9,166,526
20150929,235.5,236.3,232.75,234.9,232.2,232.45,233.15,-3.85,-3.15,74,532
20150930,232.45,233.15,231.75,233.05,223.8,233.05,230.2,-.1,-2.95,36,510
20151008,233.05,230.2,233.05,234.5,233.05,234.5,233.75,4.3,3.55,12,504
20151009,234.5,233.75,239.1,239.1,234.5,235,234.95,1.25,1.2,450,120
20151012,235,234.95,235.05,236,235.05,236,235.9,1.05,.95,132,0
20151013,236,235.9,,,,235.9,235.9,0,0,0,0
20151014,235.9,235.9,,,,235.9,235.9,0,0,0,0
20151015,235.9,235.9,,,,235.9,235.9,0,0,0,0
au1511,20150818,230.55,230.55,,,,231.25,231.25,.7,.7,0,0
20150819,231.25,231.25,,,,231.45,231.45,.2,.2,0,0
20150820,231.45,231.45,,,,234.35,234.35,2.9,2.9,0,0
20150821,234.35,234.35,244.1,244.1,239.65,240.55,241.8,6.2,7.45,82,26
20150824,240.55,241.8,240,241.45,239,239,240.4,-2.8,-1.4,64,14
20150825,239,240.4,241.65,244.3,237.4,241.9,242.25,1.5,1.85,220,18
20150826,241.9,242.25,238.55,238.55,238.55,238.55,238.55,-3.7,-3.7,2,18
20150827,238.55,238.55,233.9,235.6,233.2,233.3,234.4,-5.25,-4.15,12,18
20150828,233.3,234.4,230.4,234.8,230.4,234.8,233.5,.4,-.9,8,12
20150831,234.8,233.5,236.1,236.1,233.2,233.95,234.5,.45,1,12,14
20150901,233.95,234.5,,,,235.15,235.15,.65,.65,0,14
20150902,235.15,235.15,238.6,238.6,233.35,235.65,235.7,.5,.55,18,12
20150907,235.65,235.7,,,,231.95,231.95,-3.75,-3.75,0,12
20150908,231.95,231.95,232.4,232.4,231.55,231.55,231.8,-.4,-.15,6,10
20150909,231.55,231.8,233.75,233.85,231.7,232.25,232.85,.45,1.05,136,28
20150910,232.25,232.85,228.85,230.95,227.8,227.8,229.4,-5.05,-3.45,26,26
20150911,227.8,229.4,229.35,229.35,229.35,229.35,229.35,-.05,-.05,2,24
20150914,229.35,229.35,230,230.3,228.55,228.55,229.2,-.8,-.15,10,24
20150915,228.55,229.2,,,,229.45,229.45,.25,.25,0,24
20150916,229.45,229.45,229.55,229.55,228.35,228.35,228.95,-1.1,-.5,4,26
20150917,228.35,228.95,228.35,232.9,228.35,231.5,231.2,2.55,2.25,8,24
20150918,231.5,231.2,,,,232.4,232.4,1.2,1.2,0,24
20150921,232.4,232.4,234.95,235,234.95,235,234.95,2.6,2.55,8,18
20150922,235,234.95,234.25,234.25,234.25,234.25,234.25,-.7,-.7,2,18
20150923,234.25,234.25,,,,232,232,-2.25,-2.25,0,18
20150924,232,232,,,,233.9,233.9,1.9,1.9,0,18
20150925,233.9,233.9,,,,238.45,238.45,4.55,4.55,0,18
20150928,238.45,238.45,,,,236.5,236.5,-1.95,-1.95,0,18
20150929,236.5,236.5,233.7,233.7,233.7,233.7,233.7,-2.8,-2.8,2,18
20150930,233.7,233.7,,,,230.7,230.7,-3,-3,0,18
20151008,230.7,230.7,,,,234.25,234.25,3.55,3.55,0,18
20151009,234.25,234.25,,,,235.45,235.45,1.2,1.2,0,18
20151012,235.45,235.45,,,,236.4,236.4,.95,.95,0,18
20151013,236.4,236.4,,,,236.4,236.4,0,0,0,18
20151014,236.4,236.4,235.3,235.3,235.3,235.3,235.3,-1.1,-1.1,2,16
20151015,235.3,235.3,,,,235.3,235.3,0,0,0,16
20151016,235.3,235.3,,,,235.3,235.3,0,0,0,16
20151019,235.3,235.3,,,,235.3,235.3,0,0,0,16
20151020,235.3,235.3,,,,235.3,235.3,0,0,0,16
20151021,235.3,235.3,,,,235.3,235.3,0,0,0,16
20151022,235.3,235.3,,,,235.3,235.3,0,0,0,16
20151023,235.3,235.3,,,,235.3,235.3,0,0,0,16
20151026,235.3,235.3,236.05,237.25,236.05,237.25,236.65,1.95,1.35,20,16
20151027,237.25,236.65,240.3,240.3,240.3,240.3,240.3,3.65,3.65,2,14
20151028,240.3,240.3,244,244.2,233.05,239.5,240.15,-.8,-.15,30,0
20151029,239.5,240.15,248.5,248.5,235.75,235.75,242.1,-4.4,1.95,4,0
20151030,235.75,242.1,,,,242.1,242.1,0,0,0,0
20151102,242.1,242.1,,,,242.1,242.1,0,0,0,0
20151103,242.1,242.1,,,,242.1,242.1,0,0,0,0
20151104,242.1,242.1,,,,242.1,242.1,0,0,0,0
20151105,242.1,242.1,,,,242.1,242.1,0,0,0,0
20151106,242.1,242.1,,,,242.1,242.1,0,0,0,0
20151109,242.1,242.1,,,,242.1,242.1,0,0,0,0
20151110,242.1,242.1,,,,242.1,242.1,0,0,0,0
20151111,242.1,242.1,,,,242.1,242.1,0,0,0,0
20151112,242.1,242.1,,,,242.1,242.1,0,0,0,0
20151113,242.1,242.1,,,,242.1,242.1,0,0,0,0
20151116,242.1,242.1,,,,242.1,242.1,0,0,0,0
au1512,20150116,247.8,247.8,254.1,254.85,253.85,254.85,254.2,7.05,6.4,52,42
20150119,254.85,254.2,256,258.8,256,258.8,257.85,4.6,3.65,40,52
20150120,258.8,257.85,258.85,259.7,257.5,258.5,258.65,.65,.8,106,112
20150121,258.5,258.65,261.55,264.25,260.5,263.55,262.6,4.9,3.95,2076,1608
20150122,263.55,262.6,260.75,264.3,260,260.55,263.1,-2.05,.5,2702,3278
20150123,260.55,263.1,262.15,264.05,258.45,262.8,262.9,-.3,-.2,2456,4472
20150126,262.8,262.9,263.1,264.1,261.25,263.35,263.65,.45,.75,1572,5524
20150127,263.35,263.65,261.85,262.25,260.15,261.5,260.95,-2.15,-2.7,584,5596
20150128,261.5,260.95,261.6,263.25,260.7,262.65,262.3,1.7,1.35,510,5794
20150129,262.65,262.3,261.95,262.25,260.3,261,260.85,-1.3,-1.45,556,5958
20150130,261,260.85,258.5,259.2,255.05,256.15,256.35,-4.7,-4.5,4618,5526
20150202,256.15,256.35,256.15,261.4,255.1,260.7,258.95,4.35,2.6,1330,5936
20150203,260.7,258.95,259.75,260.9,258.2,260.65,259.75,1.7,.8,1382,6536
20150204,260.65,259.75,258.8,259.65,256.2,258.05,257.45,-1.7,-2.3,2240,7540
20150205,258.05,257.45,258.8,259.7,257.2,258.9,258.6,1.45,1.15,1182,7610
20150206,258.9,258.6,257.85,258.3,256.7,258.3,257.65,-.3,-.95,820,7666
20150209,258.3,257.65,258.45,260.55,251.5,253.25,253.6,-4.4,-4.05,4200,9804
20150210,253.25,253.6,253.15,254.1,252.7,253.85,253.65,.25,.05,1132,10102
20150211,253.85,253.65,253.05,253.05,251.9,252.5,252.6,-1.15,-1.05,610,10234
20150212,252.5,252.6,251.9,252.15,249.2,249.65,249.8,-2.95,-2.8,1742,11210
20150213,249.65,249.8,250,251.45,249.45,251.4,250.5,1.6,.7,754,11392
20150216,251.4,250.5,250.85,252.5,250.8,252,251.3,1.5,.8,2238,12328
20150217,252,251.3,251.9,252.25,251,251.15,251.7,-.15,.4,1496,13142
20150225,251.15,251.7,248.9,248.9,247.6,247.95,247.9,-3.75,-3.8,1128,13528
20150226,247.95,247.9,247.7,248.4,246.4,248.1,247.5,.2,-.4,1982,14264
20150227,248.1,247.5,249.3,249.55,247.3,248.6,248.45,1.1,.95,3604,16018
20150302,248.6,248.45,248.55,251.5,248.3,251.15,250.5,2.7,2.05,1388,16084
20150303,251.15,250.5,250.55,250.7,245.65,249.2,248.6,-1.3,-1.9,5986,16574
20150304,249.2,248.6,249.45,250.2,247.8,248.6,248.7,0,.1,2476,16970
20150305,248.6,248.7,248,248.7,247.05,247.75,248,-.95,-.7,1786,17374
20150306,247.75,248,247.55,248.85,246.5,246.9,247.2,-1.1,-.8,3118,18136
20150309,246.9,247.2,246.9,246.9,240.4,241.85,242.05,-5.35,-5.15,7436,21708
20150310,241.85,242.05,241.75,242.1,239,239.5,240.55,-2.55,-1.5,5494,22732
20150311,239.5,240.55,241.35,241.55,239.35,240.15,240.3,-.4,-.25,4622,24744
20150312,240.15,240.3,239.6,240.85,236.6,240.65,238.8,.35,-1.5,6496,25988
20150313,240.65,238.8,239.15,240,237.95,239.5,239.4,.7,.6,3866,27450
20150316,239.5,239.4,239.5,240.4,238.15,240.1,239.4,.7,0,3624,28400
20150317,240.1,239.4,238.6,239.4,237.85,238.5,238.35,-.9,-1.05,2518,29172
20150318,238.5,238.35,236.95,248.2,235.05,235.9,236.85,-2.45,-1.5,6724,29412
20150319,235.9,236.85,235.65,241.5,235.65,239.75,238.9,2.9,2.05,4244,29730
20150320,239.75,238.9,238.1,240.05,237.55,239.45,238.85,.55,-.05,3726,30536
20150323,239.45,238.85,239.15,243.1,239.15,242.3,241.8,3.45,2.95,5292,31898
20150324,242.3,241.8,242.75,244.3,242.1,242.9,243.15,1.1,1.35,9998,31004
20150325,242.9,243.15,243.7,244.35,242.55,243.2,243.25,.05,.1,3556,31370
20150326,243.2,243.25,244.65,245.9,244,245.9,244.95,2.65,1.7,8334,30520
20150327,245.9,244.95,245.55,246.2,244.7,244.9,245.25,-.05,.3,9982,29712
20150330,244.9,245.25,244.5,244.75,241.95,242,243.3,-3.25,-1.95,6648,30190
20150331,242,243.3,241.4,241.4,239.8,239.8,240.65,-3.5,-2.65,5190,30712
20150401,239.8,240.65,240.5,241.75,239.75,240.5,240.75,-.15,.1,5518,31948
20150402,240.5,240.75,241.5,245.4,241.5,245.2,243.75,4.45,3,10262,34154
20150403,245.2,243.75,244.45,244.85,242.7,244.2,243.8,.45,.05,7232,36338
20150407,244.2,243.8,246,246.55,245.75,246.3,246.2,2.5,2.4,5076,37552
20150408,246.3,246.2,246.3,246.55,245.2,246.4,246,.2,-.2,6858,40272
20150409,246.4,246,246.2,246.3,242.3,242.95,243.75,-3.05,-2.25,6674,40932
20150410,242.95,243.75,242.2,243.6,242.05,242.4,242.55,-1.35,-1.2,6692,40468
20150413,242.4,242.55,244.3,245.95,244.3,245.4,245.25,2.85,2.7,11008,41896
20150414,245.4,245.25,245.5,245.55,241.65,242.55,243.8,-2.7,-1.45,10842,41998
20150415,242.55,243.8,241.35,243.9,241.35,242.45,242.75,-1.35,-1.05,12742,42774
20150416,242.45,242.75,242.45,244.95,242.2,244.4,243.95,1.65,1.2,12694,43682
20150417,244.4,243.95,244.6,244.75,242.45,243.25,243.4,-.7,-.55,12368,45512
20150420,243.25,243.4,243.55,245.4,243.5,245.3,244.3,1.9,.9,12482,46570
20150421,245.3,244.3,243,243.65,242.05,242.4,242.65,-1.9,-1.65,10942,48070
20150422,242.4,242.65,243.6,244.95,242.6,243.8,243.6,1.15,.95,10486,48116
20150423,243.8,243.6,243,243.1,239.4,239.8,240.45,-3.8,-3.15,20800,51392
20150424,239.8,240.45,239.65,242.05,239.65,241.5,241.1,1.05,.65,15428,54326
20150427,241.5,241.1,240.4,240.8,238.35,239.5,239.4,-1.6,-1.7,24668,61740
20150428,239.5,239.4,240.6,246.5,240.45,244.3,244.35,4.9,4.95,50506,64816
20150429,244.3,244.35,245.25,247.1,244.35,245.5,245.95,1.15,1.6,34308,73664
20150430,245.5,245.95,245.35,246.5,243.85,244.4,244.95,-1.55,-1,35392,83174
20150504,244.4,244.95,238,240.85,238,240.65,240.15,-4.3,-4.8,29282,93176
20150505,240.65,240.15,240.85,242.75,240.6,241.5,241.85,1.35,1.7,33960,96180
20150506,241.5,241.85,244,244.2,242.6,243.15,243.5,1.3,1.65,50306,103120
20150507,243.15,243.5,243.4,243.6,240.05,240.05,241.85,-3.45,-1.65,45224,102864
20150508,240.05,241.85,240,241.5,239.25,241.05,240.6,-.8,-1.25,42984,105770
20150511,241.05,240.6,241.8,242.4,240.5,241.15,241.4,.55,.8,49412,109426
20150512,241.15,241.4,241.65,242.2,239.5,240.6,240.65,-.8,-.75,48302,113008
20150513,240.6,240.65,243.2,243.3,241.35,242.7,242.15,2.05,1.5,59310,113768
20150514,242.7,242.15,244.6,247.45,244.15,247.15,245.9,5,3.75,155688,128358
20150515,247.15,245.9,247.5,248.8,246.55,247.45,247.5,1.55,1.6,146534,131580
20150518,247.45,247.5,246.55,250.15,246.3,249.2,248.15,1.7,.65,148128,142462
20150519,249.2,248.15,249,249.55,247.25,247.75,248.35,-.4,.2,117590,139706
20150520,247.75,248.35,246,246.65,243.5,244.25,245.15,-4.1,-3.2,157826,127742
20150521,244.25,245.15,245,246.05,244.6,245.1,245.25,-.05,.1,95594,128368
20150522,245.1,245.25,243.75,244.95,243.3,244.6,244.2,-.65,-1.05,93404,130840
20150525,244.6,244.2,244,244.6,243.05,244.2,243.85,0,-.35,96058,134514
20150526,244.2,243.85,244,245.3,242.15,242.5,244,-1.35,.15,104142,140872
20150527,242.5,244,240.2,241.6,240.2,241.1,241,-2.9,-3,143194,156088
20150528,241.1,241,240.5,241.5,240.4,241.05,240.95,.05,-.05,98436,158536
20150529,241.05,240.95,240.8,241.5,239,240.8,240.7,-.15,-.25,121018,163448
20150601,240.8,240.7,241.45,242,240.5,240.55,241.35,-.15,.65,103334,168392
20150602,240.55,241.35,240.65,243.95,240.3,240.85,241.95,-.5,.6,181356,172252
20150603,240.85,241.95,241.15,242.15,240.95,241.15,241.55,-.8,-.4,115948,174450
20150604,241.15,241.55,240.85,241.45,238.4,239.2,240.05,-2.35,-1.5,140880,180144
20150605,239.2,240.05,238.7,238.85,237.3,238.35,238.15,-1.7,-1.9,153790,186976
20150608,238.35,238.15,236.25,238.65,235.5,237.7,237,-.45,-1.15,171370,189622
20150609,237.7,237,237.35,238.65,237.15,238.6,237.9,1.6,.9,88838,187914
20150610,238.6,237.9,239,239.8,238.2,239.65,238.8,1.75,.9,95576,184534
20150611,239.65,238.8,241.1,241.8,239.85,240.1,240.6,1.3,1.8,90162,179208
20150612,240.1,240.6,239.7,240,238.7,239.5,239.35,-1.1,-1.25,91472,180652
20150615,239.5,239.35,238.75,239.85,238.45,239.75,239.2,.4,-.15,81150,180970
20150616,239.75,239.2,238.85,241.1,238.65,240.55,240,1.35,.8,116438,184750
20150617,240.55,240,239.9,240,238.3,238.65,238.85,-1.35,-1.15,112048,184814
20150618,238.65,238.85,238.65,240.8,237.85,240.3,239.3,1.45,.45,130180,179180
20150619,240.3,239.3,242.95,243.5,242.1,242.55,242.75,3.25,3.45,134734,174454
20150623,242.55,242.75,240.15,240.35,239.6,239.85,240.05,-2.9,-2.7,35896,173568
20150624,239.85,240.05,238.2,238.85,238,238.6,238.4,-1.45,-1.65,86736,175432
20150625,238.6,238.4,238,238.5,237.35,238.25,237.85,-.15,-.55,94536,178444
20150626,238.25,237.85,237.7,238.05,237.1,237.35,237.7,-.5,-.15,70318,182194
20150629,237.35,237.7,237.15,240.45,236.5,239.25,238.35,1.55,.65,102474,177434
20150630,239.25,238.35,239.5,239.55,237.7,238.05,238.35,-.3,0,108750,176296
20150701,238.05,238.35,237.1,238.75,236.25,237.7,237.35,-.65,-1,130804,178778
20150702,237.7,237.35,237.05,237.55,235.65,235.9,236.55,-1.45,-.8,129988,190984
20150703,235.9,236.55,236.2,237,235.6,236.7,236.3,.15,-.25,112654,190922
20150706,236.7,236.3,236.9,237.5,236.2,236.35,236.65,.05,.35,80562,190230
20150707,236.35,236.65,236.2,238.15,235.65,236.9,236.7,.25,.05,89786,187446
20150708,236.9,236.7,235.45,235.5,226.05,231.7,232.65,-5,-4.05,490996,206374
20150709,231.7,232.65,232.7,244.25,232.3,235.4,235.05,2.75,2.4,241776,183564
20150710,235.4,235.05,235.85,236.5,234.2,235.2,235.5,.15,.45,112944,182362
20150713,235.2,235.5,235.2,236.15,234.65,235.15,235.15,-.35,-.35,90552,181494
20150714,235.15,235.15,233.75,234.65,233,233.3,233.65,-1.85,-1.5,133862,188602
20150715,233.3,233.65,233.8,234.7,233.3,233.5,233.9,-.15,.25,81074,187688
20150716,233.5,233.9,232.8,232.9,230.65,231.5,231.55,-2.4,-2.35,173142,198274
20150717,231.5,231.55,230.25,231.75,230.25,231.3,231.15,-.25,-.4,98002,194776
20150720,231.3,231.15,230,230.1,220.15,225.65,225.95,-5.5,-5.2,384974,208312
20150721,225.65,225.95,224.6,225,222.3,223.05,223.55,-2.9,-2.4,264440,217652
20150722,223.05,223.55,222.7,224.2,219.55,220.65,221.95,-2.9,-1.6,283762,235362
20150723,220.65,221.95,219.9,222.25,219.25,221.1,220.6,-.85,-1.35,278334,223608
20150724,221.1,220.6,221,221.8,216.8,219.3,219.45,-1.3,-1.15,303596,234572
20150727,219.3,219.45,219,223.7,218.1,223.7,220.85,4.25,1.4,318958,215628
20150728,223.7,220.85,221.5,223.35,220.7,221.75,221.75,.9,.9,208244,218516
20150729,221.75,221.75,221.3,222.4,221.2,221.85,221.8,.1,.05,143350,211334
20150730,221.85,221.8,221.4,223.1,218.15,219.05,220.8,-2.75,-1,320076,237326
20150731,219.05,220.8,219.45,221.35,218.05,218.15,219.7,-2.65,-1.1,289880,239568
20150803,218.15,219.7,219.9,222.95,219.65,221.6,220.9,1.9,1.2,272524,223732
20150804,221.6,220.9,220.1,220.85,217.7,219.3,219.25,-1.6,-1.65,209816,237116
20150805,219.3,219.25,220.05,220.45,218.55,219.15,219.45,-.1,.2,143808,242704
20150806,219.15,219.45,219.55,219.8,218.15,218.7,218.75,-.75,-.7,175434,249914
20150807,218.7,218.75,218.7,221.5,218.45,221.2,219.6,2.45,.85,218824,229248
20150810,221.2,219.6,218.8,222,218.6,221.55,220.75,1.95,1.15,251200,221392
20150811,221.55,220.75,220.95,227.3,220.95,226.3,224.35,5.55,3.6,464794,218994
20150812,226.3,224.35,227.9,235.55,227.5,235.45,231.4,11.1,7.05,503090,239256
20150813,235.45,231.4,235.35,236.65,232.95,234.25,235.1,2.85,3.7,416448,223036
20150814,234.25,235.1,233.15,233.85,231.15,232.85,232.75,-2.25,-2.35,228462,222040
20150817,232.85,232.75,233,233.65,230,232.85,232.1,.1,-.65,230864,217974
20150818,232.85,232.1,233.1,233.45,232.05,232.45,232.75,.35,.65,165702,219690
20150819,232.45,232.75,232.1,233.75,230.35,233.55,231.95,.8,-.8,235948,226990
20150820,233.55,231.95,233.4,237.9,233.05,236.95,235.35,5,3.4,323534,233756
20150821,236.95,235.35,237.15,243.55,237.15,240.8,240.4,5.45,5.05,450916,246898
20150824,240.8,240.4,240.3,242.5,238.85,240,240.65,-.4,.25,590824,258036
20150825,240,240.65,240.4,244.2,238.1,239.5,241.35,-1.15,.7,664454,257184
20150826,239.5,241.35,240.05,240.45,235.8,236.8,237.2,-4.55,-4.15,518780,243656
20150827,236.8,237.2,234.8,235.3,232.5,234.75,234,-2.45,-3.2,367310,237946
20150828,234.75,234,233.6,235.85,233,235.25,234.5,1.25,.5,391728,237678
20150831,235.25,234.5,234.7,237.2,233.7,235.55,235.7,1.05,1.2,344230,236710
20150901,235.55,235.7,234.05,237.1,233.4,236.75,235.4,1.05,-.3,242728,233592
20150902,236.75,235.4,236.65,238.75,235,236.6,236.2,1.2,.8,248968,234716
20150907,236.6,236.2,232.3,233.3,231.6,232.75,232.8,-3.45,-3.4,79104,231582
20150908,232.75,232.8,232.5,232.65,231.4,232.25,232.15,-.55,-.65,131530,232098
20150909,232.25,232.15,232.7,233.85,232.5,232.9,233.05,.75,.9,207002,230936
20150910,232.9,233.05,232.1,232.1,228.55,229.8,230.1,-3.25,-2.95,281406,232072
20150911,229.8,230.1,230.45,230.7,229,229.6,229.8,-.5,-.3,238658,231116
20150914,229.6,229.8,229.1,229.65,227.55,229.25,228.6,-.55,-1.2,232764,227026
20150915,229.25,228.6,228.8,230.15,228.3,229.3,229.25,.7,.65,148064,226762
20150916,229.3,229.25,229.05,229.55,228.65,229.3,228.95,.05,-.3,116810,227108
20150917,229.3,228.95,231.05,233.15,230.5,231.95,231.9,3,2.95,247974,230978
20150918,231.95,231.9,231.2,234.6,231.05,233.3,232.8,1.4,.9,234892,222554
20150921,233.3,232.8,235.6,235.95,234.55,235.7,235.1,2.9,2.3,178226,227066
20150922,235.7,235.1,234.7,234.95,234.15,234.45,234.55,-.65,-.55,86282,224150
20150923,234.45,234.55,232.95,233.6,232.25,233.6,232.9,-.95,-1.65,115666,225516
20150924,233.6,232.9,234,235.7,233.95,235.5,234.8,2.6,1.9,126276,226970
20150925,235.5,234.8,235.95,239.35,235.8,237.2,238,2.4,3.2,290832,235976
20150928,237.2,238,237,237.2,234.65,234.75,236.35,-3.25,-1.65,68928,235484
20150929,234.75,236.35,233.05,234.5,231.7,232.25,233.15,-4.1,-3.2,143358,220178
20150930,232.25,233.15,232.7,233.15,230.7,231,231.9,-2.15,-1.25,113082,212632
20151008,231,231.9,235.35,235.8,234.6,234.9,235.1,3,3.2,63344,207384
20151009,234.9,235.1,234,236.5,233.9,235.05,234.95,-.05,-.15,137844,202420
20151012,235.05,234.95,237.1,238.55,235.65,238.25,237,3.3,2.05,198656,208586
20151013,238.25,237,238.3,238.4,235.4,236.45,236.95,-.55,-.05,180082,196902
20151014,236.45,236.95,237.35,240.6,236.9,240.35,239.05,3.4,2.1,229870,212284
20151015,240.35,239.05,240.2,242.85,239.95,241.65,241.2,2.6,2.15,232528,211582
20151016,241.65,241.2,241,243.1,240.2,240.95,241.55,-.25,.35,277960,201892
20151019,240.95,241.55,242,242.4,239.6,240.2,240.95,-1.35,-.6,219320,198922
20151020,240.2,240.95,240.8,241.2,238.75,239.95,239.65,-1,-1.3,183632,193090
20151021,239.95,239.65,240.15,241.55,239.55,240.2,240.7,.55,1.05,215012,198884
20151022,240.2,240.7,240.65,240.8,238.3,239.4,239.05,-1.3,-1.65,193706,195940
20151023,239.4,239.05,238.75,241,238.4,240.9,239.65,1.85,.6,197752,194388
20151026,240.9,239.65,241.5,241.5,237.8,238.7,239.05,-.95,-.6,210274,188302
20151027,238.7,239.05,239,239.9,238.5,238.95,239.1,-.1,.05,127366,180474
20151028,238.95,239.1,238.45,240.9,238.3,240.45,239.7,1.35,.6,164766,175400
20151029,240.45,239.7,241.15,242.9,237.15,237.75,240.2,-1.95,.5,301848,162606
20151030,237.75,240.2,236.6,237.1,234.45,234.85,235.7,-5.35,-4.5,195092,157612
20151102,234.85,235.7,233.3,233.95,232.25,233.5,233.25,-2.2,-2.45,139320,146026
20151103,233.5,233.25,233.05,233.25,232.1,232.55,232.55,-.7,-.7,93756,142148
20151104,232.55,232.55,231.7,231.85,228.2,229.25,230,-3.3,-2.55,144696,138286
20151105,229.25,230,228.55,229.65,227.2,227.4,228.35,-2.6,-1.65,157222,137056
20151106,227.4,228.35,227.2,228.2,226.85,227.8,227.55,-.55,-.8,111246,136050
20151109,227.8,227.55,227.7,228.2,223.3,224.65,224.65,-2.9,-2.9,196986,125470
20151110,224.65,224.65,224.7,225.15,223.65,224.8,224.35,.15,-.3,103676,111376
20151111,224.8,224.35,224.75,225.3,223.15,224.85,224.4,.5,.05,121004,99904
20151112,224.85,224.4,224.35,224.65,223.35,224.05,224.1,-.35,-.3,77854,95794
20151113,224.05,224.1,223.45,224.4,221.5,223.3,222.95,-.8,-1.15,153540,87794
20151116,223.3,222.95,223.25,226.4,222.8,226.15,224.6,3.2,1.65,109498,83034
20151117,226.15,224.6,225.3,225.6,222.05,222.35,223.7,-2.25,-.9,75806,73496
20151118,222.35,223.7,222.7,223.55,219.15,221.15,221.4,-2.55,-2.3,72460,64248
20151119,221.15,221.4,221.05,222.2,220.25,221.95,221.2,.55,-.2,51934,51756
20151120,221.95,221.2,221.15,223.6,220.4,223.4,222.35,2.2,1.15,56174,43674
20151123,223.4,222.35,223.3,223.95,220.2,220.55,221.95,-1.8,-.4,41424,38748
20151124,220.55,221.95,220.1,221.5,219.6,220.7,220.45,-1.25,-1.5,27522,34186
20151125,220.7,220.45,221.3,222.75,220.85,222.05,221.95,1.6,1.5,35708,27738
20151126,222.05,221.95,221.1,221.45,220,220.9,220.65,-1.05,-1.3,19880,23364
20151127,220.9,220.65,220.9,221,219.7,220.3,220.45,-.35,-.2,10200,20436
20151130,220.3,220.45,220,220,216.15,216.9,217.1,-3.55,-3.35,25478,13708
au1601,20151016,241.2,241.2,245.65,245.7,240.15,242.85,242.4,1.65,1.2,62,6
20151019,242.85,242.4,242.35,244.25,239.9,240.1,241.55,-2.3,-.85,48,16
20151020,240.1,241.55,240.45,241.2,239.85,239.85,240.6,-1.7,-.95,14,16
20151021,239.85,240.6,240.2,244.2,240.2,240.65,241.7,.05,1.1,32,18
20151022,240.65,241.7,242.9,242.9,239.5,241,240.35,-.7,-1.35,48,24
20151023,241,240.35,238.85,240.95,238.15,240.95,240.1,.6,-.25,50,18
20151026,240.95,240.1,241.2,243.9,238.3,239.35,240.15,-.75,.05,682,28
20151027,239.35,240.15,240.4,242.5,239.4,240,240.15,-.15,0,20,26
20151028,240,240.15,239.5,242.45,239.1,241.45,241,1.3,.85,44,28
20151029,241.45,241,242.7,245,238.05,239.25,242.85,-1.75,1.85,132,78
20151030,239.25,242.85,236.65,238.95,233.05,233.05,237.15,-9.8,-5.7,134,132
20151102,233.05,237.15,235.6,237.35,232.5,235.5,235.55,-1.65,-1.6,122,158
20151103,235.5,235.55,234.2,236.25,233.85,234.55,234.55,-1,-1,106,152
20151104,234.55,234.55,232.6,233.65,230.3,231.45,231.65,-3.1,-2.9,148,188
20151105,231.45,231.65,231,231.25,228.9,228.9,230,-2.75,-1.65,86,186
20151106,228.9,230,228.5,230.45,228.5,230.45,229.45,.45,-.55,62,180
20151109,230.45,229.45,229.9,229.9,225.6,226.55,226.55,-2.9,-2.9,160,202
20151110,226.55,226.55,226.95,227.55,225.75,226.55,226.25,0,-.3,172,206
20151111,226.55,226.25,225.75,226.55,225.2,225.8,226.05,-.45,-.2,48,194
20151112,225.8,226.05,225.8,225.8,224.95,225.45,225.4,-.6,-.65,84,200
20151113,225.45,225.4,225.4,226.55,222.3,223.85,223.8,-1.55,-1.6,284,210
20151116,223.85,223.8,223.85,228.05,223.7,227.35,227.05,3.55,3.25,608,228
20151117,227.35,227.05,226.05,226.05,222.95,223.4,224.3,-3.65,-2.75,148,208
20151118,223.4,224.3,224.25,224.75,220.85,221.9,222.15,-2.4,-2.15,180,258
20151119,221.9,222.15,221.9,223.45,221.45,222.6,222.7,.45,.55,100,278
20151120,222.6,222.7,221.5,225.5,221.5,224.2,224,1.5,1.3,200,272
20151123,224.2,224,224.75,225.05,220,220.75,221,-3.25,-3,264,358
20151124,220.75,221,220.55,222.55,218.7,221.4,221.25,.4,.25,260,228
20151125,221.4,221.25,222.5,224.6,221.7,223.35,223.35,2.1,2.1,578,334
20151126,223.35,223.35,222.35,222.6,221.25,222,221.95,-1.35,-1.4,406,350
20151127,222,221.95,221.95,222.4,220.65,221.25,221.5,-.7,-.45,188,370
20151130,221.25,221.5,219.05,219.15,217.4,217.4,218.15,-4.1,-3.35,402,408
au1602,20150317,239.4,239.4,,,,239.4,239.4,0,0,0,0
20150318,239.4,239.4,235.85,235.85,235.85,235.85,235.85,-3.55,-3.55,2,2
20150319,235.85,235.85,,,,238.7,238.7,2.85,2.85,0,2
20150320,238.7,238.7,239.55,240.65,238.05,239.85,239.95,1.15,1.25,16,14
20150323,239.85,239.95,243.4,243.4,243.4,243.4,243.4,3.45,3.45,2,16
20150324,243.4,243.4,244.35,244.35,243.9,243.9,244.1,.5,.7,4,16
20150325,243.9,244.1,,,,244.2,244.2,.1,.1,0,16
20150326,244.2,244.2,246.95,246.95,244.9,246.05,245.95,1.85,1.75,6,16
20150327,246.05,245.95,,,,245.95,245.95,0,0,0,16
20150330,245.95,245.95,,,,244,244,-1.95,-1.95,0,16
20150331,244,244,241.55,241.55,240.95,240.95,241.25,-3.05,-2.75,4,16
20150401,240.95,241.25,242.35,242.35,242.35,242.35,242.35,1.1,1.1,2,18
20150402,242.35,242.35,245,245,245,245,245,2.65,2.65,2,16
20150403,245,245,243.05,243.05,243.05,243.05,243.05,-1.95,-1.95,2,18
20150407,243.05,243.05,247.3,247.3,247.3,247.3,247.3,4.25,4.25,2,16
20150408,247.3,247.3,247.35,247.35,247.35,247.35,247.35,.05,.05,4,16
20150409,247.35,247.35,245.6,248.95,242.85,244.8,245.35,-2.55,-2,22,26
20150410,244.8,245.35,244.05,245.65,244.05,244.55,245.05,-.8,-.3,58,62
20150413,244.55,245.05,247.75,248.8,247.75,247.95,248.4,2.9,3.35,20,72
20150414,247.95,248.4,246.95,246.95,244.25,244.8,245.5,-3.6,-2.9,40,44
20150415,244.8,245.5,247.45,247.45,243.5,243.75,246.15,-1.75,.65,12,54
20150416,243.75,246.15,244.4,247.4,244.4,245.2,245.8,-.95,-.35,12,52
20150417,245.2,245.8,244.75,244.75,243.95,244.65,244.5,-1.15,-1.3,8,52
20150420,244.65,244.5,246.15,246.15,246.15,246.15,246.15,1.65,1.65,4,56
20150421,246.15,246.15,244.95,244.95,244.95,244.95,244.95,-1.2,-1.2,2,56
20150422,244.95,244.95,246.3,246.3,244.4,244.45,245,-.5,.05,8,54
20150423,244.45,245,,,,241.85,241.85,-3.15,-3.15,0,54
20150424,241.85,241.85,243.05,243.05,243.05,243.05,243.05,1.2,1.2,2,54
20150427,243.05,243.05,241.85,241.85,241,241.75,241.5,-1.3,-1.55,20,66
20150428,241.75,241.5,247.05,247.1,245.35,245.55,246.65,4.05,5.15,16,70
20150429,245.55,246.65,246.05,247.5,246.05,246.85,247.2,.2,.55,32,60
20150430,246.85,247.2,247.15,247.15,245.55,245.55,246.35,-1.65,-.85,6,58
20150504,245.55,246.35,244.1,244.1,244.1,244.1,244.1,-2.25,-2.25,2,60
20150505,244.1,244.1,243.4,243.4,242.35,243.25,243.05,-.85,-1.05,14,62
20150506,243.25,243.05,245.25,245.25,244.75,244.75,245,1.7,1.95,8,60
20150507,244.75,245,244.45,244.45,242.75,242.75,243.3,-2.25,-1.7,8,58
20150508,242.75,243.3,242.65,242.8,241.7,241.75,242.15,-1.55,-1.15,26,60
20150511,241.75,242.15,242.95,244.3,241.9,243.3,243.05,1.15,.9,20,68
20150512,243.3,243.05,241.85,242,241.85,242,241.9,-1.05,-1.15,4,68
20150513,242,241.9,243,243,243,243,243,1.1,1.1,2,68
20150514,243,243,247.8,247.8,246.8,246.8,247.3,3.8,4.3,4,68
20150515,246.8,247.3,250.05,250.05,248.2,248.2,248.7,.9,1.4,8,62
20150518,248.2,248.7,248.6,250.05,248.6,250.05,249.25,1.35,.55,14,60
20150519,250.05,249.25,249.5,250.2,249.2,249.2,249.75,-.05,.5,12,68
20150520,249.2,249.75,248,248.05,244.55,245.3,246,-4.45,-3.75,222,76
20150521,245.3,246,246.5,247.05,246.5,246.85,246.9,.85,.9,16,78
20150522,246.85,246.9,245.35,245.7,245.35,245.6,245.55,-1.3,-1.35,30,68
20150525,245.6,245.55,245.4,245.4,245.4,245.4,245.4,-.15,-.15,2,68
20150526,245.4,245.4,245.85,245.85,245.85,245.85,245.85,.45,.45,4,68
20150527,245.85,245.85,242.2,243.65,242.05,242.75,242.6,-3.1,-3.25,22,74
20150528,242.75,242.6,242.35,242.65,241,242.6,242.25,0,-.35,16,68
20150529,242.6,242.25,242.25,243.1,240.65,242.8,242.2,.55,-.05,14,72
20150601,242.8,242.2,243.15,243.15,242.55,242.9,242.85,.7,.65,18,72
20150602,242.9,242.85,244.1,245,242.05,242.05,244.15,-.8,1.3,14,70
20150603,242.05,244.15,243.45,243.45,242.75,242.75,243.1,-1.4,-1.05,8,68
20150604,242.75,243.1,241.95,242.9,240.9,241.25,241.9,-1.85,-1.2,30,60
20150605,241.25,241.9,239.75,239.95,238.5,239.95,239.2,-1.95,-2.7,18,56
20150608,239.95,239.2,237.5,240,237.5,239.55,239.4,.35,.2,28,78
20150609,239.55,239.4,,,,240.3,240.3,.9,.9,0,78
20150610,240.3,240.3,239.6,240.75,239.5,240.75,239.95,.45,-.35,6,76
20150611,240.75,239.95,242,242.05,242,242,242,2.05,2.05,14,68
20150612,242,242,,,,242,242,0,0,0,68
20150615,242,242,240.3,241.1,240.15,241,240.5,-1,-1.5,34,72
20150616,241,240.5,241.2,242.35,241.2,241.65,241.9,1.15,1.4,10,72
20150617,241.65,241.9,241.1,241.1,240,240,240.4,-1.9,-1.5,14,70
20150618,240,240.4,240.65,240.65,240.65,240.65,240.65,.25,.25,2,70
20150619,240.65,240.65,244.05,244.05,243.5,243.6,243.65,2.95,3,28,64
20150623,243.6,243.65,245,245,240.95,241.05,241.7,-2.6,-1.95,12,64
20150624,241.05,241.7,239.6,239.9,238.95,239.9,239.5,-1.8,-2.2,48,90
20150625,239.9,239.5,239.9,239.9,238.9,239.25,239.2,-.25,-.3,28,80
20150626,239.25,239.2,239,239.3,238.9,239,239,-.2,-.2,20,84
20150629,239,239,238.6,240.4,238.6,240.15,239.5,1.15,.5,8,82
20150630,240.15,239.5,239.7,239.75,238.8,238.8,239.3,-.7,-.2,14,76
20150701,238.8,239.3,,,,238.3,238.3,-1,-1,0,76
20150702,238.3,238.3,237.5,237.9,237.5,237.9,237.5,-.4,-.8,24,74
20150703,237.9,237.5,237.95,237.95,237.95,237.95,237.95,.45,.45,2,72
20150706,237.95,237.95,237.6,237.6,237.4,237.4,237.5,-.55,-.45,6,74
20150707,237.4,237.5,236.8,238.25,236.8,237.85,237.35,.35,-.15,36,68
20150708,237.85,237.35,233.55,234.25,232.05,232.05,232.65,-5.3,-4.7,30,64
20150709,232.05,232.65,235,236.85,233.85,235.75,235.7,3.1,3.05,30,48
20150710,235.75,235.7,236.75,236.85,236.1,236.1,236.5,.4,.8,12,50
20150713,236.1,236.5,235.8,236.75,235.25,235.25,235.95,-1.25,-.55,26,54
20150714,235.25,235.95,234.4,235,234.4,235,234.55,-.95,-1.4,54,64
20150715,235,234.55,,,,234.8,234.8,.25,.25,0,64
20150716,234.8,234.8,232.75,232.75,232.35,232.65,232.45,-2.15,-2.35,12,58
20150717,232.65,232.45,,,,232,232,-.45,-.45,0,58
20150720,232,232,229.35,229.6,223.85,226.75,226.4,-5.25,-5.6,36,64
20150721,226.75,226.4,225.8,225.8,223.25,224.5,225,-1.9,-1.4,38,62
20150722,224.5,225,223.6,223.6,221.75,221.75,222.4,-3.25,-2.6,8,64
20150723,221.75,222.4,221.5,223.25,221.5,222.5,222.45,.1,.05,10,64
20150724,222.5,222.45,219.95,220.65,219.95,220.65,220.3,-1.8,-2.15,4,64
20150727,220.65,220.3,223.05,224.3,223.05,224.2,223.7,3.9,3.4,14,66
20150728,224.2,223.7,222.9,223.5,222.1,222.4,222.95,-1.3,-.75,32,70
20150729,222.4,222.95,222.75,222.95,222.75,222.95,222.8,0,-.15,16,70
20150730,222.95,222.8,221.95,223.5,216,216,221.65,-6.8,-1.15,36,58
20150731,216,221.65,,,,221.65,221.65,0,0,0,58
20150803,221.65,221.65,222.7,222.7,221.4,222,221.8,.35,.15,12,60
20150804,222,221.8,220.8,220.8,220.8,220.8,220.8,-1,-1,2,58
20150805,220.8,220.8,219.85,219.85,219.85,219.85,219.85,-.95,-.95,2,58
20150806,219.85,219.85,220.1,220.35,219.25,219.65,219.8,-.2,-.05,10,60
20150807,219.65,219.8,219.7,221,219.6,221,220,1.2,.2,14,64
20150810,221,220,221,222.65,221,221.95,222.1,1.95,2.1,108,116
20150811,221.95,222.1,222.8,228.1,222.8,226.75,224.45,4.65,2.35,112,108
20150812,226.75,224.45,228.75,235.5,228.75,235.25,231.75,10.8,7.3,82,102
20150813,235.25,231.75,237.1,237.4,234.65,235.3,235.7,3.55,3.95,74,110
20150814,235.3,235.7,234.45,234.8,232.35,234,233.6,-1.7,-2.1,48,102
20150817,234,233.6,231.8,233.65,231.8,233.65,232.6,.05,-1,22,100
20150818,233.65,232.6,233.85,234.7,233.35,233.35,233.7,.75,1.1,12,98
20150819,233.35,233.7,232.5,234.2,231.5,234.2,232.7,.5,-1,58,94
20150820,234.2,232.7,235,238.5,235,237.75,237.05,5.05,4.35,40,90
20150821,237.75,237.05,239.4,245,239.4,243.75,242.25,6.7,5.2,36,90
20150824,243.75,242.25,240.9,243.7,240.5,241.4,242.5,-.85,.25,88,96
20150825,241.4,242.5,244.85,244.85,239.15,240.3,242.5,-2.2,0,230,76
20150826,240.3,242.5,239.5,239.5,237.2,237.6,238.1,-4.9,-4.4,40,80
20150827,237.6,238.1,234.85,236.85,232.85,235.3,234.95,-2.8,-3.15,54,74
20150828,235.3,234.95,232.95,242.1,232.1,235.8,234.75,.85,-.2,80,94
20150831,235.8,234.75,234.75,237.15,234.75,234.75,235.45,0,.7,16,106
20150901,234.75,235.45,234.7,238.75,234.7,237.65,237,2.2,1.55,32,104
20150902,237.65,237,238,238.35,236.1,237,237.6,0,.6,72,106
20150907,237,237.6,232.85,234.4,232.85,233.25,233.55,-4.35,-4.05,26,102
20150908,233.25,233.55,232.85,233.1,232.5,233.1,232.8,-.45,-.75,18,96
20150909,233.1,232.8,233.65,234.3,232.05,233.25,233.55,.45,.75,38,84
20150910,233.25,233.55,231.3,234,230.25,230.5,231,-3.05,-2.55,22,80
20150911,230.5,231,231.1,231.2,229.6,230.25,230.35,-.75,-.65,50,86
20150914,230.25,230.35,229.15,230.25,228.4,230.15,229.6,-.2,-.75,34,86
20150915,230.15,229.6,229.25,230.3,229.25,230.25,229.75,.65,.15,18,78
20150916,230.25,229.75,229.35,229.95,229.35,229.9,229.65,.15,-.1,36,50
20150917,229.9,229.65,233.05,233.45,233.05,233.1,233.25,3.45,3.6,30,36
20150918,233.1,233.25,233.25,235,233.25,234.5,234.25,1.25,1,18,40
20150921,234.5,234.25,236.1,236.1,236.1,236.1,236.1,1.85,1.85,22,58
20150922,236.1,236.1,235.5,235.5,235.25,235.5,235.35,-.6,-.75,10,58
20150923,235.5,235.35,234.5,234.5,234.15,234.15,234.25,-1.2,-1.1,10,62
20150924,234.15,234.25,235.8,237.35,235.55,236.65,235.8,2.4,1.55,44,44
20150925,236.65,235.8,238,239,238,238.35,238.4,2.55,2.6,34,42
20150928,238.35,238.4,,,,236.75,236.75,-1.65,-1.65,0,42
20150929,236.75,236.75,234.5,234.8,233.5,233.75,234.1,-3,-2.65,8,44
20150930,233.75,234.1,232,232.2,231.85,231.95,232,-2.15,-2.1,8,46
20151008,231.95,232,236,236.05,236,236,236,4,4,6,46
20151009,236,236,235.6,236.05,235.5,236.05,235.8,.05,-.2,8,46
20151012,236.05,235.8,237.2,239.35,237.1,239.35,237.8,3.55,2,44,58
20151013,239.35,237.8,238.75,239,236.85,236.85,238.25,-.95,.45,126,56
20151014,236.85,238.25,240.5,241.15,239.85,241.15,240.6,2.9,2.35,12,60
20151015,241.15,240.6,241.5,243.4,241.25,243.4,242.4,2.8,1.8,26,62
20151016,243.4,242.4,241,242.35,241,241.75,241.7,-.65,-.7,26,62
20151019,241.75,241.7,241.25,241.25,240.3,240.5,240.75,-1.2,-.95,24,72
20151020,240.5,240.75,240.9,240.9,239.95,240.25,240.25,-.5,-.5,14,70
20151021,240.25,240.25,241.25,241.5,241.25,241.5,241.3,1.25,1.05,10,68
20151022,241.5,241.3,240.15,240.8,239.3,240.5,240.3,-.8,-1,28,72
20151023,240.5,240.3,240.65,240.65,240.4,240.4,240.5,.1,.2,4,70
20151026,240.4,240.5,241.2,241.2,239.5,240,240.15,-.5,-.35,10,64
20151027,240,240.15,240,240.55,239.8,240.5,240,.35,-.15,46,74
20151028,240.5,240,240.75,241.95,240.75,241.95,241.35,1.95,1.35,24,68
20151029,241.95,241.35,240.55,240.65,239.5,240.15,239.7,-1.2,-1.65,230,238
20151030,240.15,239.7,239.15,239.2,236.8,237.25,237.7,-2.45,-2,92,266
20151102,237.25,237.7,236.1,236.1,234.3,235.05,235.15,-2.65,-2.55,106,266
20151103,235.05,235.15,234.75,234.75,234.05,234.05,234.25,-1.1,-.9,66,276
20151104,234.05,234.25,234.05,234.05,231.15,231.15,231.9,-3.1,-2.35,86,314
20151105,231.15,231.9,230.75,230.75,229.5,229.5,230.05,-2.4,-1.85,30,322
20151106,229.5,230.05,230.25,230.25,229.25,229.5,229.6,-.55,-.45,30,334
20151109,229.5,229.6,228.95,228.95,225.8,226.35,226.65,-3.25,-2.95,58,342
20151110,226.35,226.65,226.95,226.95,226.05,226.1,226.25,-.55,-.4,38,350
20151111,226.1,226.25,225.85,227,225.1,226.25,226.05,0,-.2,72,354
20151112,226.25,226.05,225.6,225.6,225.55,225.55,225.55,-.5,-.5,12,362
20151113,225.55,225.55,224.8,225.15,223.05,224.5,224.15,-1.05,-1.4,116,356
20151116,224.5,224.15,224.05,228.15,224.05,227.8,226.95,3.65,2.8,88,378
20151117,227.8,226.95,225.45,225.45,223.2,223.7,224.2,-3.25,-2.75,90,424
20151118,223.7,224.2,223.3,224.15,220.95,222.2,223.5,-2,-.7,312,464
20151119,222.2,223.5,221.9,223.35,221.9,223.3,223.05,-.2,-.45,16,474
20151120,223.3,223.05,222.65,225.9,222.65,225.9,224.45,2.85,1.4,98,468
20151123,225.9,224.45,224.9,225.2,221.55,221.75,222.85,-2.7,-1.6,34,454
20151124,221.75,222.85,222.05,222.4,221.7,222.4,222.05,-.45,-.8,14,458
20151125,222.4,222.05,223.75,224.1,223.05,224.1,223.75,2.05,1.7,62,478
20151126,224.1,223.75,221.35,224.35,221.35,222.9,222.3,-.85,-1.45,34,490
20151127,222.9,222.3,222.6,222.6,221.55,221.7,222.05,-.6,-.25,60,512
20151130,221.7,222.05,220.9,220.9,217.95,218.25,218.65,-3.8,-3.4,128,532
au1604,20150416,246.15,246.15,243.7,243.7,243.7,243.7,243.7,-2.45,-2.45,16,16
20150417,243.7,243.7,244.45,244.45,244.45,244.45,244.45,.75,.75,2,18
20150420,244.45,244.45,,,,246.05,246.05,1.6,1.6,0,18
20150421,246.05,246.05,243.65,244.15,243.65,244.15,243.95,-1.9,-2.1,6,22
20150422,244.15,243.95,,,,243.95,243.95,0,0,0,22
20150423,243.95,243.95,243.05,243.05,241.5,241.5,242.25,-2.45,-1.7,4,24
20150424,241.5,242.25,242.6,242.7,242.6,242.7,242.65,.45,.4,4,24
20150427,242.7,242.65,242.1,242.1,240.15,241.75,241,-.9,-1.65,14,34
20150428,241.75,241,243.2,246,241.95,245,243.7,4,2.7,14,34
20150429,245,243.7,245.8,249,245.8,246.8,247,3.1,3.3,24,34
20150430,246.8,247,247.35,247.35,243.35,246.4,246.3,-.6,-.7,18,36
20150504,246.4,246.3,239.8,242.95,239.8,242.2,241.95,-4.1,-4.35,24,40
20150505,242.2,241.95,242.95,243.25,242.85,242.85,243,.9,1.05,6,38
20150506,242.85,243,245.55,245.55,244.4,244.4,245.05,1.4,2.05,6,34
20150507,244.4,245.05,244.4,244.4,244.4,244.4,244.4,-.65,-.65,2,36
20150508,244.4,244.4,242.3,242.3,242.3,242.3,242.3,-2.1,-2.1,2,38
20150511,242.3,242.3,243.15,244.05,243.1,243.35,243.4,1.05,1.1,8,36
20150512,243.35,243.4,243.35,243.35,242.35,242.35,242.85,-1.05,-.55,4,40
20150513,242.35,242.85,,,,243.35,243.35,.5,.5,0,40
20150514,243.35,243.35,245.6,248.7,245.6,248.2,247.55,4.85,4.2,32,32
20150515,248.2,247.55,249.55,249.55,248.7,249,249.1,1.45,1.55,14,40
20150518,249,249.1,249.6,251.3,248.45,251.3,249.8,2.2,.7,22,44
20150519,251.3,249.8,249.5,249.75,249.5,249.75,249.6,-.05,-.2,4,46
20150520,249.75,249.6,248.45,248.45,246.2,246.4,246.85,-3.2,-2.75,42,50
20150521,246.4,246.85,247.3,247.3,247.2,247.2,247.25,.35,.4,4,50
20150522,247.2,247.25,247.2,247.2,245.05,246.05,246.1,-1.2,-1.15,6,50
20150525,246.05,246.1,245.55,246.4,245.55,246.4,246.1,.3,0,6,54
20150526,246.4,246.1,246.3,246.7,245.5,245.5,246.05,-.6,-.05,20,66
20150527,245.5,246.05,242.75,243.5,242.75,243.3,243.05,-2.75,-3,12,66
20150528,243.3,243.05,242.8,242.9,241.6,241.6,242.2,-1.45,-.85,22,58
20150529,241.6,242.2,242.3,243.05,241.5,243.05,242.85,.85,.65,28,56
20150601,243.05,242.85,,,,242.85,242.85,0,0,0,56
20150602,242.85,242.85,242.85,242.85,242.85,242.85,242.85,0,0,2,56
20150603,242.85,242.85,,,,242.85,242.85,0,0,0,56
20150604,242.85,242.85,241.65,241.65,241.65,241.65,241.65,-1.2,-1.2,2,56
20150605,241.65,241.65,240.25,240.3,239.85,240.05,240.1,-1.6,-1.55,10,54
20150608,240.05,240.1,239.8,240.05,239.8,240.05,239.9,-.05,-.2,4,52
20150609,240.05,239.9,,,,239.9,239.9,0,0,0,52
20150610,239.9,239.9,240.75,240.75,240,240,240.35,.1,.45,4,48
20150611,240,240.35,242.7,242.7,242.7,242.7,242.7,2.35,2.35,2,46
20150612,242.7,242.7,241.25,241.65,241.25,241.35,241.4,-1.35,-1.3,8,44
20150615,241.35,241.4,241.25,241.25,240.05,241.2,240.8,-.2,-.6,12,38
20150616,241.2,240.8,241.2,242,241.2,241.8,241.65,1,.85,6,38
20150617,241.8,241.65,240.9,240.95,240.6,240.6,240.8,-1.05,-.85,8,38
20150618,240.6,240.8,240.65,241.9,240.65,241.85,241.15,1.05,.35,46,38
20150619,241.85,241.15,244.8,244.8,243.25,243.25,244.15,2.1,3,14,26
20150623,243.25,244.15,241.65,242.55,241.1,241.1,241.75,-3.05,-2.4,6,26
20150624,241.1,241.75,240.5,241.25,240.35,240.4,240.55,-1.35,-1.2,10,36
20150625,240.4,240.55,239.8,240.5,238.35,240,239.6,-.55,-.95,66,32
20150626,240,239.6,239.55,239.55,239.55,239.55,239.55,-.05,-.05,2,34
20150629,239.55,239.55,241.7,241.7,240.3,241,241.2,1.45,1.65,10,30
20150630,241,241.2,240.25,240.25,240.25,240.25,240.25,-.95,-.95,2,28
20150701,240.25,240.25,,,,239.25,239.25,-1,-1,0,28
20150702,239.25,239.25,238.75,238.75,237.05,238,238.25,-1.25,-1,10,26
20150703,238,238.25,237.75,237.75,237.75,237.75,237.75,-.5,-.5,2,24
20150706,237.75,237.75,,,,237.3,237.3,-.45,-.45,0,24
20150707,237.3,237.3,238.4,238.9,238.4,238.9,238.65,1.6,1.35,4,26
20150708,238.9,238.65,234.55,236.6,232.55,234.8,235.25,-3.85,-3.4,28,30
20150709,234.8,235.25,237.3,239.75,235.8,237.9,237.85,2.65,2.6,10,28
20150710,237.9,237.85,237,238.2,237,237.05,237.6,-.8,-.25,12,28
20150713,237.05,237.6,,,,237.05,237.05,-.55,-.55,0,28
20150714,237.05,237.05,235.25,236,235.25,235.55,235.65,-1.5,-1.4,16,30
20150715,235.55,235.65,235.75,235.75,235.65,235.65,235.7,0,.05,4,30
20150716,235.65,235.7,,,,233.35,233.35,-2.35,-2.35,0,30
20150717,233.35,233.35,,,,232.9,232.9,-.45,-.45,0,30
20150720,232.9,232.9,229.3,229.3,225,227.5,226.4,-5.4,-6.5,50,44
20150721,227.5,226.4,224.4,226.6,224.4,224.8,225.45,-1.6,-.95,16,46
20150722,224.8,225.45,225.75,225.75,223.4,223.4,224.2,-2.05,-1.25,20,50
20150723,223.4,224.2,222.6,224,222.6,224,223.3,-.2,-.9,4,50
20150724,224,223.3,220.5,221.15,220.5,221.15,220.8,-2.15,-2.5,4,50
20150727,221.15,220.8,221.05,223.85,221.05,223.85,222.35,3.05,1.55,16,44
20150728,223.85,222.35,224.6,224.6,222.5,223.05,223.65,.7,1.3,30,46
20150729,223.05,223.65,223.85,224.4,222.9,224,223.9,.35,.25,14,42
20150730,224,223.9,224.15,224.2,223.6,223.6,224.05,-.3,.15,10,34
20150731,223.6,224.05,,,,221.75,221.75,-2.3,-2.3,0,34
20150803,221.75,221.75,,,,221.75,221.75,0,0,0,34
20150804,221.75,221.75,220.9,220.9,220.9,220.9,220.9,-.85,-.85,2,32
20150805,220.9,220.9,220.6,220.6,220.6,220.6,220.6,-.3,-.3,2,30
20150806,220.6,220.6,,,,220.6,220.6,0,0,0,30
20150807,220.6,220.6,,,,220.6,220.6,0,0,0,30
20150810,220.6,220.6,,,,220.6,220.6,0,0,0,30
20150811,220.6,220.6,,,,225,225,4.4,4.4,0,30
20150812,225,225,230.8,236.25,230.8,236.25,233.9,11.25,8.9,14,24
20150813,236.25,233.9,236.25,237.75,234.9,236,236.7,2.1,2.8,30,26
20150814,236,236.7,234.8,234.8,234.8,234.8,234.8,-1.9,-1.9,2,24
20150817,234.8,234.8,233.6,233.6,233.5,233.5,233.55,-1.3,-1.25,4,24
20150818,233.5,233.55,,,,233.55,233.55,0,0,0,24
20150819,233.55,233.55,233.95,235.6,233.95,234.55,234.7,1,1.15,12,26
20150820,234.55,234.7,234.7,237.85,234.7,237.85,236,3.15,1.3,6,22
20150821,237.85,236,243.05,243.05,242.1,242.1,242.55,6.1,6.55,4,24
20150824,242.1,242.55,241.7,245.75,240.75,245.75,242.95,3.2,.4,18,24
20150825,245.75,242.95,244.2,244.8,242.35,242.35,243.7,-.6,.75,20,26
20150826,242.35,243.7,,,,243.7,243.7,0,0,0,26
20150827,243.7,243.7,236.5,237,236.5,236.5,236.65,-7.2,-7.05,6,26
20150828,236.5,236.65,236.1,238.4,235.05,238.4,236.75,1.75,.1,24,30
20150831,238.4,236.75,,,,236.75,236.75,0,0,0,30
20150901,236.75,236.75,,,,236.75,236.75,0,0,0,30
20150902,236.75,236.75,,,,236.75,236.75,0,0,0,30
20150907,236.75,236.75,,,,236.75,236.75,0,0,0,30
20150908,236.75,236.75,234.65,234.65,234,234,234.3,-2.75,-2.45,12,30
20150909,234,234.3,232.55,236.8,232.55,235,234.45,.7,.15,16,30
20150910,235,234.45,232.5,232.5,232.5,232.5,232.5,-1.95,-1.95,2,32
20150911,232.5,232.5,232.25,232.25,232.25,232.25,232.25,-.25,-.25,2,32
20150914,232.25,232.25,,,,232.25,232.25,0,0,0,32
20150915,232.25,232.25,,,,232.25,232.25,0,0,0,32
20150916,232.25,232.25,,,,232.25,232.25,0,0,0,32
20150917,232.25,232.25,234,234,234,234,234,1.75,1.75,2,32
20150918,234,234,234,236.05,234,235.95,235.55,1.95,1.55,12,34
20150921,235.95,235.55,,,,237.4,237.4,1.85,1.85,0,34
20150922,237.4,237.4,,,,237.4,237.4,0,0,0,34
20150923,237.4,237.4,235,235,235,235,235,-2.4,-2.4,2,34
20150924,235,235,236.85,237.6,236.85,237.6,237.1,2.6,2.1,6,30
20150925,237.6,237.1,239.7,239.7,239.7,239.7,239.7,2.6,2.6,2,28
20150928,239.7,239.7,,,,238.05,238.05,-1.65,-1.65,0,28
20150929,238.05,238.05,,,,238.05,238.05,0,0,0,28
20150930,238.05,238.05,234.75,234.75,234.75,234.75,234.75,-3.3,-3.3,4,32
20151008,234.75,234.75,,,,238.8,238.8,4.05,4.05,0,32
20151009,238.8,238.8,237.9,237.9,237.75,237.75,237.8,-1.05,-1,4,34
20151012,237.75,237.8,237.85,241.8,237.85,240.4,240.25,2.6,2.45,10,38
20151013,240.4,240.25,,,,240.7,240.7,.45,.45,0,38
20151014,240.7,240.7,240.75,242.5,240.25,242.2,241.3,1.5,.6,44,38
20151015,242.2,241.3,243.55,244.15,243.55,244.15,243.85,2.85,2.55,4,36
20151016,244.15,243.85,243.2,243.2,242.9,243.1,243.1,-.75,-.75,12,34
20151019,243.1,243.1,243.45,243.45,241.9,241.9,242.85,-1.2,-.25,6,32
20151020,241.9,242.85,242.1,242.1,240.85,240.95,241.45,-1.9,-1.4,8,34
20151021,240.95,241.45,242.75,242.75,241.65,241.65,242.2,.2,.75,4,36
20151022,241.65,242.2,241.5,241.5,241.5,241.5,241.5,-.7,-.7,2,34
20151023,241.5,241.5,243.5,243.5,241.35,241.7,242.15,.2,.65,12,26
20151026,241.7,242.15,240.2,240.2,240.2,240.2,240.2,-1.95,-1.95,6,32
20151027,240.2,240.2,240.55,241.5,240.55,241.5,241,1.3,.8,20,34
20151028,241.5,241,242.6,243.1,242.6,243.1,242.8,2.1,1.8,10,34
20151029,243.1,242.8,245,245,240.5,240.5,242.7,-2.3,-.1,8,34
20151030,240.5,242.7,238.8,238.8,237.8,237.8,238.3,-4.9,-4.4,4,34
20151102,237.8,238.3,236.15,236.2,235,236.15,235.5,-2.15,-2.8,22,34
20151103,236.15,235.5,235.15,235.15,234.55,235.05,234.9,-.45,-.6,6,36
20151104,235.05,234.9,234,234,232,232,232.7,-2.9,-2.2,6,34
20151105,232,232.7,231.95,231.95,229.8,229.8,230.6,-2.9,-2.1,12,40
20151106,229.8,230.6,229.75,230.15,229.75,230.05,230,-.55,-.6,10,38
20151109,230.05,230,228.95,228.95,227.75,228,228.25,-2,-1.75,16,36
20151110,228,228.25,226.95,227.15,226.35,227.15,226.8,-1.1,-1.45,18,40
20151111,227.15,226.8,226.8,227.35,226.65,226.65,227.05,-.15,.25,12,40
20151112,226.65,227.05,226.35,226.45,226.35,226.45,226.4,-.6,-.65,4,40
20151113,226.45,226.4,225.6,225.6,223.8,224.85,224.7,-1.55,-1.7,26,44
20151116,224.85,224.7,227.65,228.6,227.65,228.6,228.05,3.9,3.35,12,48
20151117,228.6,228.05,224.85,225.6,224.85,225.2,225.2,-2.85,-2.85,14,46
20151118,225.2,225.2,221.8,222.4,221.4,222.4,221.7,-2.8,-3.5,16,40
20151119,222.4,221.7,221.85,222.5,221.85,222.5,222.15,.8,.45,4,40
20151120,222.5,222.15,225.55,225.55,224.95,225.1,225.25,2.95,3.1,8,44
20151123,225.1,225.25,226.05,226.05,222,222.75,224.3,-2.5,-.95,10,42
20151124,222.75,224.3,222.7,222.95,222,222.65,222.55,-1.65,-1.75,26,46
20151125,222.65,222.55,227,227,224.4,225.35,224.8,2.8,2.25,36,52
20151126,225.35,224.8,223.1,223.5,220.6,223.5,221.95,-1.3,-2.85,8,54
20151127,223.5,221.95,,,,221.95,221.95,0,0,0,54
20151130,221.95,221.95,221.45,221.45,218.75,218.75,219.5,-3.2,-2.45,22,66
au1606,20150518,249.1,249.1,246.8,249.8,246.8,249.8,248.3,.7,-.8,4,2
20150519,249.8,248.3,,,,248.3,248.3,0,0,0,2
20150520,248.3,248.3,249.95,249.95,244.55,247.2,247.25,-1.1,-1.05,82,14
20150521,247.2,247.25,247.5,248.55,247.45,247.75,248,.5,.75,12,16
20150522,247.75,248,245.95,247.1,245.6,247,246.2,-1,-1.8,20,26
20150525,247,246.2,245.95,246.65,243.9,246.65,245.4,.45,-.8,62,46
20150526,246.65,245.4,246.5,247.65,245.4,245.4,246.65,0,1.25,46,58
20150527,245.4,246.65,245.4,245.4,243.05,244.1,244.2,-2.55,-2.45,52,70
20150528,244.1,244.2,244.75,244.75,243.55,243.55,244,-.65,-.2,26,78
20150529,243.55,244,242.6,244.9,242.6,243.55,243.95,-.45,-.05,36,94
20150601,243.55,243.95,243.8,244,243.8,243.85,243.8,-.1,-.15,14,106
20150602,243.85,243.8,244.25,246.15,243.5,244,244.85,.2,1.05,48,106
20150603,244,244.85,244,244.75,244,244,244.4,-.85,-.45,104,178
20150604,244,244.4,244.45,246,241.75,242.6,243.35,-1.8,-1.05,162,252
20150605,242.6,243.35,241.55,242.15,240.5,241.25,241.15,-2.1,-2.2,80,282
20150608,241.25,241.15,239.45,241.75,238.6,241.55,240.1,.4,-1.05,98,296
20150609,241.55,240.1,241.55,241.75,240.3,241.4,240.95,1.3,.85,100,320
20150610,241.4,240.95,242.95,242.95,240.85,242.1,241.55,1.15,.6,118,318
20150611,242.1,241.55,243.6,244.2,241.85,243.1,243.45,1.55,1.9,76,324
20150612,243.1,243.45,242.9,242.9,241.7,242.35,242.15,-1.1,-1.3,22,318
20150615,242.35,242.15,241.85,242.75,241.35,242.75,241.85,.6,-.3,48,320
20150616,242.75,241.85,242.4,243.85,242,243.85,243.15,2,1.3,88,340
20150617,243.85,243.15,242.45,242.45,241.2,241.65,241.8,-1.5,-1.35,92,370
20150618,241.65,241.8,241.25,243.75,240.05,243.15,241.9,1.35,.1,100,350
20150619,243.15,241.9,245.3,245.8,244.75,245.05,245.3,3.15,3.4,74,346
20150623,245.05,245.3,242.5,243.1,242.35,242.9,242.7,-2.4,-2.6,50,340
20150624,242.9,242.7,241,241.45,240.7,241.45,241.1,-1.25,-1.6,74,378
20150625,241.45,241.1,240.35,241.65,240.35,241.05,240.85,-.05,-.25,108,398
20150626,241.05,240.85,240.5,241.25,240.3,240.65,240.75,-.2,-.1,190,450
20150629,240.65,240.75,240.3,243.45,239.8,242.05,241.55,1.3,.8,146,432
20150630,242.05,241.55,242.1,242.15,240.85,241.25,241.3,-.3,-.25,162,442
20150701,241.25,241.3,240.5,241.95,239.75,240.8,240.6,-.5,-.7,230,500
20150702,240.8,240.6,239.85,241.25,239.05,239.25,239.8,-1.35,-.8,148,510
20150703,239.25,239.8,239.8,240.35,239.1,240.15,239.65,.35,-.15,114,488
20150706,240.15,239.65,239.8,240.35,239.45,239.95,239.95,.3,.3,118,484
20150707,239.95,239.95,239.3,241.05,239.3,240.4,240,.45,.05,122,518
20150708,240.4,240,238.5,238.5,232.45,234.1,235.45,-5.9,-4.55,546,444
20150709,234.1,235.45,235.85,239.25,235.35,238,237.3,2.55,1.85,224,424
20150710,238,237.3,249,249,237.2,238.05,238.6,.75,1.3,110,398
20150713,238.05,238.6,237.55,238,237.5,237.7,237.7,-.9,-.9,52,406
20150714,237.7,237.7,237,237.25,236,236.1,236.45,-1.6,-1.25,162,468
20150715,236.1,236.45,236.7,237.15,236.35,236.65,236.6,.2,.15,68,484
20150716,236.65,236.6,235.65,235.7,233.95,234.6,234.8,-2,-1.8,148,522
20150717,234.6,234.8,233.75,234.85,233.65,234.4,234.2,-.4,-.6,114,528
20150720,234.4,234.2,232.8,233.4,223.65,228.95,229.05,-5.25,-5.15,846,738
20150721,228.95,229.05,227.4,227.85,225.9,226.35,226.55,-2.7,-2.5,358,804
20150722,226.35,226.55,226.25,227.5,222.9,223.9,225.25,-2.65,-1.3,480,844
20150723,223.9,225.25,223.9,225.3,222.65,224.5,223.75,-.75,-1.5,290,856
20150724,224.5,223.75,224.2,224.85,220.2,222.3,222.45,-1.45,-1.3,544,932
20150727,222.3,222.45,221.75,226.2,221.2,226.2,224.3,3.75,1.85,536,930
20150728,226.2,224.3,224.35,225.7,223.6,224.25,224.35,-.05,.05,664,982
20150729,224.25,224.35,224.1,224.95,223.8,224.75,224.45,.4,.1,376,1152
20150730,224.75,224.45,224.3,225.85,221.3,222,223.45,-2.45,-1,652,1242
20150731,222,223.45,222,224.25,221.05,221.05,222.6,-2.4,-.85,920,1278
20150803,221.05,222.6,223.4,225.25,222.25,224.2,223.65,1.6,1.05,580,1280
20150804,224.2,223.65,222.8,223.35,220.6,222.2,222.1,-1.45,-1.55,548,1354
20150805,222.2,222.1,222.75,223.15,221.4,221.9,221.95,-.2,-.15,188,1336
20150806,221.9,221.95,222.4,222.4,220.85,221.25,221.1,-.7,-.85,532,1540
20150807,221.25,221.1,221.35,223.85,221.2,223.65,222.1,2.55,1,516,1660
20150810,223.65,222.1,220.9,224.35,220.75,223.95,223.4,1.85,1.3,518,1680
20150811,223.95,223.4,223.85,229.8,223.85,229,227.9,5.6,4.5,2098,2176
20150812,229,227.9,229,239,229,238.2,235.85,10.3,7.95,4110,2830
20150813,238.2,235.85,238.3,239.2,235.7,236.4,237.45,.55,1.6,2402,3306
20150814,236.4,237.45,234.05,235.9,233.35,235.2,234.65,-2.25,-2.8,1002,3402
20150817,235.2,234.65,235.65,235.8,232.7,235.3,234.2,.65,-.45,932,3408
20150818,235.3,234.2,235.75,236,234.5,235.2,235.3,1,1.1,722,3498
20150819,235.2,235.3,234.35,236.45,233.3,236.35,235,1.05,-.3,1766,3824
20150820,236.35,235,235.95,240.6,235.95,240,238.15,5,3.15,3958,4992
20150821,240,238.15,240.25,246,240.25,243.75,243.5,5.6,5.35,4836,6172
20150824,243.75,243.5,243.05,246,241.7,242.85,243.9,-.65,.4,5810,6136
20150825,242.85,243.9,243.7,246.95,241.15,242.4,244.1,-1.5,.2,5484,6692
20150826,242.4,244.1,243.25,243.25,238.95,239.75,240.2,-4.35,-3.9,3818,6752
20150827,239.75,240.2,237.6,238.45,235.7,237.7,237.15,-2.5,-3.05,1980,6798
20150828,237.7,237.15,236.35,238.9,236,238.35,237.75,1.2,.6,2422,7014
20150831,238.35,237.75,237.8,240.3,236.8,238.4,238.9,.65,1.15,2588,7260
20150901,238.4,238.9,237.95,240,236.35,239.4,238.85,.5,-.05,1556,7560
20150902,239.4,238.85,240.5,240.55,237.8,239.3,238.95,.45,.1,2000,7710
20150907,239.3,238.95,233.65,236.2,233.65,235.85,235.85,-3.1,-3.1,2750,8644
20150908,235.85,235.85,235.5,235.8,234.6,235.4,235.55,-.45,-.3,2208,9586
20150909,235.4,235.55,235.9,237.1,235.75,236,236.2,.45,.65,1922,9510
20150910,236,236.2,235.05,235.25,231.85,232.75,233.05,-3.45,-3.15,2472,9730
20150911,232.75,233.05,233.1,233.85,232.15,232.3,232.6,-.75,-.45,3648,8972
20150914,232.3,232.6,231.9,232.4,230.4,232.05,231.4,-.55,-1.2,940,9052
20150915,232.05,231.4,231.4,232.75,231.2,232,232.05,.6,.65,588,9058
20150916,232,232.05,231.95,232.25,231.45,232.15,231.7,.1,-.35,616,9176
20150917,232.15,231.7,234.05,235.75,233.25,234.15,234.5,2.45,2.8,5512,9006
20150918,234.15,234.5,233.55,236.6,233.5,235.15,235.6,.65,1.1,6034,9966
20150921,235.15,235.6,237.5,242,236.45,237.7,237.2,2.1,1.6,2292,9976
20150922,237.7,237.2,236.45,237.05,236.3,236.5,236.65,-.7,-.55,970,10138
20150923,236.5,236.65,234.85,235.7,234.25,235.7,234.9,-.95,-1.75,2232,10668
20150924,235.7,234.9,238.75,238.75,236.1,237.85,237.2,2.95,2.3,1644,10784
20150925,237.85,237.2,238.4,241.3,238.15,239.5,240.05,2.3,2.85,6136,12046
20150928,239.5,240.05,239.25,239.4,236.95,237.1,238.7,-2.95,-1.35,1194,12276
20150929,237.1,238.7,235,236.65,234.25,234.85,235.55,-3.85,-3.15,3750,11486
20150930,234.85,235.55,235.5,235.6,233.1,233.15,234.2,-2.4,-1.35,2102,11616
20151008,233.15,234.2,238.3,238.3,236.9,237.2,237.45,3,3.25,2114,12424
20151009,237.2,237.45,236.4,238.8,236.25,237.2,237.3,-.25,-.15,4352,13628
20151012,237.2,237.3,239.25,241,237.75,240.8,239.3,3.5,2,8476,17010
20151013,240.8,239.3,241.1,241.1,237.95,238.8,239.15,-.5,-.15,4398,17750
20151014,238.8,239.15,239.85,242.8,239.15,242.55,241.6,3.4,2.45,7398,19988
20151015,242.55,241.6,242.65,244.75,242,243.75,243.25,2.15,1.65,9976,23486
20151016,243.75,243.25,242.95,244.85,242.2,242.9,243.35,-.35,.1,9686,26428
20151019,242.9,243.35,243.1,244.2,241.6,242.1,242.6,-1.25,-.75,4814,26688
20151020,242.1,242.6,242.4,243.1,240.55,241.9,241.6,-.7,-1,10048,29094
20151021,241.9,241.6,242.05,243.45,241.45,242.2,242.55,.6,.95,6522,30624
20151022,242.2,242.55,242.35,242.65,240.7,241.6,241.2,-.95,-1.35,9202,32544
20151023,241.6,241.2,240.95,242.9,240.65,242.9,241.8,1.7,.6,7174,34244
20151026,242.9,241.8,243.1,243.45,239.9,240.55,241.05,-1.25,-.75,9796,35426
20151027,240.55,241.05,241.1,242,240.5,241.7,241.35,.65,.3,20590,44508
20151028,241.7,241.35,241.3,243.7,241.05,243.6,242.65,2.25,1.3,24948,55716
20151029,243.6,242.65,244.1,245.7,240.45,241,242.55,-1.65,-.1,29504,62502
20151030,241,242.55,239.9,240.4,237.3,237.3,238.65,-5.25,-3.9,30296,71130
20151102,237.3,238.65,236.5,236.65,234.55,236.45,235.8,-2.2,-2.85,31958,74586
20151103,236.45,235.8,235.9,236.15,235.05,235.5,235.5,-.3,-.3,21414,78688
20151104,235.5,235.5,234.7,234.75,231.3,232.15,232.85,-3.35,-2.65,37638,86634
20151105,232.15,232.85,231.7,232.65,230,230.15,231.1,-2.7,-1.75,46936,90668
20151106,230.15,231.1,230,231,229.65,230.7,230.3,-.4,-.8,38236,92284
20151109,230.7,230.3,230.75,230.85,226.05,227.2,227.4,-3.1,-2.9,67462,107322
20151110,227.2,227.4,227.3,227.75,226.45,227.15,227.05,-.25,-.35,43622,119732
20151111,227.15,227.05,226.95,227.7,225.65,227.2,226.95,.15,-.1,67062,131396
20151112,227.2,226.95,227.05,227.05,226,226.35,226.55,-.6,-.4,46310,141386
20151113,226.35,226.55,225.35,226.4,223.6,225.3,224.9,-1.25,-1.65,121770,136892
20151116,225.3,224.9,225.3,228.85,224.85,228.75,226.95,3.85,2.05,121480,146096
20151117,228.75,226.95,227.95,228,223.9,224.5,225.6,-2.45,-1.35,145864,159018
20151118,224.5,225.6,224.5,225.55,221.35,223.1,223.15,-2.5,-2.45,187126,164990
20151119,223.1,223.15,222.85,224.6,222,224.4,223.35,1.25,.2,133616,168638
20151120,224.4,223.35,223.35,226.3,222.5,225.9,224.8,2.55,1.45,174986,167922
20151123,225.9,224.8,225.65,226.65,222.3,222.95,224,-1.85,-.8,192624,186712
20151124,222.95,224,222.9,223.85,221.75,223.1,222.75,-.9,-1.25,180118,192434
20151125,223.1,222.75,224,225.75,223.7,224.95,224.9,2.2,2.15,257482,199628
20151126,224.95,224.9,224,224.3,222.6,223.55,223.35,-1.35,-1.55,218074,208140
20151127,223.55,223.35,223.4,223.9,222.2,222.95,223.15,-.4,-.2,139772,219492
20151130,222.95,223.15,222.5,222.55,218.8,219.15,219.95,-4,-3.2,342424,266378
au1608,20150716,236.6,236.6,,,,234.8,234.8,-1.8,-1.8,0,0
20150717,234.8,234.8,230.4,236.45,230.4,236.45,233.4,1.65,-1.4,4,2
20150720,236.45,233.4,230,230,224.15,226.4,226.75,-7,-6.65,8,8
20150721,226.4,226.75,,,,224.3,224.3,-2.45,-2.45,0,8
20150722,224.3,224.3,,,,223,223,-1.3,-1.3,0,8
20150723,223,223,,,,221.55,221.55,-1.45,-1.45,0,8
20150724,221.55,221.55,,,,220.25,220.25,-1.3,-1.3,0,8
20150727,220.25,220.25,,,,222.1,222.1,1.85,1.85,0,8
20150728,222.1,222.1,,,,222.15,222.15,.05,.05,0,8
20150729,222.15,222.15,,,,222.25,222.25,.1,.1,0,8
20150730,222.25,222.25,223.55,223.55,223.55,223.55,223.55,1.3,1.3,2,8
20150731,223.55,223.55,,,,223.55,223.55,0,0,0,8
20150803,223.55,223.55,223.3,224.7,223.25,223.25,223.75,-.3,.2,6,8
20150804,223.25,223.75,,,,223.75,223.75,0,0,0,8
20150805,223.75,223.75,,,,223.75,223.75,0,0,0,8
20150806,223.75,223.75,221.9,221.9,221.9,221.9,221.9,-1.85,-1.85,2,10
20150807,221.9,221.9,223.5,224.25,221.8,223.8,223.1,1.9,1.2,42,16
20150810,223.8,223.1,222.25,224.2,222.25,224.2,223.5,1.1,.4,10,16
20150811,224.2,223.5,229.4,230,229.4,230,229.6,6.5,6.1,6,18
20150812,230,229.6,233.25,237.3,233.25,237.3,235.65,7.7,6.05,8,20
20150813,237.3,235.65,238.5,239.2,236.85,238.25,238.4,2.6,2.75,10,22
20150814,238.25,238.4,236.75,236.75,236.4,236.4,236.45,-2,-1.95,10,20
20150817,236.4,236.45,,,,236,236,-.45,-.45,0,20
20150818,236,236,,,,237.1,237.1,1.1,1.1,0,20
20150819,237.1,237.1,234.3,235,234.3,235,234.75,-2.1,-2.35,8,22
20150820,235,234.75,,,,237.9,237.9,3.15,3.15,0,22
20150821,237.9,237.9,242,246.05,242,246.05,244.55,8.15,6.65,16,18
20150824,246.05,244.55,244.65,246.6,242.65,243.65,244.9,-.9,.35,38,30
20150825,243.65,244.9,242.2,244.4,242.2,244.25,243.6,-.65,-1.3,6,30
20150826,244.25,243.6,240.05,240.05,240.05,240.05,240.05,-3.55,-3.55,4,26
20150827,240.05,240.05,237.9,237.9,237.25,237.25,237.55,-2.8,-2.5,4,26
20150828,237.25,237.55,,,,238.15,238.15,.6,.6,0,26
20150831,238.15,238.15,,,,239.3,239.3,1.15,1.15,0,26
20150901,239.3,239.3,237.35,237.5,237.35,237.5,237.4,-1.8,-1.9,4,26
20150902,237.5,237.4,,,,237.5,237.5,.1,.1,0,26
20150907,237.5,237.5,,,,234.45,234.45,-3.05,-3.05,0,26
20150908,234.45,234.45,,,,234.15,234.15,-.3,-.3,0,26
20150909,234.15,234.15,236.65,236.65,236.05,236.05,236.4,1.9,2.25,6,26
20150910,236.05,236.4,233.75,233.75,232.8,233.2,233.25,-3.2,-3.15,6,24
20150911,233.2,233.25,,,,232.8,232.8,-.45,-.45,0,24
20150914,232.8,232.8,232.65,232.65,232.65,232.65,232.65,-.15,-.15,2,22
20150915,232.65,232.65,,,,233.3,233.3,.65,.65,0,22
20150916,233.3,233.3,,,,232.95,232.95,-.35,-.35,0,22
20150917,232.95,232.95,235.1,235.1,235.1,235.1,235.1,2.15,2.15,2,22
20150918,235.1,235.1,236.35,236.35,236.35,236.35,236.35,1.25,1.25,4,22
20150921,236.35,236.35,,,,237.95,237.95,1.6,1.6,0,22
20150922,237.95,237.95,,,,237.35,237.35,-.6,-.6,0,22
20150923,237.35,237.35,,,,235.6,235.6,-1.75,-1.75,0,22
20150924,235.6,235.6,,,,237.9,237.9,2.3,2.3,0,22
20150925,237.9,237.9,,,,240.75,240.75,2.85,2.85,0,22
20150928,240.75,240.75,239.2,239.2,239.2,239.2,239.2,-1.55,-1.55,2,22
20150929,239.2,239.2,236.6,236.6,236.6,236.6,236.6,-2.6,-2.6,2,22
20150930,236.6,236.6,234.75,234.75,234.75,234.75,234.75,-1.85,-1.85,2,24
20151008,234.75,234.75,,,,238,238,3.25,3.25,0,24
20151009,238,238,237.6,237.6,237.6,237.6,237.6,-.4,-.4,2,22
20151012,237.6,237.6,,,,237.6,237.6,0,0,0,22
20151013,237.6,237.6,238.65,238.65,238.65,238.65,238.65,1.05,1.05,2,20
20151014,238.65,238.65,243.4,243.4,242.5,242.75,242.85,4.1,4.2,12,28
20151015,242.75,242.85,243.4,245.1,243.25,244.85,244.25,2,1.4,14,34
20151016,244.85,244.25,243.75,243.75,243.3,243.3,243.5,-.95,-.75,8,26
20151019,243.3,243.5,,,,242.75,242.75,-.75,-.75,0,26
20151020,242.75,242.75,243.25,243.25,242,242,243.1,-.75,.35,24,26
20151021,242,243.1,242.1,243.55,242.1,242.95,242.95,-.15,-.15,10,32
20151022,242.95,242.95,242.55,242.7,241.6,242.7,242.05,-.25,-.9,14,24
20151023,242.7,242.05,,,,242.65,242.65,.6,.6,0,24
20151026,242.65,242.65,241.1,241.1,241.1,241.1,241.1,-1.55,-1.55,2,24
20151027,241.1,241.1,241.9,242.3,241.9,242.3,242.15,1.2,1.05,6,20
20151028,242.3,242.15,242.7,244.1,242.1,243.9,242.95,1.75,.8,30,26
20151029,243.9,242.95,242,242.25,241.8,242.15,242.05,-.8,-.9,18,24
20151030,242.15,242.05,240.5,240.5,240.5,240.5,240.5,-1.55,-1.55,2,24
20151102,240.5,240.5,237.05,239,234.5,236.85,236.5,-3.65,-4,26,26
20151103,236.85,236.5,,,,236.5,236.5,0,0,0,26
20151104,236.5,236.5,,,,236.5,236.5,0,0,0,26
20151105,236.5,236.5,,,,236.5,236.5,0,0,0,26
20151106,236.5,236.5,231.4,231.4,231.4,231.4,231.4,-5.1,-5.1,6,26
20151109,231.4,231.4,230.4,230.4,228.05,228.05,228.75,-3.35,-2.65,14,34
20151110,228.05,228.75,,,,228.75,228.75,0,0,0,34
20151111,228.75,228.75,,,,228.2,228.2,-.55,-.55,0,34
20151112,228.2,228.2,,,,228.2,228.2,0,0,0,34
20151113,228.2,228.2,226.15,226.95,225.25,225.85,226.05,-2.35,-2.15,20,30
20151116,225.85,226.05,226.1,229.1,226.05,229.1,226.95,3.05,.9,10,28
20151117,229.1,226.95,225,225,225,225,225,-1.95,-1.95,6,30
20151118,225,225,223.55,225.9,223,223,224.05,-2,-.95,46,48
20151119,223,224.05,223.5,225.25,223.5,225.25,224.6,1.2,.55,6,44
20151120,225.25,224.6,225.25,227.25,225.25,226.1,226.25,1.5,1.65,8,42
20151123,226.1,226.25,227.3,227.3,223.95,223.95,225.3,-2.3,-.95,6,42
20151124,223.95,225.3,223.45,223.75,222.65,223.5,223.3,-1.8,-2,8,40
20151125,223.5,223.3,225.95,225.95,225.95,225.95,225.95,2.65,2.65,2,38
20151126,225.95,225.95,,,,225.95,225.95,0,0,0,38
20151127,225.95,225.95,,,,225.95,225.95,0,0,0,38
20151130,225.95,225.95,220.05,220.75,220.05,220.75,220.4,-5.2,-5.55,4,38
au1610,20150916,233.3,233.3,,,,232.95,232.95,-.35,-.35,0,0
20150917,232.95,232.95,,,,235.1,235.1,2.15,2.15,0,0
20150918,235.1,235.1,,,,236.35,236.35,1.25,1.25,0,0
20150921,236.35,236.35,,,,237.95,237.95,1.6,1.6,0,0
20150922,237.95,237.95,,,,237.35,237.35,-.6,-.6,0,0
20150923,237.35,237.35,,,,235.6,235.6,-1.75,-1.75,0,0
20150924,235.6,235.6,,,,237.9,237.9,2.3,2.3,0,0
20150925,237.9,237.9,,,,240.75,240.75,2.85,2.85,0,0
20150928,240.75,240.75,236.75,236.75,236.75,236.75,236.75,-4,-4,2,2
20150929,236.75,236.75,238.7,238.7,238.7,238.7,238.7,1.95,1.95,2,2
20150930,238.7,238.7,,,,236.8,236.8,-1.9,-1.9,0,2
20151008,236.8,236.8,,,,240.1,240.1,3.3,3.3,0,2
20151009,240.1,240.1,235.85,237.6,234.85,237.6,235.65,-2.5,-4.45,1672,966
20151012,237.6,235.65,238.75,242.6,238.5,240.85,240.15,5.2,4.5,960,236
20151013,240.85,240.15,240.3,240.5,239.95,239.95,240.25,-.2,.1,6,230
20151014,239.95,240.25,,,,244.5,244.5,4.25,4.25,0,230
20151015,244.5,244.5,244.8,245.55,244.8,245.55,245.2,1.05,.7,10,228
20151016,245.55,245.2,243.95,244,243.95,243.95,243.95,-1.25,-1.25,12,218
20151019,243.95,243.95,244.25,244.75,242.95,242.95,243.75,-1,-.2,12,216
20151020,242.95,243.75,243.35,243.85,242.25,242.25,243,-1.5,-.75,10,220
20151021,242.25,243,242.85,243.25,242.85,243.25,243.05,.25,.05,4,220
20151022,243.25,243.05,243.35,243.35,241.95,241.95,242.45,-1.1,-.6,26,202
20151023,241.95,242.45,,,,243.05,243.05,.6,.6,0,202
20151026,243.05,243.05,242.7,242.7,241.75,242,242.35,-1.05,-.7,10,206
20151027,242,242.35,241.65,242.3,241.65,242.3,241.8,-.05,-.55,16,190
20151028,242.3,241.8,243.25,244.1,243.25,244.1,243.65,2.3,1.85,4,194
20151029,244.1,243.65,245.7,245.7,241.35,241.35,242.8,-2.3,-.85,6,188
20151030,241.35,242.8,239,239.05,238.8,238.8,238.95,-4,-3.85,16,192
20151102,238.8,238.95,236.4,236.95,236,236.95,236.55,-2,-2.4,22,184
20151103,236.95,236.55,,,,236.55,236.55,0,0,0,184
20151104,236.55,236.55,232.75,232.75,232.75,232.75,232.75,-3.8,-3.8,4,182
20151105,232.75,232.75,,,,231,231,-1.75,-1.75,0,182
20151106,231,231,230.35,231.3,230.35,231.25,231.15,.25,.15,30,188
20151109,231.25,231.15,231.05,231.05,227.75,228.25,228.6,-2.9,-2.55,76,140
20151110,228.25,228.6,227.8,227.8,227.65,227.65,227.7,-.95,-.9,10,134
20151111,227.65,227.7,227.55,228.5,226.6,228.5,228,.8,.3,102,100
20151112,228.5,228,227.55,227.55,227.35,227.35,227.4,-.65,-.6,8,100
20151113,227.35,227.4,226.25,226.5,225.6,226,226,-1.4,-1.4,32,102
20151116,226,226,226.5,229.5,226.5,229.5,227.65,3.5,1.65,68,148
20151117,229.5,227.65,227,227,226.15,226.55,226.55,-1.1,-1.1,16,146
20151118,226.55,226.55,222.9,223.25,222.5,223.25,223,-3.3,-3.55,12,152
20151119,223.25,223,223.65,225.75,223.65,225.75,223.75,2.75,.75,62,106
20151120,225.75,223.75,224.65,224.65,224,224.5,224.3,.75,.55,12,104
20151123,224.5,224.3,224.6,224.6,222.75,223.6,223.85,-.7,-.45,10,102
20151124,223.6,223.85,223.8,224,223.8,224,223.9,.15,.05,4,104
20151125,224,223.9,225.8,226.2,225.8,226.2,226.05,2.3,2.15,52,98
20151126,226.2,226.05,224.8,225,224.8,225,224.85,-1.05,-1.2,6,96
20151127,225,224.85,223.05,224,223.05,224,223.5,-.85,-1.35,8,96
20151130,224,223.5,223,223,219.75,220.75,221.05,-2.75,-2.45,14,98
au1612,20151117,227.65,227.65,227.35,227.35,224.95,224.95,226.85,-2.7,-.8,10,10
20151118,224.95,226.85,228.25,228.25,224.35,224.35,225.1,-2.5,-1.75,10,20
20151119,224.35,225.1,222.1,224.35,222.1,224.35,223.15,-.75,-1.95,8,20
20151120,224.35,223.15,225.25,228.2,224.85,227.2,226.05,4.05,2.9,26,26
20151123,227.2,226.05,223.85,224.7,223.85,224.1,224.2,-1.95,-1.85,6,28
20151124,224.1,224.2,,,,224.2,224.2,0,0,0,28
20151125,224.2,224.2,226.25,229.55,226.2,227.1,227.5,2.9,3.3,32,44
20151126,227.1,227.5,225.8,226.15,225,226.15,225.75,-1.35,-1.75,42,48
20151127,226.15,225.75,224.95,225.25,224.45,225,224.95,-.75,-.8,36,48
20151130,225,224.95,223.8,224.8,220.6,221.4,222.4,-3.55,-2.55,66,62
bu1501,20150105,3528,3528,3520,3520,3518,3518,3518,-10,-10,4,10
20150106,3518,3518,,,,3518,3518,0,0,0,10
20150107,3518,3518,,,,3518,3518,0,0,0,10
20150108,3518,3518,,,,3518,3518,0,0,0,10
20150109,3518,3518,3478,3692,3478,3692,3584,174,66,4,8
20150112,3692,3584,3692,3692,3692,3692,3692,108,108,8,0
20150113,3692,3692,,,,3692,3692,0,0,0,0
20150114,3692,3692,,,,3692,3692,0,0,0,0
20150115,3692,3692,,,,3692,3692,0,0,0,0
bu1502,20150105,3484,3484,,,,3474,3474,-10,-10,0,0
20150106,3474,3474,,,,3474,3474,0,0,0,0
20150107,3474,3474,,,,3474,3474,0,0,0,0
20150108,3474,3474,,,,3474,3474,0,0,0,0
20150109,3474,3474,,,,3540,3540,66,66,0,0
20150112,3540,3540,,,,3646,3646,106,106,0,0
20150113,3646,3646,,,,3646,3646,0,0,0,0
20150114,3646,3646,,,,3646,3646,0,0,0,0
20150115,3646,3646,,,,3646,3646,0,0,0,0
20150116,3646,3646,,,,3646,3646,0,0,0,0
20150119,3646,3646,,,,3646,3646,0,0,0,0
20150120,3646,3646,,,,3646,3646,0,0,0,0
20150121,3646,3646,,,,3646,3646,0,0,0,0
20150122,3646,3646,,,,3646,3646,0,0,0,0
20150123,3646,3646,,,,3646,3646,0,0,0,0
20150126,3646,3646,,,,3646,3646,0,0,0,0
20150127,3646,3646,,,,3646,3646,0,0,0,0
20150128,3646,3646,,,,3646,3646,0,0,0,0
20150129,3646,3646,,,,3646,3646,0,0,0,0
20150130,3646,3646,,,,3646,3646,0,0,0,0
20150202,3646,3646,,,,3646,3646,0,0,0,0
20150203,3646,3646,,,,3646,3646,0,0,0,0
20150204,3646,3646,,,,3646,3646,0,0,0,0
20150205,3646,3646,,,,3646,3646,0,0,0,0
20150206,3646,3646,,,,3646,3646,0,0,0,0
20150209,3646,3646,,,,3646,3646,0,0,0,0
20150210,3646,3646,,,,3646,3646,0,0,0,0
bu1503,20150105,3450,3450,,,,3450,3450,0,0,0,20
20150106,3450,3450,,,,3450,3450,0,0,0,20
20150107,3450,3450,,,,3450,3450,0,0,0,20
20150108,3450,3450,,,,3450,3450,0,0,0,20
20150109,3450,3450,,,,3450,3450,0,0,0,20
20150112,3450,3450,,,,3450,3450,0,0,0,20
20150113,3450,3450,,,,3450,3450,0,0,0,20
20150114,3450,3450,3276,3276,3276,3276,3276,-174,-174,4,20
20150115,3276,3276,,,,3276,3276,0,0,0,20
20150116,3276,3276,3150,3424,3112,3270,3256,-6,-20,14,20
20150119,3270,3256,3358,3358,3100,3350,3282,94,26,14,20
20150120,3350,3282,,,,3282,3282,0,0,0,20
20150121,3282,3282,3280,3280,3120,3120,3200,-162,-82,4,20
20150122,3120,3200,3350,3350,3040,3040,3092,-160,-108,34,30
20150123,3040,3092,2846,2948,2844,2870,2856,-222,-236,28,46
20150126,2870,2856,2776,2840,2712,2712,2760,-144,-96,26,48
20150127,2712,2760,2630,2716,2630,2716,2686,-44,-74,6,48
20150128,2716,2686,2686,2708,2632,2632,2686,-54,0,24,34
20150129,2632,2686,,,,2680,2680,-6,-6,0,34
20150130,2680,2680,2630,2630,2630,2630,2630,-50,-50,2,34
20150202,2630,2630,,,,2630,2630,0,0,0,34
20150203,2630,2630,2738,2738,2738,2738,2738,108,108,2,32
20150204,2738,2738,2738,2738,2738,2738,2738,0,0,2,30
20150205,2738,2738,2738,2874,2738,2874,2828,136,90,32,12
20150206,2874,2828,,,,2830,2830,2,2,0,12
20150209,2830,2830,,,,2830,2830,0,0,0,12
20150210,2830,2830,,,,2830,2830,0,0,0,12
20150211,2830,2830,2830,2830,2830,2830,2830,0,0,6,6
20150212,2830,2830,,,,2830,2830,0,0,0,6
20150213,2830,2830,2830,2830,2830,2830,2830,0,0,2,4
20150216,2830,2830,2830,2830,2830,2830,2830,0,0,2,2
20150217,2830,2830,2700,2700,2638,2638,2668,-192,-162,4,2
20150225,2638,2668,,,,2668,2668,0,0,0,2
20150226,2668,2668,,,,2668,2668,0,0,0,2
20150227,2668,2668,2550,2550,2550,2550,2550,-118,-118,2,0
20150302,2550,2550,,,,2550,2550,0,0,0,0
20150303,2550,2550,,,,2550,2550,0,0,0,0
20150304,2550,2550,,,,2550,2550,0,0,0,0
20150305,2550,2550,,,,2550,2550,0,0,0,0
20150306,2550,2550,,,,2550,2550,0,0,0,0
20150309,2550,2550,,,,2550,2550,0,0,0,0
20150310,2550,2550,,,,2550,2550,0,0,0,0
20150311,2550,2550,,,,2550,2550,0,0,0,0
20150312,2550,2550,,,,2550,2550,0,0,0,0
20150313,2550,2550,,,,2550,2550,0,0,0,0
20150316,2550,2550,,,,2550,2550,0,0,0,0
bu1504,20150105,3044,3044,,,,3036,3036,-8,-8,0,0
20150106,3036,3036,,,,3036,3036,0,0,0,0
20150107,3036,3036,3178,3178,3178,3178,3178,142,142,2,2
20150108,3178,3178,,,,3178,3178,0,0,0,2
20150109,3178,3178,,,,3238,3238,60,60,0,2
20150112,3238,3238,3396,3396,3396,3396,3396,158,158,2,0
20150113,3396,3396,,,,3396,3396,0,0,0,0
20150114,3396,3396,,,,3226,3226,-170,-170,0,0
20150115,3226,3226,,,,3226,3226,0,0,0,0
20150116,3226,3226,,,,3206,3206,-20,-20,0,0
20150119,3206,3206,,,,3232,3232,26,26,0,0
20150120,3232,3232,,,,3232,3232,0,0,0,0
20150121,3232,3232,,,,3150,3150,-82,-82,0,0
20150122,3150,3150,,,,3044,3044,-106,-106,0,0
20150123,3044,3044,,,,2890,2890,-154,-154,0,0
20150126,2890,2890,,,,2792,2792,-98,-98,0,0
20150127,2792,2792,,,,2716,2716,-76,-76,0,0
20150128,2716,2716,,,,2716,2716,0,0,0,0
20150129,2716,2716,,,,2716,2716,0,0,0,0
20150130,2716,2716,,,,2664,2664,-52,-52,0,0
20150202,2664,2664,,,,2664,2664,0,0,0,0
20150203,2664,2664,,,,2772,2772,108,108,0,0
20150204,2772,2772,,,,2772,2772,0,0,0,0
20150205,2772,2772,,,,2864,2864,92,92,0,0
20150206,2864,2864,,,,2864,2864,0,0,0,0
20150209,2864,2864,,,,2864,2864,0,0,0,0
20150210,2864,2864,,,,2864,2864,0,0,0,0
20150211,2864,2864,,,,2864,2864,0,0,0,0
20150212,2864,2864,,,,2864,2864,0,0,0,0
20150213,2864,2864,,,,2864,2864,0,0,0,0
20150216,2864,2864,,,,2864,2864,0,0,0,0
20150217,2864,2864,,,,2700,2700,-164,-164,0,0
20150225,2700,2700,,,,2700,2700,0,0,0,0
20150226,2700,2700,,,,2700,2700,0,0,0,0
20150227,2700,2700,,,,2580,2580,-120,-120,0,0
20150302,2580,2580,,,,2580,2580,0,0,0,0
20150303,2580,2580,,,,2580,2580,0,0,0,0
20150304,2580,2580,,,,2580,2580,0,0,0,0
20150305,2580,2580,,,,2580,2580,0,0,0,0
20150306,2580,2580,,,,2580,2580,0,0,0,0
20150309,2580,2580,,,,2580,2580,0,0,0,0
20150310,2580,2580,,,,2580,2580,0,0,0,0
20150311,2580,2580,,,,2580,2580,0,0,0,0
20150312,2580,2580,,,,2580,2580,0,0,0,0
20150313,2580,2580,,,,2580,2580,0,0,0,0
20150316,2580,2580,,,,2580,2580,0,0,0,0
20150317,2580,2580,,,,2580,2580,0,0,0,0
20150318,2580,2580,,,,2580,2580,0,0,0,0
20150319,2580,2580,,,,2580,2580,0,0,0,0
20150320,2580,2580,,,,2580,2580,0,0,0,0
20150323,2580,2580,,,,2580,2580,0,0,0,0
20150324,2580,2580,,,,2580,2580,0,0,0,0
20150325,2580,2580,,,,2580,2580,0,0,0,0
20150326,2580,2580,,,,2580,2580,0,0,0,0
20150327,2580,2580,,,,2580,2580,0,0,0,0
20150330,2580,2580,,,,2580,2580,0,0,0,0
20150331,2580,2580,,,,2580,2580,0,0,0,0
20150401,2580,2580,,,,2580,2580,0,0,0,0
20150402,2580,2580,,,,2580,2580,0,0,0,0
20150403,2580,2580,,,,2580,2580,0,0,0,0
20150407,2580,2580,,,,2580,2580,0,0,0,0
20150408,2580,2580,,,,2580,2580,0,0,0,0
20150409,2580,2580,,,,2580,2580,0,0,0,0
20150410,2580,2580,2592,2708,2592,2708,2650,128,70,4,2
20150413,2708,2650,2782,2782,2782,2782,2782,132,132,2,0
20150414,2782,2782,,,,2782,2782,0,0,0,0
20150415,2782,2782,,,,2782,2782,0,0,0,0
bu1505,20150105,3044,3044,,,,3036,3036,-8,-8,0,0
20150106,3036,3036,,,,3036,3036,0,0,0,0
20150107,3036,3036,,,,3178,3178,142,142,0,0
20150108,3178,3178,,,,3178,3178,0,0,0,0
20150109,3178,3178,,,,3238,3238,60,60,0,0
20150112,3238,3238,,,,3238,3238,0,0,0,0
20150113,3238,3238,,,,3238,3238,0,0,0,0
20150114,3238,3238,,,,3074,3074,-164,-164,0,0
20150115,3074,3074,,,,3074,3074,0,0,0,0
20150116,3074,3074,,,,3056,3056,-18,-18,0,0
20150119,3056,3056,3360,3360,2822,2822,3090,-234,34,4,0
20150120,2822,3090,,,,3090,3090,0,0,0,0
20150121,3090,3090,,,,3012,3012,-78,-78,0,0
20150122,3012,3012,,,,2910,2910,-102,-102,0,0
20150123,2910,2910,,,,2764,2764,-146,-146,0,0
20150126,2764,2764,,,,2670,2670,-94,-94,0,0
20150127,2670,2670,2536,2536,2536,2536,2536,-134,-134,2,2
20150128,2536,2536,,,,2662,2662,126,126,0,2
20150129,2662,2662,2540,2790,2540,2790,2690,128,28,8,2
20150130,2790,2690,,,,2690,2690,0,0,0,2
20150202,2690,2690,2680,2680,2680,2680,2680,-10,-10,2,0
20150203,2680,2680,,,,2790,2790,110,110,0,0
20150204,2790,2790,,,,2790,2790,0,0,0,0
20150205,2790,2790,2680,2850,2680,2850,2764,60,-26,4,0
20150206,2850,2764,,,,2764,2764,0,0,0,0
20150209,2764,2764,,,,2764,2764,0,0,0,0
20150210,2764,2764,,,,2764,2764,0,0,0,0
20150211,2764,2764,,,,2764,2764,0,0,0,0
20150212,2764,2764,,,,2764,2764,0,0,0,0
20150213,2764,2764,,,,2764,2764,0,0,0,0
20150216,2764,2764,,,,2764,2764,0,0,0,0
20150217,2764,2764,,,,2606,2606,-158,-158,0,0
20150225,2606,2606,,,,2606,2606,0,0,0,0
20150226,2606,2606,2608,2736,2608,2736,2646,130,40,8,6
20150227,2736,2646,,,,2730,2730,84,84,0,6
20150302,2730,2730,2866,2866,2866,2866,2866,136,136,2,6
20150303,2866,2866,,,,2866,2866,0,0,0,6
20150304,2866,2866,2848,3000,2848,3000,2932,134,66,14,8
20150305,3000,2932,3060,3060,2832,3048,2958,116,26,22,6
20150306,3048,2958,3040,3040,2860,2882,2926,-76,-32,6,6
20150309,2882,2926,3050,3050,2856,2936,2932,10,6,10,4
20150310,2936,2932,2866,3020,2854,3020,2890,88,-42,20,6
20150311,3020,2890,2900,2900,2900,2900,2900,10,10,2,4
20150312,2900,2900,2902,2998,2798,2946,2896,46,-4,34,8
20150313,2946,2896,3028,3028,2990,2990,3018,94,122,18,22
20150316,2990,3018,2930,2930,2866,2912,2918,-106,-100,22,10
20150317,2912,2918,,,,2880,2880,-38,-38,0,10
20150318,2880,2880,,,,2880,2880,0,0,0,10
20150319,2880,2880,,,,2880,2880,0,0,0,10
20150320,2880,2880,2948,2948,2908,2914,2922,34,42,6,10
20150323,2914,2922,2986,2986,2986,2986,2986,64,64,2,10
20150324,2986,2986,3030,3030,3030,3030,3030,44,44,2,10
20150325,3030,3030,,,,3030,3030,0,0,0,10
20150326,3030,3030,3178,3178,2950,3098,3080,68,50,26,14
20150327,3098,3080,3074,3080,3074,3080,3078,0,-2,14,0
20150330,3080,3078,,,,3078,3078,0,0,0,0
20150331,3078,3078,,,,3078,3078,0,0,0,0
20150401,3078,3078,,,,3078,3078,0,0,0,0
20150402,3078,3078,,,,3078,3078,0,0,0,0
20150403,3078,3078,,,,3078,3078,0,0,0,0
20150407,3078,3078,,,,3078,3078,0,0,0,0
20150408,3078,3078,,,,3078,3078,0,0,0,0
20150409,3078,3078,,,,3078,3078,0,0,0,0
20150410,3078,3078,,,,3160,3160,82,82,0,0
20150413,3160,3160,3118,3318,3118,3318,3308,158,148,168,4
20150414,3318,3308,3302,3570,3302,3450,3414,142,106,28,6
20150415,3450,3414,3548,3580,3452,3452,3490,38,76,14,2
20150416,3452,3490,3646,3646,3450,3450,3548,-40,58,4,4
20150417,3450,3548,3458,3558,3370,3436,3464,-112,-84,52,2
20150420,3436,3464,3458,3458,3458,3458,3458,-6,-6,2,2
20150421,3458,3458,,,,3446,3446,-12,-12,0,2
20150422,3446,3446,,,,3446,3446,0,0,0,2
20150423,3446,3446,,,,3446,3446,0,0,0,2
20150424,3446,3446,3590,3590,3278,3286,3432,-160,-14,44,2
20150427,3286,3432,3260,3260,3260,3260,3260,-172,-172,2,2
20150428,3260,3260,,,,3260,3260,0,0,0,2
20150429,3260,3260,,,,3260,3260,0,0,0,2
20150430,3260,3260,,,,3260,3260,0,0,0,2
20150504,3260,3260,,,,3260,3260,0,0,0,2
20150505,3260,3260,,,,3260,3260,0,0,0,2
20150506,3260,3260,3270,3270,3270,3270,3270,10,10,2,0
20150507,3270,3270,,,,3270,3270,0,0,0,0
20150508,3270,3270,,,,3270,3270,0,0,0,0
20150511,3270,3270,,,,3270,3270,0,0,0,0
20150512,3270,3270,,,,3270,3270,0,0,0,0
20150513,3270,3270,,,,3270,3270,0,0,0,0
20150514,3270,3270,,,,3270,3270,0,0,0,0
20150515,3270,3270,,,,3270,3270,0,0,0,0
bu1506,20150105,3508,3516,3498,3500,3480,3480,3492,-36,-24,30,88
20150106,3480,3492,3480,3666,3428,3472,3540,-20,48,318,284
20150107,3472,3540,3472,3500,3430,3450,3484,-90,-56,118,370
20150108,3450,3484,3486,3546,3370,3406,3414,-78,-70,304,548
20150109,3406,3414,3390,3390,3242,3242,3266,-172,-148,466,578
20150112,3242,3266,3222,3238,3044,3082,3108,-184,-158,1670,1182
20150113,3082,3108,3000,3088,2952,2952,2988,-156,-120,2118,1598
20150114,2952,2988,2952,3030,2822,2922,2910,-66,-78,8432,2448
20150115,2922,2910,2930,3018,2844,2956,2924,46,14,10706,2884
20150116,2956,2924,2986,3040,2936,2960,2980,36,56,6758,2970
20150119,2960,2980,2960,2986,2880,2888,2924,-92,-56,7322,4148
20150120,2888,2924,2890,2908,2868,2886,2888,-38,-36,5300,4320
20150121,2886,2888,2902,2904,2832,2848,2862,-40,-26,7654,4738
20150122,2848,2862,2850,2900,2848,2880,2878,18,16,6750,4946
20150123,2880,2878,2890,2896,2856,2862,2872,-16,-6,4420,5352
20150126,2862,2872,2862,2862,2742,2746,2806,-126,-66,8368,6318
20150127,2746,2806,2768,2796,2750,2768,2774,-38,-32,7556,6268
20150128,2768,2774,2770,2824,2768,2788,2786,14,12,5716,5864
20150129,2788,2786,2788,2796,2768,2780,2778,-6,-8,3776,6320
20150130,2780,2778,2796,2796,2744,2746,2772,-32,-6,4672,6658
20150202,2746,2772,2758,2790,2710,2770,2754,-2,-18,9582,7156
20150203,2770,2754,2782,2844,2766,2834,2794,80,40,11408,7740
20150204,2834,2794,2858,2860,2790,2812,2826,18,32,14940,8918
20150205,2812,2826,2820,2820,2772,2778,2788,-48,-38,9424,9828
20150206,2778,2788,2796,2828,2788,2822,2810,34,22,10294,9612
20150209,2822,2810,2818,2832,2804,2820,2816,10,6,6876,9710
20150210,2820,2816,2822,2834,2808,2820,2820,4,4,4690,9592
20150211,2820,2820,2820,2838,2814,2826,2824,6,4,5078,9648
20150212,2826,2824,2822,2854,2816,2850,2830,26,6,5402,8840
20150213,2850,2830,2854,2968,2852,2966,2922,136,92,15018,9598
20150216,2966,2922,2960,3026,2952,2966,2984,44,62,13422,9184
20150217,2966,2984,2962,2990,2914,2970,2952,-14,-32,9358,8452
20150225,2970,2952,2930,2936,2778,2926,2896,-26,-56,5942,7564
20150226,2926,2896,2906,3030,2906,3022,2986,126,90,15340,9372
20150227,3022,2986,3018,3086,3006,3076,3054,90,68,26444,11328
20150302,3076,3054,3098,3192,3080,3158,3142,104,88,35480,16664
20150303,3158,3142,3148,3290,3144,3202,3222,60,80,73918,18068
20150304,3202,3222,3210,3216,3138,3168,3172,-54,-50,43550,18336
20150305,3168,3172,3182,3188,3022,3050,3074,-122,-98,65936,18648
20150306,3050,3074,3054,3130,2994,3002,3076,-72,2,63340,19390
20150309,3002,3076,3000,3056,2934,3022,2996,-54,-80,95074,19890
20150310,3022,2996,3000,3048,2964,2982,3008,-14,12,50192,19116
20150311,2982,3008,2966,2986,2932,2958,2966,-50,-42,34832,20156
20150312,2958,2966,2960,3030,2960,3024,2996,58,30,40028,20462
20150313,3024,2996,3030,3066,3014,3050,3040,54,44,46928,21272
20150316,3050,3040,3032,3036,2946,2992,2994,-48,-46,43882,19096
20150317,2992,2994,2988,3018,2972,2988,2990,-6,-4,31448,18728
20150318,2988,2990,2978,3008,2952,2970,2984,-20,-6,26258,19172
20150319,2970,2984,2958,3044,2948,2994,2992,10,8,34266,19002
20150320,2994,2992,2980,3016,2980,2992,2996,0,4,21790,18616
20150323,2992,2996,3004,3110,3004,3094,3048,98,52,52544,23392
20150324,3094,3048,3116,3164,3068,3120,3124,72,76,66134,23588
20150325,3120,3124,3140,3162,3072,3090,3116,-34,-8,37034,23936
20150326,3090,3116,3110,3188,3102,3164,3148,48,32,80856,26804
20150327,3164,3148,3140,3178,3082,3124,3140,-24,-8,65530,24904
20150330,3124,3140,3132,3148,3068,3078,3102,-62,-38,46200,23284
20150331,3078,3102,3090,3134,3074,3084,3106,-18,4,41100,22456
20150401,3084,3106,3080,3110,3068,3104,3086,-2,-20,32254,21578
20150402,3104,3086,3094,3240,3094,3240,3198,154,112,103154,30696
20150403,3240,3198,3236,3358,3204,3278,3292,80,94,209592,31712
20150407,3278,3292,3322,3398,3320,3366,3358,74,66,59556,32786
20150408,3366,3358,3360,3392,3258,3328,3332,-30,-26,145332,29932
20150409,3328,3332,3332,3338,3238,3296,3284,-36,-48,115724,32256
20150410,3296,3284,3300,3436,3296,3370,3390,86,106,255384,43730
20150413,3370,3390,3370,3458,3352,3386,3412,-4,22,196110,43760
20150414,3386,3412,3408,3438,3328,3362,3384,-50,-28,135340,43384
20150415,3362,3384,3364,3424,3350,3372,3390,-12,6,159762,44390
20150416,3372,3390,3376,3474,3366,3450,3426,60,36,239586,53528
20150417,3450,3426,3438,3466,3384,3406,3424,-20,-2,177322,49530
20150420,3406,3424,3402,3422,3292,3308,3364,-116,-60,171280,51604
20150421,3308,3364,3288,3304,3200,3218,3244,-146,-120,226852,50730
20150422,3218,3244,3226,3300,3226,3254,3266,10,22,176018,50064
20150423,3254,3266,3268,3296,3176,3210,3246,-56,-20,186900,57812
20150424,3210,3246,3232,3282,3202,3256,3242,10,-4,182228,57850
20150427,3256,3242,3264,3338,3246,3306,3288,64,46,210646,57812
20150428,3306,3288,3316,3366,3292,3296,3330,8,42,181048,58128
20150429,3296,3330,3320,3324,3220,3238,3280,-92,-50,139354,53810
20150430,3238,3280,3238,3272,3222,3242,3250,-38,-30,123384,55378
20150504,3242,3250,3262,3284,3210,3256,3248,6,-2,66116,54146
20150505,3256,3248,3270,3330,3262,3324,3298,76,50,166986,58444
20150506,3324,3298,3360,3370,3306,3324,3338,26,40,145296,53498
20150507,3324,3338,3340,3346,3230,3252,3280,-86,-58,118984,51064
20150508,3252,3280,3250,3250,3140,3166,3198,-114,-82,129026,52628
20150511,3166,3198,3178,3290,3178,3228,3216,30,18,116968,55640
20150512,3228,3216,3222,3232,3168,3182,3196,-34,-20,64950,52376
20150513,3182,3196,3200,3238,3190,3214,3212,18,16,63300,52156
20150514,3214,3212,3226,3226,3160,3194,3184,-18,-28,54048,50334
20150515,3194,3184,3198,3208,3172,3188,3188,4,4,44780,51774
20150518,3188,3188,3170,3200,3106,3114,3148,-74,-40,44086,53222
20150519,3114,3148,3106,3134,3014,3058,3080,-90,-68,72550,51872
20150520,3058,3080,3054,3054,2952,2976,2996,-104,-84,59642,47958
20150521,2976,2996,2974,3010,2970,2996,2990,0,-6,31722,48246
20150522,2996,2990,3002,3030,2956,2998,3000,8,10,30910,46850
20150525,2998,3000,2950,3022,2946,3000,2984,0,-16,19538,44724
20150526,3000,2984,2994,3100,2988,3010,3024,26,40,23296,42602
20150527,3010,3024,2996,3022,2950,3010,2992,-14,-32,12334,40328
20150528,3010,2992,2998,3010,2974,3000,2996,8,4,13320,36400
20150529,3000,2996,3000,3014,2962,2996,2996,0,0,12562,33534
20150601,2996,2996,3000,3058,2982,3006,3012,10,16,8870,30206
20150602,3006,3012,3026,3040,2970,2990,3006,-22,-6,3548,29150
20150603,2990,3006,3000,3014,2984,3006,3002,0,-4,1708,28382
20150604,3006,3002,3000,3002,2920,2936,2960,-66,-42,2268,27110
20150605,2936,2960,3002,3002,2872,2878,2910,-82,-50,1516,26648
20150608,2878,2910,2898,2926,2850,2860,2864,-50,-46,1444,26550
20150609,2860,2864,2852,2890,2848,2854,2862,-10,-2,1658,26464
20150610,2854,2862,2874,2898,2848,2868,2880,6,18,2676,26374
20150611,2868,2880,2858,3024,2848,2950,2890,70,10,286,26368
20150612,2950,2890,2820,2820,2790,2790,2802,-100,-88,24,26392
20150615,2790,2802,2780,2800,2660,2776,2724,-26,-78,1014,26416
bu1507,20150116,2924,2924,,,,2980,2980,56,56,0,0
20150119,2980,2980,,,,2924,2924,-56,-56,0,0
20150120,2924,2924,,,,2888,2888,-36,-36,0,0
20150121,2888,2888,,,,2862,2862,-26,-26,0,0
20150122,2862,2862,,,,2878,2878,16,16,0,0
20150123,2878,2878,,,,2872,2872,-6,-6,0,0
20150126,2872,2872,,,,2806,2806,-66,-66,0,0
20150127,2806,2806,,,,2774,2774,-32,-32,0,0
20150128,2774,2774,,,,2786,2786,12,12,0,0
20150129,2786,2786,,,,2778,2778,-8,-8,0,0
20150130,2778,2778,,,,2772,2772,-6,-6,0,0
20150202,2772,2772,,,,2772,2772,0,0,0,0
20150203,2772,2772,,,,2814,2814,42,42,0,0
20150204,2814,2814,,,,2814,2814,0,0,0,0
20150205,2814,2814,,,,2814,2814,0,0,0,0
20150206,2814,2814,,,,2814,2814,0,0,0,0
20150209,2814,2814,,,,2820,2820,6,6,0,0
20150210,2820,2820,,,,2824,2824,4,4,0,0
20150211,2824,2824,,,,2824,2824,0,0,0,0
20150212,2824,2824,,,,2824,2824,0,0,0,0
20150213,2824,2824,3098,3106,3060,3106,3090,282,266,8,2
20150216,3106,3090,,,,3090,3090,0,0,0,2
20150217,3090,3090,,,,3090,3090,0,0,0,2
20150225,3090,3090,,,,3090,3090,0,0,0,2
20150226,3090,3090,3050,3218,3050,3218,3134,128,44,4,2
20150227,3218,3134,3090,3090,3090,3090,3090,-44,-44,2,0
20150302,3090,3090,,,,3180,3180,90,90,0,0
20150303,3180,3180,,,,3262,3262,82,82,0,0
20150304,3262,3262,,,,3262,3262,0,0,0,0
20150305,3262,3262,,,,3162,3162,-100,-100,0,0
20150306,3162,3162,,,,3164,3164,2,2,0,0
20150309,3164,3164,,,,3082,3082,-82,-82,0,0
20150310,3082,3082,,,,3094,3094,12,12,0,0
20150311,3094,3094,,,,3050,3050,-44,-44,0,0
20150312,3050,3050,,,,3050,3050,0,0,0,0
20150313,3050,3050,,,,3050,3050,0,0,0,0
20150316,3050,3050,,,,3004,3004,-46,-46,0,0
20150317,3004,3004,,,,3000,3000,-4,-4,0,0
20150318,3000,3000,,,,3000,3000,0,0,0,0
20150319,3000,3000,,,,3008,3008,8,8,0,0
20150320,3008,3008,,,,3012,3012,4,4,0,0
20150323,3012,3012,,,,3064,3064,52,52,0,0
20150324,3064,3064,,,,3140,3140,76,76,0,0
20150325,3140,3140,,,,3132,3132,-8,-8,0,0
20150326,3132,3132,,,,3164,3164,32,32,0,0
20150327,3164,3164,,,,3164,3164,0,0,0,0
20150330,3164,3164,,,,3164,3164,0,0,0,0
20150331,3164,3164,,,,3168,3168,4,4,0,0
20150401,3168,3168,,,,3148,3148,-20,-20,0,0
20150402,3148,3148,3136,3246,3136,3226,3200,78,52,8,0
20150403,3226,3200,,,,3294,3294,94,94,0,0
20150407,3294,3294,,,,3360,3360,66,66,0,0
20150408,3360,3360,,,,3360,3360,0,0,0,0
20150409,3360,3360,,,,3360,3360,0,0,0,0
20150410,3360,3360,3500,3500,3346,3346,3422,-14,62,4,0
20150413,3346,3422,3588,3588,3340,3576,3476,154,54,44,2
20150414,3576,3476,3500,3550,3500,3502,3526,26,50,18,8
20150415,3502,3526,3350,3350,3350,3350,3350,-176,-176,6,8
20150416,3350,3350,3404,3404,3404,3404,3404,54,54,2,8
20150417,3404,3404,3486,3490,3450,3450,3478,46,74,8,0
20150420,3450,3478,3520,3520,3304,3304,3412,-174,-66,4,0
20150421,3304,3412,,,,3412,3412,0,0,0,0
20150422,3412,3412,,,,3412,3412,0,0,0,0
20150423,3412,3412,,,,3392,3392,-20,-20,0,0
20150424,3392,3392,,,,3392,3392,0,0,0,0
20150427,3392,3392,,,,3392,3392,0,0,0,0
20150428,3392,3392,,,,3392,3392,0,0,0,0
20150429,3392,3392,,,,3392,3392,0,0,0,0
20150430,3392,3392,,,,3392,3392,0,0,0,0
20150504,3392,3392,,,,3392,3392,0,0,0,0
20150505,3392,3392,3420,3480,3320,3420,3410,28,18,8,0
20150506,3420,3410,,,,3410,3410,0,0,0,0
20150507,3410,3410,,,,3350,3350,-60,-60,0,0
20150508,3350,3350,3432,3432,3432,3432,3432,82,82,2,2
20150511,3432,3432,,,,3452,3452,20,20,0,2
20150512,3452,3452,,,,3430,3430,-22,-22,0,2
20150513,3430,3430,,,,3446,3446,16,16,0,2
20150514,3446,3446,,,,3416,3416,-30,-30,0,2
20150515,3416,3416,3244,3400,3244,3260,3314,-156,-102,48,4
20150518,3260,3314,3284,3284,3168,3180,3210,-134,-104,6,4
20150519,3180,3210,,,,3140,3140,-70,-70,0,4
20150520,3140,3140,,,,3054,3054,-86,-86,0,4
20150521,3054,3054,,,,3054,3054,0,0,0,4
20150522,3054,3054,,,,3054,3054,0,0,0,4
20150525,3054,3054,,,,3054,3054,0,0,0,4
20150526,3054,3054,,,,3054,3054,0,0,0,4
20150527,3054,3054,,,,3054,3054,0,0,0,4
20150528,3054,3054,,,,3054,3054,0,0,0,4
20150529,3054,3054,,,,3054,3054,0,0,0,4
20150601,3054,3054,,,,3054,3054,0,0,0,4
20150602,3054,3054,,,,3054,3054,0,0,0,4
20150603,3054,3054,,,,3054,3054,0,0,0,4
20150604,3054,3054,,,,3012,3012,-42,-42,0,4
20150605,3012,3012,,,,2962,2962,-50,-50,0,4
20150608,2962,2962,,,,2916,2916,-46,-46,0,4
20150609,2916,2916,,,,2916,2916,0,0,0,4
20150610,2916,2916,,,,2934,2934,18,18,0,4
20150611,2934,2934,,,,2944,2944,10,10,0,4
20150612,2944,2944,,,,2854,2854,-90,-90,0,4
20150615,2854,2854,,,,2774,2774,-80,-80,0,4
20150616,2774,2774,,,,2774,2774,0,0,0,4
20150617,2774,2774,,,,2774,2774,0,0,0,4
20150618,2774,2774,,,,2774,2774,0,0,0,4
20150619,2774,2774,,,,2774,2774,0,0,0,4
20150623,2774,2774,,,,2774,2774,0,0,0,4
20150624,2774,2774,,,,2774,2774,0,0,0,4
20150625,2774,2774,,,,2774,2774,0,0,0,4
20150626,2774,2774,,,,2774,2774,0,0,0,4
20150629,2774,2774,,,,2774,2774,0,0,0,4
20150630,2774,2774,2638,2900,2636,2898,2772,124,-2,12,4
20150701,2898,2772,,,,2772,2772,0,0,0,4
20150702,2772,2772,,,,2772,2772,0,0,0,4
20150703,2772,2772,,,,2772,2772,0,0,0,4
20150706,2772,2772,,,,2772,2772,0,0,0,4
20150707,2772,2772,,,,2772,2772,0,0,0,4
20150708,2772,2772,,,,2772,2772,0,0,0,4
20150709,2772,2772,,,,2772,2772,0,0,0,4
20150710,2772,2772,,,,2772,2772,0,0,0,4
20150713,2772,2772,2632,2632,2632,2632,2632,-140,-140,4,0
20150714,2632,2632,,,,2632,2632,0,0,0,0
20150715,2632,2632,,,,2632,2632,0,0,0,0
bu1508,20150216,3090,3090,,,,3156,3156,66,66,0,0
20150217,3156,3156,,,,3122,3122,-34,-34,0,0
20150225,3122,3122,,,,3064,3064,-58,-58,0,0
20150226,3064,3064,,,,3106,3106,42,42,0,0
20150227,3106,3106,,,,3062,3062,-44,-44,0,0
20150302,3062,3062,,,,3150,3150,88,88,0,0
20150303,3150,3150,,,,3230,3230,80,80,0,0
20150304,3230,3230,3230,3252,3230,3252,3240,22,10,4,2
20150305,3252,3240,,,,3240,3240,0,0,0,2
20150306,3240,3240,,,,3240,3240,0,0,0,2
20150309,3240,3240,,,,3156,3156,-84,-84,0,2
20150310,3156,3156,,,,3170,3170,14,14,0,2
20150311,3170,3170,,,,3124,3124,-46,-46,0,2
20150312,3124,3124,,,,3156,3156,32,32,0,2
20150313,3156,3156,,,,3202,3202,46,46,0,2
20150316,3202,3202,,,,3152,3152,-50,-50,0,2
20150317,3152,3152,,,,3148,3148,-4,-4,0,2
20150318,3148,3148,,,,3140,3140,-8,-8,0,2
20150319,3140,3140,,,,3150,3150,10,10,0,2
20150320,3150,3150,,,,3156,3156,6,6,0,2
20150323,3156,3156,,,,3210,3210,54,54,0,2
20150324,3210,3210,,,,3290,3290,80,80,0,2
20150325,3290,3290,,,,3282,3282,-8,-8,0,2
20150326,3282,3282,,,,3316,3316,34,34,0,2
20150327,3316,3316,,,,3308,3308,-8,-8,0,2
20150330,3308,3308,,,,3268,3268,-40,-40,0,2
20150331,3268,3268,,,,3268,3268,0,0,0,2
20150401,3268,3268,,,,3268,3268,0,0,0,2
20150402,3268,3268,,,,3322,3322,54,54,0,2
20150403,3322,3322,,,,3420,3420,98,98,0,2
20150407,3420,3420,,,,3420,3420,0,0,0,2
20150408,3420,3420,,,,3394,3394,-26,-26,0,2
20150409,3394,3394,,,,3394,3394,0,0,0,2
20150410,3394,3394,,,,3456,3456,62,62,0,2
20150413,3456,3456,,,,3510,3510,54,54,0,2
20150414,3510,3510,,,,3560,3560,50,50,0,2
20150415,3560,3560,,,,3560,3560,0,0,0,2
20150416,3560,3560,,,,3616,3616,56,56,0,2
20150417,3616,3616,,,,3694,3694,78,78,0,2
20150420,3694,3694,,,,3622,3622,-72,-72,0,2
20150421,3622,3622,,,,3496,3496,-126,-126,0,2
20150422,3496,3496,,,,3496,3496,0,0,0,2
20150423,3496,3496,,,,3486,3486,-10,-10,0,2
20150424,3486,3486,,,,3486,3486,0,0,0,2
20150427,3486,3486,,,,3486,3486,0,0,0,2
20150428,3486,3486,,,,3486,3486,0,0,0,2
20150429,3486,3486,,,,3486,3486,0,0,0,2
20150430,3486,3486,,,,3486,3486,0,0,0,2
20150504,3486,3486,,,,3486,3486,0,0,0,2
20150505,3486,3486,,,,3486,3486,0,0,0,2
20150506,3486,3486,,,,3486,3486,0,0,0,2
20150507,3486,3486,,,,3480,3480,-6,-6,0,2
20150508,3480,3480,,,,3564,3564,84,84,0,2
20150511,3564,3564,,,,3584,3584,20,20,0,2
20150512,3584,3584,,,,3562,3562,-22,-22,0,2
20150513,3562,3562,,,,3580,3580,18,18,0,2
20150514,3580,3580,,,,3550,3550,-30,-30,0,2
20150515,3550,3550,,,,3372,3372,-178,-178,0,2
20150518,3372,3372,3344,3346,3216,3216,3280,-156,-92,8,2
20150519,3216,3280,,,,3208,3208,-72,-72,0,2
20150520,3208,3208,,,,3200,3200,-8,-8,0,2
20150521,3200,3200,,,,3200,3200,0,0,0,2
20150522,3200,3200,,,,3200,3200,0,0,0,2
20150525,3200,3200,3220,3220,3220,3220,3220,20,20,2,2
20150526,3220,3220,3220,3220,3220,3220,3220,0,0,2,0
20150527,3220,3220,,,,3220,3220,0,0,0,0
20150528,3220,3220,,,,3220,3220,0,0,0,0
20150529,3220,3220,,,,3220,3220,0,0,0,0
20150601,3220,3220,3316,3316,3060,3192,3200,-28,-20,14,8
20150602,3192,3200,3120,3162,3120,3160,3150,-40,-50,8,8
20150603,3160,3150,,,,3150,3150,0,0,0,8
20150604,3150,3150,,,,3150,3150,0,0,0,8
20150605,3150,3150,,,,3150,3150,0,0,0,8
20150608,3150,3150,,,,3150,3150,0,0,0,8
20150609,3150,3150,,,,3148,3148,-2,-2,0,8
20150610,3148,3148,,,,3148,3148,0,0,0,8
20150611,3148,3148,,,,3148,3148,0,0,0,8
20150612,3148,3148,,,,3052,3052,-96,-96,0,8
20150615,3052,3052,,,,3052,3052,0,0,0,8
20150616,3052,3052,,,,3052,3052,0,0,0,8
20150617,3052,3052,,,,3052,3052,0,0,0,8
20150618,3052,3052,,,,3052,3052,0,0,0,8
20150619,3052,3052,,,,3052,3052,0,0,0,8
20150623,3052,3052,,,,3052,3052,0,0,0,8
20150624,3052,3052,,,,3052,3052,0,0,0,8
20150625,3052,3052,,,,3052,3052,0,0,0,8
20150626,3052,3052,,,,3052,3052,0,0,0,8
20150629,3052,3052,,,,3052,3052,0,0,0,8
20150630,3052,3052,,,,3048,3048,-4,-4,0,8
20150701,3048,3048,,,,3048,3048,0,0,0,8
20150702,3048,3048,,,,3048,3048,0,0,0,8
20150703,3048,3048,,,,3048,3048,0,0,0,8
20150706,3048,3048,,,,3048,3048,0,0,0,8
20150707,3048,3048,,,,3048,3048,0,0,0,8
20150708,3048,3048,,,,3048,3048,0,0,0,8
20150709,3048,3048,,,,3048,3048,0,0,0,8
20150710,3048,3048,,,,3048,3048,0,0,0,8
20150713,3048,3048,,,,2894,2894,-154,-154,0,8
20150714,2894,2894,,,,2894,2894,0,0,0,8
20150715,2894,2894,,,,2894,2894,0,0,0,8
20150716,2894,2894,,,,2894,2894,0,0,0,8
20150717,2894,2894,,,,2894,2894,0,0,0,8
20150720,2894,2894,2948,2948,2948,2948,2948,54,54,2,8
20150721,2948,2948,,,,2948,2948,0,0,0,8
20150722,2948,2948,,,,2800,2800,-148,-148,0,8
20150723,2800,2800,,,,2660,2660,-140,-140,0,8
20150724,2660,2660,,,,2660,2660,0,0,0,8
20150727,2660,2660,,,,2660,2660,0,0,0,8
20150728,2660,2660,,,,2526,2526,-134,-134,0,8
20150729,2526,2526,2398,2398,2398,2398,2398,-128,-128,4,6
20150730,2398,2398,,,,2398,2398,0,0,0,6
20150731,2398,2398,2516,2516,2366,2366,2440,-32,42,4,8
20150803,2366,2440,,,,2440,2440,0,0,0,8
20150804,2440,2440,,,,2440,2440,0,0,0,8
20150805,2440,2440,,,,2440,2440,0,0,0,8
20150806,2440,2440,,,,2440,2440,0,0,0,8
20150807,2440,2440,,,,2440,2440,0,0,0,8
20150810,2440,2440,2560,2560,2560,2560,2560,120,120,2,8
20150811,2560,2560,2598,2598,2456,2590,2528,30,-32,10,8
20150812,2590,2528,,,,2528,2528,0,0,0,8
20150813,2528,2528,2400,2400,2400,2400,2400,-128,-128,8,8
20150814,2400,2400,,,,2400,2400,0,0,0,8
20150817,2400,2400,,,,2400,2400,0,0,0,8
bu1509,20150105,3594,3594,,,,3594,3594,0,0,0,34
20150106,3594,3594,,,,3594,3594,0,0,0,34
20150107,3594,3594,,,,3594,3594,0,0,0,34
20150108,3594,3594,3550,3550,3550,3550,3550,-44,-44,2,34
20150109,3550,3550,3540,3540,3540,3540,3540,-10,-10,2,34
20150112,3540,3540,,,,3368,3368,-172,-172,0,34
20150113,3368,3368,3530,3530,3200,3200,3362,-168,-6,14,38
20150114,3200,3362,3192,3192,3192,3192,3192,-170,-170,14,48
20150115,3192,3192,,,,3158,3158,-34,-34,0,48
20150116,3158,3158,3188,3188,3168,3168,3170,10,12,12,52
20150119,3168,3170,,,,3170,3170,0,0,0,52
20150120,3170,3170,,,,3170,3170,0,0,0,52
20150121,3170,3170,,,,3170,3170,0,0,0,52
20150122,3170,3170,,,,3170,3170,0,0,0,52
20150123,3170,3170,,,,3170,3170,0,0,0,52
20150126,3170,3170,3016,3016,3010,3010,3012,-160,-158,4,56
20150127,3010,3012,2782,3240,2782,3072,2970,60,-42,12,52
20150128,3072,2970,2998,3000,2998,3000,2998,30,28,6,58
20150129,3000,2998,,,,2998,2998,0,0,0,58
20150130,2998,2998,2928,2990,2912,2984,2952,-14,-46,16,62
20150202,2984,2952,3000,3000,3000,3000,3000,48,48,6,66
20150203,3000,3000,3144,3146,3056,3056,3100,56,100,8,68
20150204,3056,3100,3250,3250,3080,3080,3154,-20,54,34,78
20150205,3080,3154,3012,3012,2996,2996,3000,-158,-154,8,86
20150206,2996,3000,3098,3126,3014,3028,3040,28,40,32,104
20150209,3028,3040,,,,3040,3040,0,0,0,104
20150210,3040,3040,3020,3020,3020,3020,3020,-20,-20,2,104
20150211,3020,3020,3040,3064,2994,3064,3032,44,12,6,100
20150212,3064,3032,,,,3032,3032,0,0,0,100
20150213,3032,3032,3136,3136,3036,3132,3116,100,84,18,100
20150216,3132,3116,,,,3116,3116,0,0,0,100
20150217,3116,3116,3050,3176,3050,3176,3140,60,24,8,104
20150225,3176,3140,,,,3140,3140,0,0,0,104
20150226,3140,3140,3198,3240,3174,3240,3214,100,74,16,114
20150227,3240,3214,3112,3288,3112,3270,3254,56,40,18,116
20150302,3270,3254,3340,3360,3340,3360,3350,106,96,4,118
20150303,3360,3350,3416,3416,3300,3300,3356,-50,6,16,114
20150304,3300,3356,3354,3354,3330,3338,3340,-18,-16,6,118
20150305,3338,3340,3300,3320,3222,3316,3274,-24,-66,18,116
20150306,3316,3274,3150,3322,3150,3260,3286,-14,12,20,112
20150309,3260,3286,3266,3300,3226,3300,3268,14,-18,36,112
20150310,3300,3268,3256,3280,3182,3184,3234,-84,-34,40,122
20150311,3184,3234,3228,3228,3160,3160,3198,-74,-36,12,128
20150312,3160,3198,3210,3228,3210,3220,3220,22,22,8,134
20150313,3220,3220,3256,3260,3256,3260,3256,40,36,12,136
20150316,3260,3256,3178,3238,3168,3218,3192,-38,-64,18,134
20150317,3218,3192,3166,3218,3166,3218,3192,26,0,4,134
20150318,3218,3192,3210,3210,3168,3200,3192,8,0,6,132
20150319,3200,3192,3228,3228,3194,3194,3204,2,12,6,134
20150320,3194,3204,,,,3240,3240,36,36,0,134
20150323,3240,3240,3292,3294,3242,3294,3278,54,38,20,148
20150324,3294,3278,3430,3430,3252,3338,3330,60,52,28,154
20150325,3338,3330,3348,3348,3260,3300,3306,-30,-24,20,158
20150326,3300,3306,3312,3350,3312,3320,3338,14,32,34,160
20150327,3320,3338,3312,3376,3300,3326,3346,-12,8,138,158
20150330,3326,3346,3306,3322,3282,3322,3304,-24,-42,30,168
20150331,3322,3304,3312,3314,3252,3282,3298,-22,-6,30,170
20150401,3282,3298,3298,3310,3286,3288,3290,-10,-8,24,168
20150402,3288,3290,3334,3454,3294,3442,3404,152,114,122,172
20150403,3442,3404,3472,3472,3386,3390,3434,-14,30,190,172
20150407,3390,3434,3498,3498,3498,3498,3498,64,64,2,174
20150408,3498,3498,3408,3522,3408,3454,3460,-44,-38,164,178
20150409,3454,3460,3406,3438,3378,3392,3412,-68,-48,94,182
20150410,3392,3412,3500,3536,3376,3460,3474,48,62,284,180
20150413,3460,3474,3472,3514,3452,3470,3472,-4,-2,132,192
20150414,3470,3472,3458,3508,3458,3486,3484,14,12,168,198
20150415,3486,3484,3430,3520,3430,3498,3498,14,14,104,214
20150416,3498,3498,3524,3528,3404,3492,3480,-6,-18,344,298
20150417,3492,3480,3500,3500,3430,3466,3466,-14,-14,342,360
20150420,3466,3466,3436,3494,3402,3472,3442,6,-24,1392,758
20150421,3472,3442,3432,3472,3372,3410,3412,-32,-30,1024,636
20150422,3410,3412,3436,3466,3394,3428,3432,16,20,676,802
20150423,3428,3432,3428,3450,3352,3378,3410,-54,-22,1258,926
20150424,3378,3410,3420,3428,3374,3410,3404,0,-6,698,988
20150427,3410,3404,3412,3470,3404,3460,3442,56,38,1140,1490
20150428,3460,3442,3462,3510,3462,3490,3494,48,52,2278,2404
20150429,3490,3494,3510,3514,3420,3422,3462,-72,-32,1726,2668
20150430,3422,3462,3410,3476,3406,3428,3440,-34,-22,1098,2758
20150504,3428,3440,3422,3456,3408,3442,3430,2,-10,1848,3354
20150505,3442,3430,3462,3498,3450,3496,3482,66,52,3910,4274
20150506,3496,3482,3518,3592,3472,3520,3528,38,46,7176,6954
20150507,3520,3528,3556,3556,3428,3442,3468,-86,-60,6522,7626
20150508,3442,3468,3442,3442,3342,3364,3390,-104,-78,8802,9028
20150511,3364,3390,3382,3424,3370,3406,3396,16,6,6306,9372
20150512,3406,3396,3398,3406,3342,3348,3366,-48,-30,6196,10996
20150513,3348,3366,3374,3404,3352,3372,3376,6,10,5900,12422
20150514,3372,3376,3376,3384,3308,3324,3346,-52,-30,8880,13362
20150515,3324,3346,3324,3334,3302,3318,3316,-28,-30,5856,13880
20150518,3318,3316,3318,3318,3270,3282,3292,-34,-24,8100,14816
20150519,3282,3292,3262,3276,3168,3182,3214,-110,-78,18558,17706
20150520,3182,3214,3160,3170,3088,3106,3116,-108,-98,22058,18640
20150521,3106,3116,3116,3156,3108,3154,3130,38,14,11570,20182
20150522,3154,3130,3168,3212,3142,3186,3180,56,50,24630,21974
20150525,3186,3180,3154,3186,3128,3164,3158,-16,-22,17614,23182
20150526,3164,3158,3160,3224,3152,3180,3200,22,42,20024,23916
20150527,3180,3200,3152,3178,3132,3170,3158,-30,-42,18758,24996
20150528,3170,3158,3150,3182,3136,3164,3162,6,4,20274,25670
20150529,3164,3162,3152,3242,3152,3172,3178,10,16,29686,28420
20150601,3172,3178,3176,3216,3170,3198,3198,20,20,38236,30850
20150602,3198,3198,3200,3228,3164,3192,3204,-6,6,33112,32694
20150603,3192,3204,3196,3230,3196,3210,3210,6,6,31518,32892
20150604,3210,3210,3198,3210,3106,3108,3150,-102,-60,51176,39274
20150605,3108,3150,3102,3128,3076,3080,3102,-70,-48,50354,41354
20150608,3080,3102,3086,3094,3052,3070,3070,-32,-32,49018,46222
20150609,3070,3070,3068,3086,3058,3060,3074,-10,4,28836,47462
20150610,3060,3074,3072,3150,3070,3098,3100,24,26,43230,44836
20150611,3098,3100,3112,3128,3092,3102,3102,2,2,25516,44644
20150612,3102,3102,3098,3102,2986,2986,3034,-116,-68,50258,50838
20150615,2986,3034,2992,3014,2972,2988,2994,-46,-40,31160,49338
20150616,2988,2994,2976,3024,2962,3012,2998,18,4,32158,47592
20150617,3012,2998,3010,3016,2976,2986,2998,-12,0,21406,47880
20150618,2986,2998,3006,3032,2982,2996,3002,-2,4,28862,48514
20150619,2996,3002,3016,3018,2952,2958,2980,-44,-22,36408,52878
20150623,2958,2980,2960,2968,2916,2924,2934,-56,-46,31642,55594
20150624,2924,2934,2920,2976,2914,2976,2944,42,10,32542,51934
20150625,2976,2944,2976,2988,2948,2950,2968,6,24,31996,52808
20150626,2950,2968,2948,2972,2936,2960,2954,-8,-14,32378,50834
20150629,2960,2954,2948,2970,2922,2936,2952,-18,-2,31124,49566
20150630,2936,2952,2930,2948,2804,2812,2854,-140,-98,52186,48312
20150701,2812,2854,2832,2850,2808,2826,2834,-28,-20,31576,49450
20150702,2826,2834,2826,2830,2774,2816,2802,-18,-32,36706,50466
20150703,2816,2802,2830,2898,2824,2860,2864,58,62,54178,46572
20150706,2860,2864,2870,2874,2720,2726,2774,-138,-90,46184,47992
20150707,2726,2774,2718,2738,2634,2634,2680,-140,-94,59944,49520
20150708,2634,2680,2598,2630,2464,2464,2492,-216,-188,43006,44960
20150709,2464,2492,2402,2686,2246,2514,2472,22,-20,154096,39340
20150710,2514,2472,2550,2592,2502,2546,2548,74,76,122816,41908
20150713,2546,2548,2534,2576,2468,2488,2532,-60,-16,93520,44834
20150714,2488,2532,2508,2558,2492,2498,2526,-34,-6,106236,43940
20150715,2498,2526,2514,2580,2510,2564,2546,38,20,98840,39414
20150716,2564,2546,2558,2566,2510,2550,2536,4,-10,86876,40696
20150717,2550,2536,2556,2590,2536,2570,2562,34,26,74048,39180
20150720,2570,2562,2538,2600,2530,2592,2568,30,6,73380,39412
20150721,2592,2568,2604,2608,2570,2588,2582,20,14,54708,37556
20150722,2588,2582,2594,2670,2584,2626,2628,44,46,117858,34382
20150723,2626,2628,2620,2642,2584,2614,2612,-14,-16,76050,34252
20150724,2614,2612,2620,2658,2588,2602,2622,-10,10,98520,35112
20150727,2602,2622,2608,2612,2490,2490,2520,-132,-102,179932,47640
20150728,2490,2520,2450,2544,2412,2496,2472,-24,-48,164332,37444
20150729,2496,2472,2498,2550,2482,2526,2520,54,48,101886,36460
20150730,2526,2520,2516,2568,2494,2524,2532,4,12,121506,32274
20150731,2524,2532,2540,2554,2514,2532,2532,0,0,74552,32670
20150803,2532,2532,2526,2568,2412,2434,2490,-98,-42,123886,35088
20150804,2434,2490,2412,2488,2404,2464,2446,-26,-44,88054,32958
20150805,2464,2446,2486,2494,2440,2480,2464,34,18,62144,31806
20150806,2480,2464,2488,2488,2440,2450,2460,-14,-4,62174,31420
20150807,2450,2460,2448,2546,2432,2538,2466,78,6,62910,31932
20150810,2538,2466,2502,2588,2502,2588,2556,122,90,150334,33270
20150811,2588,2556,2604,2646,2550,2554,2594,-2,38,146172,36066
20150812,2554,2594,2540,2544,2500,2538,2522,-56,-72,103094,34354
20150813,2538,2522,2548,2576,2510,2542,2542,20,20,89786,33912
20150814,2542,2542,2524,2572,2506,2506,2542,-36,0,88422,30764
20150817,2506,2542,2522,2538,2420,2440,2476,-102,-66,92464,33232
20150818,2440,2476,2432,2474,2418,2428,2448,-48,-28,89146,33372
20150819,2428,2448,2432,2452,2384,2450,2422,2,-26,92868,30850
20150820,2450,2422,2452,2466,2400,2412,2422,-10,0,64490,31448
20150821,2412,2422,2430,2438,2338,2354,2390,-68,-32,62432,32436
20150824,2354,2390,2350,2370,2270,2270,2312,-120,-78,51864,25086
20150825,2270,2312,2278,2362,2218,2276,2274,-36,-38,41952,20496
20150826,2276,2274,2320,2348,2270,2286,2302,12,28,16970,18630
20150827,2286,2302,2296,2412,2278,2398,2360,96,58,22582,13218
20150828,2398,2360,2400,2466,2386,2400,2422,40,62,14194,11992
20150831,2400,2422,2390,2414,2372,2386,2392,-36,-30,4744,11550
20150901,2386,2392,2414,2492,2364,2458,2420,66,28,3718,9318
20150902,2458,2420,2446,2454,2360,2412,2396,-8,-24,1634,8654
20150907,2412,2396,2434,2454,2392,2392,2424,-4,28,330,8626
20150908,2392,2424,2398,2418,2396,2404,2402,-20,-22,370,8776
20150909,2404,2402,2412,2436,2400,2404,2412,2,10,378,8866
20150910,2404,2412,2448,2500,2394,2418,2434,6,22,614,8712
20150911,2418,2434,2314,2500,2314,2410,2434,-24,0,1392,8704
20150914,2410,2434,2522,2528,2520,2528,2524,94,90,652,8704
20150915,2528,2524,2536,2538,2450,2450,2500,-74,-24,520,8704
bu1510,20150416,3498,3498,,,,3498,3498,0,0,0,0
20150417,3498,3498,,,,3498,3498,0,0,0,0
20150420,3498,3498,,,,3498,3498,0,0,0,0
20150421,3498,3498,,,,3498,3498,0,0,0,0
20150422,3498,3498,,,,3498,3498,0,0,0,0
20150423,3498,3498,,,,3498,3498,0,0,0,0
20150424,3498,3498,,,,3498,3498,0,0,0,0
20150427,3498,3498,,,,3498,3498,0,0,0,0
20150428,3498,3498,,,,3498,3498,0,0,0,0
20150429,3498,3498,3348,3558,3348,3490,3446,-8,-52,20,0
20150430,3490,3446,,,,3446,3446,0,0,0,0
20150504,3446,3446,,,,3446,3446,0,0,0,0
20150505,3446,3446,,,,3446,3446,0,0,0,0
20150506,3446,3446,,,,3492,3492,46,46,0,0
20150507,3492,3492,,,,3492,3492,0,0,0,0
20150508,3492,3492,3316,3562,3316,3378,3392,-114,-100,10,0
20150511,3378,3392,,,,3392,3392,0,0,0,0
20150512,3392,3392,,,,3392,3392,0,0,0,0
20150513,3392,3392,,,,3392,3392,0,0,0,0
20150514,3392,3392,,,,3392,3392,0,0,0,0
20150515,3392,3392,,,,3392,3392,0,0,0,0
20150518,3392,3392,,,,3392,3392,0,0,0,0
20150519,3392,3392,,,,3312,3312,-80,-80,0,0
20150520,3312,3312,3160,3226,3146,3146,3186,-166,-126,22,4
20150521,3146,3186,3300,3300,3300,3300,3300,114,114,2,2
20150522,3300,3300,,,,3300,3300,0,0,0,2
20150525,3300,3300,,,,3300,3300,0,0,0,2
20150526,3300,3300,,,,3300,3300,0,0,0,2
20150527,3300,3300,,,,3300,3300,0,0,0,2
20150528,3300,3300,,,,3300,3300,0,0,0,2
20150529,3300,3300,,,,3300,3300,0,0,0,2
20150601,3300,3300,,,,3300,3300,0,0,0,2
20150602,3300,3300,,,,3300,3300,0,0,0,2
20150603,3300,3300,,,,3300,3300,0,0,0,2
20150604,3300,3300,,,,3300,3300,0,0,0,2
20150605,3300,3300,3300,3300,3144,3144,3222,-156,-78,4,2
20150608,3144,3222,,,,3222,3222,0,0,0,2
20150609,3222,3222,,,,3222,3222,0,0,0,2
20150610,3222,3222,,,,3222,3222,0,0,0,2
20150611,3222,3222,,,,3222,3222,0,0,0,2
20150612,3222,3222,,,,3222,3222,0,0,0,2
20150615,3222,3222,,,,3180,3180,-42,-42,0,2
20150616,3180,3180,,,,3180,3180,0,0,0,2
20150617,3180,3180,,,,3180,3180,0,0,0,2
20150618,3180,3180,,,,3180,3180,0,0,0,2
20150619,3180,3180,,,,3158,3158,-22,-22,0,2
20150623,3158,3158,,,,3110,3110,-48,-48,0,2
20150624,3110,3110,,,,3110,3110,0,0,0,2
20150625,3110,3110,,,,3110,3110,0,0,0,2
20150626,3110,3110,,,,3110,3110,0,0,0,2
20150629,3110,3110,,,,3110,3110,0,0,0,2
20150630,3110,3110,3030,3030,3030,3030,3030,-80,-80,6,8
20150701,3030,3030,,,,2970,2970,-60,-60,0,8
20150702,2970,2970,2948,2948,2948,2948,2948,-22,-22,2,10
20150703,2948,2948,2956,2964,2910,2914,2936,-34,-12,8,8
20150706,2914,2936,,,,2896,2896,-40,-40,0,8
20150707,2896,2896,,,,2798,2798,-98,-98,0,8
20150708,2798,2798,,,,2658,2658,-140,-140,0,8
20150709,2658,2658,2660,2784,2524,2784,2584,126,-74,22,8
20150710,2784,2584,2620,2712,2620,2712,2652,128,68,6,8
20150713,2712,2652,2556,2650,2556,2650,2626,-2,-26,22,6
20150714,2650,2626,2706,2706,2526,2592,2586,-34,-40,8,4
20150715,2592,2586,2568,2590,2568,2590,2578,4,-8,4,4
20150716,2590,2578,2610,2610,2610,2610,2610,32,32,2,4
20150717,2610,2610,2604,2604,2542,2542,2586,-68,-24,14,4
20150720,2542,2586,,,,2586,2586,0,0,0,4
20150721,2586,2586,,,,2586,2586,0,0,0,4
20150722,2586,2586,,,,2540,2540,-46,-46,0,4
20150723,2540,2540,,,,2562,2562,22,22,0,4
20150724,2562,2562,,,,2566,2566,4,4,0,4
20150727,2566,2566,,,,2466,2466,-100,-100,0,4
20150728,2466,2466,,,,2418,2418,-48,-48,0,4
20150729,2418,2418,,,,2466,2466,48,48,0,4
20150730,2466,2466,,,,2466,2466,0,0,0,4
20150731,2466,2466,,,,2466,2466,0,0,0,4
20150803,2466,2466,,,,2400,2400,-66,-66,0,4
20150804,2400,2400,,,,2356,2356,-44,-44,0,4
20150805,2356,2356,,,,2374,2374,18,18,0,4
20150806,2374,2374,,,,2370,2370,-4,-4,0,4
20150807,2370,2370,,,,2376,2376,6,6,0,4
20150810,2376,2376,,,,2464,2464,88,88,0,4
20150811,2464,2464,,,,2468,2468,4,4,0,4
20150812,2468,2468,,,,2468,2468,0,0,0,4
20150813,2468,2468,,,,2468,2468,0,0,0,4
20150814,2468,2468,,,,2468,2468,0,0,0,4
20150817,2468,2468,,,,2410,2410,-58,-58,0,4
20150818,2410,2410,,,,2384,2384,-26,-26,0,4
20150819,2384,2384,2426,2426,2426,2426,2426,42,42,2,4
20150820,2426,2426,2524,2524,2436,2450,2462,24,36,8,4
20150821,2450,2462,2340,2450,2340,2450,2394,-12,-68,4,4
20150824,2450,2394,,,,2372,2372,-22,-22,0,4
20150825,2372,2372,2324,2324,2324,2324,2324,-48,-48,2,4
20150826,2324,2324,,,,2352,2352,28,28,0,4
20150827,2352,2352,,,,2410,2410,58,58,0,4
20150828,2410,2410,,,,2472,2472,62,62,0,4
20150831,2472,2472,,,,2442,2442,-30,-30,0,4
20150901,2442,2442,,,,2472,2472,30,30,0,4
20150902,2472,2472,,,,2448,2448,-24,-24,0,4
20150907,2448,2448,,,,2476,2476,28,28,0,4
20150908,2476,2476,,,,2454,2454,-22,-22,0,4
20150909,2454,2454,,,,2454,2454,0,0,0,4
20150910,2454,2454,,,,2476,2476,22,22,0,4
20150911,2476,2476,,,,2476,2476,0,0,0,4
20150914,2476,2476,,,,2568,2568,92,92,0,4
20150915,2568,2568,,,,2568,2568,0,0,0,4
20150916,2568,2568,,,,2568,2568,0,0,0,4
20150917,2568,2568,,,,2568,2568,0,0,0,4
20150918,2568,2568,,,,2568,2568,0,0,0,4
20150921,2568,2568,,,,2568,2568,0,0,0,4
20150922,2568,2568,,,,2568,2568,0,0,0,4
20150923,2568,2568,,,,2568,2568,0,0,0,4
20150924,2568,2568,,,,2568,2568,0,0,0,4
20150925,2568,2568,,,,2568,2568,0,0,0,4
20150928,2568,2568,,,,2568,2568,0,0,0,4
20150929,2568,2568,2440,2440,2440,2440,2440,-128,-128,2,2
20150930,2440,2440,,,,2440,2440,0,0,0,2
20151008,2440,2440,2440,2440,2440,2440,2440,0,0,2,0
20151009,2440,2440,,,,2440,2440,0,0,0,0
20151012,2440,2440,,,,2440,2440,0,0,0,0
20151013,2440,2440,,,,2440,2440,0,0,0,0
20151014,2440,2440,,,,2440,2440,0,0,0,0
20151015,2440,2440,,,,2440,2440,0,0,0,0
bu1511,20150518,3392,3392,,,,3366,3366,-26,-26,0,0
20150519,3366,3366,,,,3286,3286,-80,-80,0,0
20150520,3286,3286,,,,3286,3286,0,0,0,0
20150521,3286,3286,,,,3286,3286,0,0,0,0
20150522,3286,3286,,,,3286,3286,0,0,0,0
20150525,3286,3286,,,,3286,3286,0,0,0,0
20150526,3286,3286,,,,3286,3286,0,0,0,0
20150527,3286,3286,,,,3286,3286,0,0,0,0
20150528,3286,3286,,,,3286,3286,0,0,0,0
20150529,3286,3286,,,,3304,3304,18,18,0,0
20150601,3304,3304,,,,3304,3304,0,0,0,0
20150602,3304,3304,,,,3304,3304,0,0,0,0
20150603,3304,3304,,,,3304,3304,0,0,0,0
20150604,3304,3304,,,,3304,3304,0,0,0,0
20150605,3304,3304,,,,3304,3304,0,0,0,0
20150608,3304,3304,,,,3304,3304,0,0,0,0
20150609,3304,3304,,,,3304,3304,0,0,0,0
20150610,3304,3304,,,,3304,3304,0,0,0,0
20150611,3304,3304,,,,3304,3304,0,0,0,0
20150612,3304,3304,,,,3304,3304,0,0,0,0
20150615,3304,3304,,,,3260,3260,-44,-44,0,0
20150616,3260,3260,,,,3260,3260,0,0,0,0
20150617,3260,3260,,,,3260,3260,0,0,0,0
20150618,3260,3260,,,,3260,3260,0,0,0,0
20150619,3260,3260,,,,3236,3236,-24,-24,0,0
20150623,3236,3236,,,,3186,3186,-50,-50,0,0
20150624,3186,3186,,,,3186,3186,0,0,0,0
20150625,3186,3186,3270,3270,2888,3022,3056,-164,-130,14,0
20150626,3022,3056,2950,3150,2950,3030,3064,-26,8,8,0
20150629,3030,3064,,,,3064,3064,0,0,0,0
20150630,3064,3064,,,,2984,2984,-80,-80,0,0
20150701,2984,2984,,,,2964,2964,-20,-20,0,0
20150702,2964,2964,,,,2942,2942,-22,-22,0,0
20150703,2942,2942,,,,2930,2930,-12,-12,0,0
20150706,2930,2930,,,,2838,2838,-92,-92,0,0
20150707,2838,2838,,,,2742,2742,-96,-96,0,0
20150708,2742,2742,,,,2604,2604,-138,-138,0,0
20150709,2604,2604,,,,2604,2604,0,0,0,0
20150710,2604,2604,2500,2706,2500,2600,2620,-4,16,120,2
20150713,2600,2620,,,,2620,2620,0,0,0,2
20150714,2620,2620,,,,2620,2620,0,0,0,2
20150715,2620,2620,,,,2620,2620,0,0,0,2
20150716,2620,2620,,,,2620,2620,0,0,0,2
20150717,2620,2620,,,,2620,2620,0,0,0,2
20150720,2620,2620,,,,2620,2620,0,0,0,2
20150721,2620,2620,,,,2620,2620,0,0,0,2
20150722,2620,2620,,,,2620,2620,0,0,0,2
20150723,2620,2620,,,,2620,2620,0,0,0,2
20150724,2620,2620,,,,2620,2620,0,0,0,2
20150727,2620,2620,,,,2620,2620,0,0,0,2
20150728,2620,2620,,,,2620,2620,0,0,0,2
20150729,2620,2620,,,,2620,2620,0,0,0,2
20150730,2620,2620,,,,2620,2620,0,0,0,2
20150731,2620,2620,,,,2620,2620,0,0,0,2
20150803,2620,2620,,,,2576,2576,-44,-44,0,2
20150804,2576,2576,,,,2576,2576,0,0,0,2
20150805,2576,2576,,,,2576,2576,0,0,0,2
20150806,2576,2576,2694,2694,2466,2466,2556,-110,-20,8,2
20150807,2466,2556,,,,2556,2556,0,0,0,2
20150810,2556,2556,,,,2650,2650,94,94,0,2
20150811,2650,2650,,,,2650,2650,0,0,0,2
20150812,2650,2650,,,,2630,2630,-20,-20,0,2
20150813,2630,2630,,,,2630,2630,0,0,0,2
20150814,2630,2630,,,,2600,2600,-30,-30,0,2
20150817,2600,2600,,,,2560,2560,-40,-40,0,2
20150818,2560,2560,,,,2560,2560,0,0,0,2
20150819,2560,2560,2440,2574,2440,2482,2486,-78,-74,58,2
20150820,2482,2486,,,,2486,2486,0,0,0,2
20150821,2486,2486,2360,2474,2360,2406,2400,-80,-86,12,2
20150824,2406,2400,2390,2390,2390,2390,2390,-10,-10,4,4
20150825,2390,2390,,,,2340,2340,-50,-50,0,4
20150826,2340,2340,,,,2340,2340,0,0,0,4
20150827,2340,2340,2390,2390,2390,2390,2390,50,50,2,2
20150828,2390,2390,,,,2452,2452,62,62,0,2
20150831,2452,2452,,,,2452,2452,0,0,0,2
20150901,2452,2452,,,,2482,2482,30,30,0,2
20150902,2482,2482,,,,2458,2458,-24,-24,0,2
20150907,2458,2458,,,,2486,2486,28,28,0,2
20150908,2486,2486,,,,2464,2464,-22,-22,0,2
20150909,2464,2464,2478,2478,2348,2348,2412,-116,-52,8,6
20150910,2348,2412,2528,2532,2368,2502,2490,90,78,12,10
20150911,2502,2490,2392,2392,2392,2392,2392,-98,-98,4,10
20150914,2392,2392,,,,2482,2482,90,90,0,10
20150915,2482,2482,2606,2606,2426,2504,2492,22,10,76,2
20150916,2504,2492,2432,2498,2432,2452,2444,-40,-48,28,2
20150917,2452,2444,2396,2558,2396,2426,2460,-18,16,6,4
20150918,2426,2460,,,,2460,2460,0,0,0,4
20150921,2460,2460,,,,2460,2460,0,0,0,4
20150922,2460,2460,2422,2422,2422,2422,2422,-38,-38,2,4
20150923,2422,2422,,,,2422,2422,0,0,0,4
20150924,2422,2422,2530,2530,2414,2414,2472,-8,50,46,4
20150925,2414,2472,,,,2472,2472,0,0,0,4
20150928,2472,2472,,,,2472,2472,0,0,0,4
20150929,2472,2472,,,,2348,2348,-124,-124,0,4
20150930,2348,2348,2500,2512,2352,2352,2432,4,84,16,4
20151008,2352,2432,,,,2432,2432,0,0,0,4
20151009,2432,2432,2570,2570,2426,2426,2498,-6,66,4,6
20151012,2426,2498,2482,2482,2482,2482,2482,-16,-16,2,6
20151013,2482,2482,2408,2546,2408,2546,2476,64,-6,4,6
20151014,2546,2476,,,,2476,2476,0,0,0,6
20151015,2476,2476,,,,2476,2476,0,0,0,6
20151016,2476,2476,2424,2624,2424,2506,2492,30,16,48,4
20151019,2506,2492,,,,2498,2498,6,6,0,4
20151020,2498,2498,2498,2498,2498,2498,2498,0,0,2,4
20151021,2498,2498,2360,2524,2354,2354,2412,-144,-86,6,6
20151022,2354,2412,2556,2556,2556,2556,2556,144,144,2,4
20151023,2556,2556,2424,2606,2404,2498,2496,-58,-60,36,28
20151026,2498,2496,2508,2532,2508,2532,2518,36,22,8,26
20151027,2532,2518,2514,2546,2504,2546,2514,28,-4,16,18
20151028,2546,2514,,,,2514,2514,0,0,0,18
20151029,2514,2514,2530,2550,2398,2536,2486,22,-28,40,8
20151030,2536,2486,2336,2508,2336,2500,2448,14,-38,6,8
20151102,2500,2448,2394,2540,2372,2520,2470,72,22,10,8
20151103,2520,2470,2570,2570,2512,2546,2548,76,78,8,6
20151104,2546,2548,2700,2700,2700,2700,2700,152,152,2,6
20151105,2700,2700,2710,2710,2710,2710,2710,10,10,2,4
20151106,2710,2710,,,,2700,2700,-10,-10,0,4
20151109,2700,2700,2698,2704,2538,2602,2648,-98,-52,10,0
20151110,2602,2648,,,,2648,2648,0,0,0,0
20151111,2648,2648,,,,2648,2648,0,0,0,0
20151112,2648,2648,,,,2648,2648,0,0,0,0
20151113,2648,2648,,,,2648,2648,0,0,0,0
20151116,2648,2648,,,,2648,2648,0,0,0,0
bu1512,20150105,3380,3380,,,,3356,3356,-24,-24,0,8
20150106,3356,3356,,,,3402,3402,46,46,0,8
20150107,3402,3402,,,,3348,3348,-54,-54,0,8
20150108,3348,3348,,,,3306,3306,-42,-42,0,8
20150109,3306,3306,,,,3296,3296,-10,-10,0,8
20150112,3296,3296,,,,3136,3136,-160,-160,0,8
20150113,3136,3136,,,,3130,3130,-6,-6,0,8
20150114,3130,3130,,,,3130,3130,0,0,0,8
20150115,3130,3130,,,,3146,3146,16,16,0,8
20150116,3146,3146,,,,3158,3158,12,12,0,8
20150119,3158,3158,,,,3100,3100,-58,-58,0,8
20150120,3100,3100,,,,3062,3062,-38,-38,0,8
20150121,3062,3062,,,,3036,3036,-26,-26,0,8
20150122,3036,3036,,,,3054,3054,18,18,0,8
20150123,3054,3054,,,,3048,3048,-6,-6,0,8
20150126,3048,3048,,,,2896,2896,-152,-152,0,8
20150127,2896,2896,,,,2856,2856,-40,-40,0,8
20150128,2856,2856,,,,2884,2884,28,28,0,8
20150129,2884,2884,,,,2876,2876,-8,-8,0,8
20150130,2876,2876,,,,2832,2832,-44,-44,0,8
20150202,2832,2832,,,,2972,2972,140,140,0,8
20150203,2972,2972,,,,3072,3072,100,100,0,8
20150204,3072,3072,,,,3072,3072,0,0,0,8
20150205,3072,3072,,,,3072,3072,0,0,0,8
20150206,3072,3072,,,,3072,3072,0,0,0,8
20150209,3072,3072,,,,3078,3078,6,6,0,8
20150210,3078,3078,,,,3056,3056,-22,-22,0,8
20150211,3056,3056,,,,3056,3056,0,0,0,8
20150212,3056,3056,,,,3056,3056,0,0,0,8
20150213,3056,3056,,,,3140,3140,84,84,0,8
20150216,3140,3140,,,,3140,3140,0,0,0,8
20150217,3140,3140,,,,3164,3164,24,24,0,8
20150225,3164,3164,,,,3164,3164,0,0,0,8
20150226,3164,3164,,,,3238,3238,74,74,0,8
20150227,3238,3238,3398,3398,3398,3398,3398,160,160,20,20
20150302,3398,3398,,,,3398,3398,0,0,0,20
20150303,3398,3398,,,,3398,3398,0,0,0,20
20150304,3398,3398,,,,3398,3398,0,0,0,20
20150305,3398,3398,3378,3378,3378,3378,3378,-20,-20,2,20
20150306,3378,3378,3396,3398,3394,3394,3396,16,18,6,20
20150309,3394,3396,,,,3396,3396,0,0,0,20
20150310,3396,3396,,,,3396,3396,0,0,0,20
20150311,3396,3396,3392,3392,3380,3380,3386,-16,-10,4,20
20150312,3380,3386,,,,3386,3386,0,0,0,20
20150313,3386,3386,,,,3386,3386,0,0,0,20
20150316,3386,3386,,,,3350,3350,-36,-36,0,20
20150317,3350,3350,,,,3350,3350,0,0,0,20
20150318,3350,3350,,,,3350,3350,0,0,0,20
20150319,3350,3350,,,,3350,3350,0,0,0,20
20150320,3350,3350,,,,3350,3350,0,0,0,20
20150323,3350,3350,,,,3354,3354,4,4,0,20
20150324,3354,3354,,,,3390,3390,36,36,0,20
20150325,3390,3390,,,,3390,3390,0,0,0,20
20150326,3390,3390,3468,3498,3466,3490,3472,100,82,32,16
20150327,3490,3472,3460,3460,3408,3408,3434,-64,-38,4,14
20150330,3408,3434,,,,3434,3434,0,0,0,14
20150331,3434,3434,,,,3410,3410,-24,-24,0,14
20150401,3410,3410,,,,3410,3410,0,0,0,14
20150402,3410,3410,,,,3488,3488,78,78,0,14
20150403,3488,3488,,,,3488,3488,0,0,0,14
20150407,3488,3488,,,,3488,3488,0,0,0,14
20150408,3488,3488,3510,3578,3510,3578,3544,90,56,4,14
20150409,3578,3544,,,,3544,3544,0,0,0,14
20150410,3544,3544,3558,3558,3558,3558,3558,14,14,4,12
20150413,3558,3558,,,,3558,3558,0,0,0,12
20150414,3558,3558,,,,3558,3558,0,0,0,12
20150415,3558,3558,,,,3558,3558,0,0,0,12
20150416,3558,3558,3390,3558,3390,3558,3474,0,-84,4,12
20150417,3558,3474,,,,3474,3474,0,0,0,12
20150420,3474,3474,3468,3468,3468,3468,3468,-6,-6,2,12
20150421,3468,3468,,,,3468,3468,0,0,0,12
20150422,3468,3468,,,,3468,3468,0,0,0,12
20150423,3468,3468,3498,3498,3498,3498,3498,30,30,2,10
20150424,3498,3498,,,,3498,3498,0,0,0,10
20150427,3498,3498,,,,3500,3500,2,2,0,10
20150428,3500,3500,3656,3656,3464,3632,3608,132,108,90,50
20150429,3632,3608,3596,3596,3572,3572,3588,-36,-20,8,52
20150430,3572,3588,3588,3588,3530,3574,3568,-14,-20,8,52
20150504,3574,3568,3562,3596,3562,3596,3578,28,10,4,50
20150505,3596,3578,,,,3580,3580,2,2,0,50
20150506,3580,3580,3688,3688,3618,3618,3670,38,90,14,50
20150507,3618,3670,3616,3616,3524,3524,3576,-146,-94,6,52
20150508,3524,3576,3530,3530,3448,3448,3488,-128,-88,4,52
20150511,3448,3488,,,,3488,3488,0,0,0,52
20150512,3488,3488,3486,3486,3434,3434,3460,-54,-28,4,52
20150513,3434,3460,3438,3438,3438,3438,3438,-22,-22,2,54
20150514,3438,3438,3438,3438,3404,3404,3426,-34,-12,6,52
20150515,3404,3426,3366,3396,3336,3336,3366,-90,-60,6,52
20150518,3336,3366,3456,3456,3358,3386,3392,20,26,28,50
20150519,3386,3392,3326,3380,3272,3284,3320,-108,-72,26,56
20150520,3284,3320,3228,3294,3190,3200,3224,-120,-96,20,60
20150521,3200,3224,3224,3244,3224,3244,3234,20,10,4,58
20150522,3244,3234,,,,3240,3240,6,6,0,58
20150525,3240,3240,,,,3240,3240,0,0,0,58
20150526,3240,3240,3232,3272,3232,3272,3248,32,8,6,60
20150527,3272,3248,,,,3248,3248,0,0,0,60
20150528,3248,3248,3274,3276,3236,3240,3260,-8,12,12,60
20150529,3240,3260,3276,3276,3276,3276,3276,16,16,2,58
20150601,3276,3276,3344,3344,3330,3330,3336,54,60,4,58
20150602,3330,3336,3328,3496,3272,3302,3334,-34,-2,52,56
20150603,3302,3334,3320,3478,3320,3330,3364,-4,30,60,70
20150604,3330,3364,3256,3336,3256,3268,3296,-96,-68,26,66
20150605,3268,3296,3250,3256,3190,3198,3244,-98,-52,60,102
20150608,3198,3244,3206,3296,3206,3220,3244,-24,0,26,106
20150609,3220,3244,3192,3248,3192,3218,3226,-26,-18,12,108
20150610,3218,3226,3238,3264,3236,3264,3250,38,24,14,104
20150611,3264,3250,3170,3298,3170,3248,3250,-2,0,50,104
20150612,3248,3250,3242,3248,3128,3180,3212,-70,-38,100,106
20150615,3180,3212,3190,3208,3164,3180,3194,-32,-18,86,110
20150616,3180,3194,3088,3160,3088,3158,3140,-36,-54,38,118
20150617,3158,3140,3118,3158,3064,3094,3102,-46,-38,18,116
20150618,3094,3102,3096,3100,3068,3068,3086,-34,-16,22,124
20150619,3068,3086,3056,3056,3040,3050,3048,-36,-38,16,136
20150623,3050,3048,,,,3048,3048,0,0,0,136
20150624,3048,3048,3030,3030,3030,3030,3030,-18,-18,2,138
20150625,3030,3030,3044,3044,3044,3044,3044,14,14,2,138
20150626,3044,3044,3022,3044,3004,3044,3020,0,-24,22,124
20150629,3044,3020,,,,3024,3024,4,4,0,124
20150630,3024,3024,2988,2988,2874,2978,2942,-46,-82,12,124
20150701,2978,2942,2940,2940,2906,2906,2928,-36,-14,6,126
20150702,2906,2928,2938,3032,2840,2856,2900,-72,-28,14,136
20150703,2856,2900,2988,2988,2868,2878,2894,-22,-6,60,174
20150706,2878,2894,2848,2882,2750,2772,2818,-122,-76,226,278
20150707,2772,2818,2752,2784,2676,2678,2728,-140,-90,152,324
20150708,2678,2728,2630,2630,2590,2590,2590,-138,-138,348,208
20150709,2590,2590,2512,2796,2384,2606,2646,16,56,192,190
20150710,2606,2646,2760,2760,2608,2650,2680,4,34,108,194
20150713,2650,2680,2676,2676,2560,2564,2600,-116,-80,72,210
20150714,2564,2600,2598,2648,2586,2586,2598,-14,-2,74,264
20150715,2586,2598,2522,2608,2520,2604,2584,6,-14,68,294
20150716,2604,2584,2586,2592,2532,2554,2560,-30,-24,54,316
20150717,2554,2560,2600,2666,2550,2570,2580,10,20,36,322
20150720,2570,2580,2588,2638,2560,2622,2598,42,18,112,334
20150721,2622,2598,2648,2648,2560,2618,2604,20,6,98,360
20150722,2618,2604,2622,2714,2600,2630,2646,26,42,144,368
20150723,2630,2646,2650,2650,2584,2614,2608,-32,-38,180,414
20150724,2614,2608,2630,2652,2588,2588,2608,-20,0,174,430
20150727,2588,2608,2582,2582,2476,2500,2508,-108,-100,1146,656
20150728,2500,2508,2480,2554,2464,2522,2500,14,-8,332,640
20150729,2522,2500,2550,2568,2518,2542,2540,42,40,352,640
20150730,2542,2540,2524,2576,2500,2522,2530,-18,-10,690,744
20150731,2522,2530,2538,2546,2510,2526,2530,-4,0,282,766
20150803,2526,2530,2506,2550,2432,2440,2478,-90,-52,1724,1378
20150804,2440,2478,2428,2460,2408,2450,2434,-28,-44,958,1516
20150805,2450,2434,2460,2478,2440,2468,2456,34,22,1766,1670
20150806,2468,2456,2470,2470,2440,2448,2452,-8,-4,1426,1798
20150807,2448,2452,2438,2528,2436,2528,2462,76,10,1764,1996
20150810,2528,2462,2510,2584,2498,2584,2538,122,76,5018,2312
20150811,2584,2538,2606,2628,2540,2544,2588,6,50,7694,4212
20150812,2544,2588,2536,2540,2506,2534,2520,-54,-68,7228,5474
20150813,2534,2520,2548,2616,2524,2614,2572,94,52,13592,6632
20150814,2614,2572,2590,2610,2556,2564,2582,-8,10,15818,7316
20150817,2564,2582,2570,2600,2466,2502,2536,-80,-46,18140,8268
20150818,2502,2536,2496,2550,2492,2502,2522,-34,-14,15558,9056
20150819,2502,2522,2510,2530,2442,2494,2482,-28,-40,25962,11168
20150820,2494,2482,2488,2494,2378,2392,2420,-90,-62,59822,20720
20150821,2392,2420,2414,2418,2318,2342,2364,-78,-56,111068,29196
20150824,2342,2364,2326,2348,2244,2244,2290,-120,-74,110926,32064
20150825,2244,2290,2214,2296,2162,2222,2228,-68,-62,182292,29290
20150826,2222,2228,2292,2310,2228,2246,2264,18,36,146108,29636
20150827,2246,2264,2252,2362,2220,2356,2288,92,24,208604,30086
20150828,2356,2288,2368,2402,2332,2364,2368,76,80,206808,28706
20150831,2364,2368,2346,2410,2318,2346,2366,-22,-2,267530,28324
20150901,2346,2366,2328,2430,2314,2384,2384,18,18,292622,28304
20150902,2384,2384,2358,2388,2272,2272,2332,-112,-52,285634,35530
20150907,2272,2332,2266,2310,2254,2284,2282,-48,-50,133916,38466
20150908,2284,2282,2282,2304,2260,2304,2276,22,-6,167724,37374
20150909,2304,2276,2320,2384,2312,2346,2350,70,74,318758,33674
20150910,2346,2350,2336,2466,2326,2466,2384,116,34,368164,46570
20150911,2466,2384,2468,2482,2430,2450,2456,66,72,477308,45956
20150914,2450,2456,2436,2550,2426,2498,2502,42,46,1097786,69756
20150915,2498,2502,2496,2556,2384,2414,2466,-88,-36,1490268,93590
20150916,2414,2466,2420,2446,2392,2436,2418,-30,-48,1061500,97976
20150917,2436,2418,2448,2460,2408,2412,2438,-6,20,842872,104638
20150918,2412,2438,2402,2428,2364,2372,2396,-66,-42,710970,104296
20150921,2372,2396,2360,2404,2336,2402,2360,6,-36,591028,100698
20150922,2402,2360,2408,2414,2338,2346,2372,-14,12,503334,109958
20150923,2346,2372,2330,2382,2322,2360,2348,-12,-24,498364,100966
20150924,2360,2348,2356,2396,2346,2372,2370,24,22,515178,100966
20150925,2372,2370,2360,2398,2350,2364,2374,-6,4,488562,85000
20150928,2364,2374,2368,2368,2326,2366,2352,-8,-22,260744,81444
20150929,2366,2352,2356,2388,2300,2328,2340,-24,-12,611312,64262
20150930,2328,2340,2346,2354,2308,2344,2332,4,-8,250640,50466
20151008,2344,2332,2400,2444,2368,2380,2390,48,58,169772,56036
20151009,2380,2390,2382,2468,2378,2462,2420,72,30,497376,77046
20151012,2462,2420,2454,2462,2408,2436,2434,16,14,426504,91326
20151013,2436,2434,2426,2428,2370,2418,2402,-16,-32,407902,85118
20151014,2418,2402,2408,2440,2404,2414,2420,12,18,338282,87662
20151015,2414,2420,2416,2444,2404,2412,2422,-8,2,326224,91302
20151016,2412,2422,2404,2448,2392,2428,2422,6,0,426252,93398
20151019,2428,2422,2422,2488,2418,2444,2446,22,24,699890,119664
20151020,2444,2446,2430,2440,2358,2380,2400,-66,-46,582176,108894
20151021,2380,2400,2384,2386,2274,2284,2334,-116,-66,702788,118748
20151022,2284,2334,2284,2292,2232,2258,2258,-76,-76,864484,127402
20151023,2258,2258,2262,2282,2152,2206,2216,-52,-42,1182402,165200
20151026,2206,2216,2200,2238,2164,2214,2206,-2,-10,991012,157342
20151027,2214,2206,2210,2238,2170,2226,2202,20,-4,812322,148066
20151028,2226,2202,2212,2234,2204,2216,2218,14,16,642460,142124
20151029,2216,2218,2220,2266,2216,2238,2244,20,26,622592,131926
20151030,2238,2244,2242,2270,2176,2180,2224,-64,-20,769254,159626
20151102,2180,2224,2190,2212,2160,2188,2186,-36,-38,683262,142426
20151103,2188,2186,2184,2218,2152,2164,2182,-22,-4,641088,160082
20151104,2164,2182,2170,2254,2164,2226,2212,44,30,768930,134666
20151105,2226,2212,2232,2250,2194,2244,2224,32,12,694374,154862
20151106,2244,2224,2250,2302,2222,2292,2260,68,36,1035026,157798
20151109,2292,2260,2286,2312,2256,2270,2280,10,20,943970,128800
20151110,2270,2280,2272,2298,2252,2292,2270,12,-10,565904,126898
20151111,2292,2270,2294,2296,2258,2268,2276,-2,6,497918,115600
20151112,2268,2276,2268,2324,2256,2304,2278,28,2,580302,113280
20151113,2304,2278,2290,2350,2284,2296,2318,18,40,765316,107778
20151116,2296,2318,2290,2296,2178,2178,2238,-140,-80,749578,106380
20151117,2178,2238,2178,2194,2092,2108,2140,-130,-98,765152,87572
20151118,2108,2140,2100,2124,2062,2082,2092,-58,-48,389602,86492
20151119,2082,2092,2076,2096,2022,2036,2064,-56,-28,308848,78372
20151120,2036,2064,2028,2096,2012,2058,2046,-6,-18,307974,69742
20151123,2058,2046,2050,2092,1922,1924,2006,-122,-40,372966,75366
20151124,1924,2006,1934,1966,1890,1954,1924,-52,-82,249710,55556
20151125,1954,1924,1954,1996,1818,1948,1916,24,-8,320284,46686
20151126,1948,1916,1938,2010,1884,1982,1952,66,36,160970,28424
20151127,1982,1952,2010,2010,1902,1936,1950,-16,-2,58064,21918
20151130,1936,1950,1936,1956,1912,1938,1934,-12,-16,21208,16696
bu1601,20150716,2584,2584,,,,2584,2584,0,0,0,0
20150717,2584,2584,2566,2696,2556,2654,2648,70,64,14,0
20150720,2654,2648,,,,2648,2648,0,0,0,0
20150721,2648,2648,,,,2648,2648,0,0,0,0
20150722,2648,2648,,,,2692,2692,44,44,0,0
20150723,2692,2692,,,,2654,2654,-38,-38,0,0
20150724,2654,2654,2622,2622,2558,2568,2578,-86,-76,8,6
20150727,2568,2578,2576,2576,2448,2448,2532,-130,-46,8,4
20150728,2448,2532,2442,2560,2442,2560,2500,28,-32,44,4
20150729,2560,2500,,,,2500,2500,0,0,0,4
20150730,2500,2500,2618,2618,2428,2596,2534,96,34,26,4
20150731,2596,2534,2584,2584,2584,2584,2584,50,50,2,4
20150803,2584,2584,2524,2620,2454,2488,2526,-96,-58,12,4
20150804,2488,2526,,,,2526,2526,0,0,0,4
20150805,2526,2526,2498,2498,2498,2498,2498,-28,-28,2,2
20150806,2498,2498,2608,2608,2400,2424,2476,-74,-22,10,2
20150807,2424,2476,2354,2526,2352,2466,2434,-10,-42,160,6
20150810,2466,2434,2510,2554,2466,2518,2524,84,90,70,12
20150811,2518,2524,2546,2600,2540,2566,2570,42,46,48,14
20150812,2566,2570,2566,2596,2512,2550,2534,-20,-36,38,30
20150813,2550,2534,2648,2648,2530,2624,2604,90,70,46,24
20150814,2624,2604,2672,2672,2596,2628,2630,24,26,68,34
20150817,2628,2630,2596,2610,2502,2550,2558,-80,-72,84,28
20150818,2550,2558,2578,2578,2534,2552,2554,-6,-4,26,26
20150819,2552,2554,2630,2630,2474,2526,2512,-28,-42,268,26
20150820,2526,2512,2502,2582,2428,2446,2470,-66,-42,274,44
20150821,2446,2470,2424,2458,2374,2384,2420,-86,-50,176,48
20150824,2384,2420,2370,2394,2298,2310,2316,-110,-104,88,46
20150825,2310,2316,2214,2418,2212,2234,2276,-82,-40,270,108
20150826,2234,2276,2250,2328,2250,2326,2288,50,12,310,52
20150827,2326,2288,2248,2400,2248,2400,2304,112,16,154,40
20150828,2400,2304,2408,2418,2356,2414,2388,110,84,438,112
20150831,2414,2388,2416,2446,2328,2394,2388,6,0,358,186
20150901,2394,2388,2412,2478,2360,2430,2412,42,24,870,168
20150902,2430,2412,2420,2436,2284,2320,2360,-92,-52,272,184
20150907,2320,2360,2280,2328,2266,2304,2300,-56,-60,92,216
20150908,2304,2300,2310,2328,2292,2328,2302,28,2,108,240
20150909,2328,2302,2330,2392,2324,2356,2358,54,56,792,300
20150910,2356,2358,2362,2454,2350,2440,2398,82,40,756,350
20150911,2440,2398,2448,2464,2426,2432,2446,34,48,754,334
20150914,2432,2446,2418,2556,2416,2484,2498,38,52,1776,336
20150915,2484,2498,2496,2554,2412,2428,2472,-70,-26,3024,414
20150916,2428,2472,2428,2460,2416,2452,2432,-20,-40,1110,392
20150917,2452,2432,2466,2484,2430,2430,2454,-2,22,1126,468
20150918,2430,2454,2436,2452,2394,2398,2416,-56,-38,1112,514
20150921,2398,2416,2384,2424,2350,2418,2374,2,-42,1622,586
20150922,2418,2374,2412,2436,2356,2362,2384,-12,10,1354,570
20150923,2362,2384,2312,2388,2306,2386,2356,2,-28,1072,572
20150924,2386,2356,2372,2406,2362,2388,2384,32,28,838,500
20150925,2388,2384,2370,2404,2370,2380,2388,-4,4,542,528
20150928,2380,2388,2380,2380,2334,2368,2362,-20,-26,784,490
20150929,2368,2362,2344,2392,2306,2338,2354,-24,-8,1760,476
20150930,2338,2354,2354,2368,2322,2356,2342,2,-12,626,548
20151008,2356,2342,2370,2496,2370,2384,2400,42,58,1068,728
20151009,2384,2400,2384,2456,2380,2440,2412,40,12,1748,958
20151012,2440,2412,2434,2440,2394,2418,2420,6,8,1078,978
20151013,2418,2420,2406,2408,2368,2398,2390,-22,-30,1512,920
20151014,2398,2390,2390,2424,2390,2404,2406,14,16,660,1044
20151015,2404,2406,2410,2428,2394,2402,2414,-4,8,738,1094
20151016,2402,2414,2394,2440,2376,2404,2414,-10,0,1306,1174
20151019,2404,2414,2408,2472,2402,2418,2430,4,16,3812,1286
20151020,2418,2430,2414,2416,2328,2348,2362,-82,-68,2886,1456
20151021,2348,2362,2346,2350,2276,2282,2308,-80,-54,3476,1588
20151022,2282,2308,2278,2288,2232,2264,2264,-44,-44,2432,1472
20151023,2264,2264,2268,2288,2174,2228,2220,-36,-44,4484,2080
20151026,2228,2220,2192,2252,2180,2214,2212,-6,-8,4126,2430
20151027,2214,2212,2214,2226,2172,2218,2196,6,-16,3336,2600
20151028,2218,2196,2206,2228,2200,2206,2212,10,16,3942,2854
20151029,2206,2212,2226,2242,2186,2222,2226,10,14,2958,3000
20151030,2222,2226,2220,2246,2180,2184,2208,-42,-18,3298,3084
20151102,2184,2208,2176,2204,2152,2184,2180,-24,-28,5126,3858
20151103,2184,2180,2170,2196,2152,2158,2174,-22,-6,7792,4750
20151104,2158,2174,2162,2226,2160,2208,2196,34,22,8210,4256
20151105,2208,2196,2206,2220,2182,2212,2202,16,6,7878,4884
20151106,2212,2202,2216,2274,2192,2256,2236,54,34,25678,10536
20151109,2256,2236,2258,2258,2206,2216,2228,-20,-8,23764,14340
20151110,2216,2228,2224,2230,2200,2222,2212,-6,-16,14220,14442
20151111,2222,2212,2228,2242,2208,2212,2218,0,6,14772,14286
20151112,2212,2218,2212,2234,2156,2208,2196,-10,-22,44764,16730
20151113,2208,2196,2176,2208,2176,2188,2190,-8,-6,37632,21064
20151116,2188,2190,2190,2190,2088,2104,2126,-86,-64,105406,32812
20151117,2104,2126,2110,2120,2046,2088,2090,-38,-36,113788,34290
20151118,2088,2090,2084,2096,2050,2060,2070,-30,-20,61362,32650
20151119,2060,2070,2054,2074,2002,2022,2042,-48,-28,71026,31956
20151120,2022,2042,2012,2054,2010,2036,2030,-6,-12,72308,27716
20151123,2036,2030,2030,2064,1908,1908,1970,-122,-60,128548,44060
20151124,1908,1970,1910,1914,1820,1884,1872,-86,-98,374956,50662
20151125,1884,1872,1898,1948,1808,1924,1888,52,16,941676,85174
20151126,1924,1888,1908,1994,1878,1930,1928,42,40,917504,74724
20151127,1930,1928,1918,1958,1854,1876,1904,-52,-24,713246,103468
20151130,1876,1904,1870,1908,1842,1868,1872,-36,-32,727344,112560
bu1602,20150818,2558,2558,,,,2554,2554,-4,-4,0,0
20150819,2554,2554,,,,2554,2554,0,0,0,0
20150820,2554,2554,,,,2510,2510,-44,-44,0,0
20150821,2510,2510,,,,2510,2510,0,0,0,0
20150824,2510,2510,,,,2402,2402,-108,-108,0,0
20150825,2402,2402,,,,2360,2360,-42,-42,0,0
20150826,2360,2360,,,,2372,2372,12,12,0,0
20150827,2372,2372,,,,2388,2388,16,16,0,0
20150828,2388,2388,,,,2476,2476,88,88,0,0
20150831,2476,2476,,,,2476,2476,0,0,0,0
20150901,2476,2476,,,,2500,2500,24,24,0,0
20150902,2500,2500,,,,2446,2446,-54,-54,0,0
20150907,2446,2446,,,,2446,2446,0,0,0,0
20150908,2446,2446,,,,2448,2448,2,2,0,0
20150909,2448,2448,,,,2448,2448,0,0,0,0
20150910,2448,2448,,,,2448,2448,0,0,0,0
20150911,2448,2448,,,,2448,2448,0,0,0,0
20150914,2448,2448,,,,2448,2448,0,0,0,0
20150915,2448,2448,,,,2448,2448,0,0,0,0
20150916,2448,2448,,,,2448,2448,0,0,0,0
20150917,2448,2448,,,,2470,2470,22,22,0,0
20150918,2470,2470,,,,2470,2470,0,0,0,0
20150921,2470,2470,,,,2428,2428,-42,-42,0,0
20150922,2428,2428,,,,2428,2428,0,0,0,0
20150923,2428,2428,,,,2428,2428,0,0,0,0
20150924,2428,2428,,,,2428,2428,0,0,0,0
20150925,2428,2428,2326,2420,2326,2420,2372,-8,-56,4,0
20150928,2420,2372,2304,2416,2304,2356,2358,-16,-14,6,0
20150929,2356,2358,,,,2350,2350,-8,-8,0,0
20150930,2350,2350,,,,2338,2338,-12,-12,0,0
20151008,2338,2338,,,,2368,2368,30,30,0,0
20151009,2368,2368,2486,2486,2464,2486,2480,118,112,8,2
20151012,2486,2480,,,,2480,2480,0,0,0,2
20151013,2480,2480,,,,2480,2480,0,0,0,2
20151014,2480,2480,,,,2480,2480,0,0,0,2
20151015,2480,2480,,,,2480,2480,0,0,0,2
20151016,2480,2480,,,,2480,2480,0,0,0,2
20151019,2480,2480,2486,2486,2486,2486,2486,6,6,2,0
20151020,2486,2486,,,,2486,2486,0,0,0,0
20151021,2486,2486,,,,2430,2430,-56,-56,0,0
20151022,2430,2430,2350,2350,2350,2350,2350,-80,-80,2,2
20151023,2350,2350,2350,2350,2208,2238,2264,-112,-86,20,6
20151026,2238,2264,2312,2336,2184,2298,2280,34,16,26,10
20151027,2298,2280,2298,2300,2236,2276,2284,-4,4,12,12
20151028,2276,2284,2262,2306,2244,2292,2274,8,-10,16,12
20151029,2292,2274,2342,2344,2210,2344,2310,70,36,8,14
20151030,2344,2310,,,,2272,2272,-38,-38,0,14
20151102,2272,2272,,,,2272,2272,0,0,0,14
20151103,2272,2272,,,,2272,2272,0,0,0,14
20151104,2272,2272,,,,2272,2272,0,0,0,14
20151105,2272,2272,,,,2272,2272,0,0,0,14
20151106,2272,2272,2300,2314,2266,2312,2298,40,26,8,12
20151109,2312,2298,2294,2294,2294,2294,2294,-4,-4,2,10
20151110,2294,2294,,,,2278,2278,-16,-16,0,10
20151111,2278,2278,,,,2278,2278,0,0,0,10
20151112,2278,2278,,,,2274,2274,-4,-4,0,10
20151113,2274,2274,2272,2272,2270,2270,2270,-4,-4,8,8
20151116,2270,2270,,,,2204,2204,-66,-66,0,8
20151117,2204,2204,2180,2200,2072,2072,2154,-132,-50,14,12
20151118,2072,2154,2128,2154,2076,2148,2126,-6,-28,8,12
20151119,2148,2126,2166,2166,2026,2026,2104,-100,-22,114,14
20151120,2026,2104,,,,2104,2104,0,0,0,14
20151123,2104,2104,1978,1978,1976,1976,1976,-128,-128,10,14
20151124,1976,1976,1908,1994,1902,1902,1926,-74,-50,16,14
20151125,1902,1926,1914,1974,1872,1938,1908,12,-18,114,42
20151126,1938,1908,1948,2016,1948,1972,1982,64,74,30,58
20151127,1972,1982,1944,1978,1890,1938,1950,-44,-32,60,104
20151130,1938,1950,1898,1938,1898,1914,1914,-36,-36,160,130
bu1603,20150105,3506,3506,,,,3506,3506,0,0,0,6
20150106,3506,3506,,,,3506,3506,0,0,0,6
20150107,3506,3506,3468,3468,3468,3468,3468,-38,-38,2,6
20150108,3468,3468,,,,3468,3468,0,0,0,6
20150109,3468,3468,3468,3468,3432,3432,3444,-36,-24,6,2
20150112,3432,3444,,,,3278,3278,-166,-166,0,2
20150113,3278,3278,,,,3278,3278,0,0,0,2
20150114,3278,3278,,,,3278,3278,0,0,0,2
20150115,3278,3278,,,,3278,3278,0,0,0,2
20150116,3278,3278,,,,3278,3278,0,0,0,2
20150119,3278,3278,,,,3278,3278,0,0,0,2
20150120,3278,3278,,,,3278,3278,0,0,0,2
20150121,3278,3278,,,,3278,3278,0,0,0,2
20150122,3278,3278,,,,3278,3278,0,0,0,2
20150123,3278,3278,,,,3278,3278,0,0,0,2
20150126,3278,3278,,,,3278,3278,0,0,0,2
20150127,3278,3278,3114,3172,3114,3172,3142,-106,-136,4,2
20150128,3172,3142,,,,3142,3142,0,0,0,2
20150129,3142,3142,,,,3142,3142,0,0,0,2
20150130,3142,3142,,,,3142,3142,0,0,0,2
20150202,3142,3142,,,,3142,3142,0,0,0,2
20150203,3142,3142,,,,3142,3142,0,0,0,2
20150204,3142,3142,,,,3142,3142,0,0,0,2
20150205,3142,3142,,,,3142,3142,0,0,0,2
20150206,3142,3142,,,,3142,3142,0,0,0,2
20150209,3142,3142,,,,3142,3142,0,0,0,2
20150210,3142,3142,,,,3142,3142,0,0,0,2
20150211,3142,3142,,,,3142,3142,0,0,0,2
20150212,3142,3142,,,,3142,3142,0,0,0,2
20150213,3142,3142,,,,3142,3142,0,0,0,2
20150216,3142,3142,,,,3142,3142,0,0,0,2
20150217,3142,3142,,,,3142,3142,0,0,0,2
20150225,3142,3142,2922,2922,2922,2922,2922,-220,-220,4,4
20150226,2922,2922,,,,3068,3068,146,146,0,4
20150227,3068,3068,3048,3210,3048,3210,3162,142,94,8,4
20150302,3210,3162,3320,3320,3320,3320,3320,158,158,2,2
20150303,3320,3320,3486,3486,3486,3486,3486,166,166,2,2
20150304,3486,3486,,,,3486,3486,0,0,0,2
20150305,3486,3486,3650,3650,3410,3420,3492,-66,6,6,2
20150306,3420,3492,3616,3616,3616,3616,3616,124,124,2,2
20150309,3616,3616,,,,3480,3480,-136,-136,0,2
20150310,3480,3480,3326,3598,3326,3490,3470,10,-10,6,2
20150311,3490,3470,,,,3450,3450,-20,-20,0,2
20150312,3450,3450,,,,3400,3400,-50,-50,0,2
20150313,3400,3400,,,,3400,3400,0,0,0,2
20150316,3400,3400,,,,3400,3400,0,0,0,2
20150317,3400,3400,,,,3400,3400,0,0,0,2
20150318,3400,3400,,,,3400,3400,0,0,0,2
20150319,3400,3400,,,,3400,3400,0,0,0,2
20150320,3400,3400,,,,3400,3400,0,0,0,2
20150323,3400,3400,3540,3570,3530,3558,3562,158,162,36,32
20150324,3558,3562,3530,3560,3476,3482,3512,-80,-50,8,32
20150325,3482,3512,3550,3550,3480,3530,3522,18,10,16,30
20150326,3530,3522,,,,3522,3522,0,0,0,30
20150327,3522,3522,3450,3450,3450,3450,3450,-72,-72,2,30
20150330,3450,3450,,,,3430,3430,-20,-20,0,30
20150331,3430,3430,,,,3430,3430,0,0,0,30
20150401,3430,3430,,,,3422,3422,-8,-8,0,30
20150402,3422,3422,3528,3530,3450,3450,3498,28,76,8,32
20150403,3450,3498,3500,3502,3500,3502,3500,4,2,16,28
20150407,3502,3500,,,,3504,3504,4,4,0,28
20150408,3504,3504,,,,3504,3504,0,0,0,28
20150409,3504,3504,3504,3650,3480,3560,3540,56,36,14,28
20150410,3560,3540,,,,3540,3540,0,0,0,28
20150413,3540,3540,,,,3540,3540,0,0,0,28
20150414,3540,3540,,,,3540,3540,0,0,0,28
20150415,3540,3540,,,,3546,3546,6,6,0,28
20150416,3546,3546,,,,3546,3546,0,0,0,28
20150417,3546,3546,,,,3546,3546,0,0,0,28
20150420,3546,3546,3550,3550,3548,3548,3548,2,2,4,30
20150421,3548,3548,3466,3498,3466,3498,3482,-50,-66,16,20
20150422,3498,3482,3550,3550,3550,3550,3550,68,68,2,20
20150423,3550,3550,3500,3500,3488,3488,3494,-62,-56,4,22
20150424,3488,3494,3490,3584,3490,3554,3542,60,48,10,14
20150427,3554,3542,,,,3542,3542,0,0,0,14
20150428,3542,3542,,,,3566,3566,24,24,0,14
20150429,3566,3566,3556,3556,3556,3556,3556,-10,-10,2,14
20150430,3556,3556,3570,3570,3570,3570,3570,14,14,2,12
20150504,3570,3570,,,,3570,3570,0,0,0,12
20150505,3570,3570,3730,3730,3518,3518,3624,-52,54,4,12
20150506,3518,3624,,,,3626,3626,2,2,0,12
20150507,3626,3626,3482,3628,3482,3522,3544,-104,-82,6,14
20150508,3522,3544,3422,3530,3422,3530,3492,-14,-52,6,14
20150511,3530,3492,3562,3562,3562,3562,3562,70,70,2,12
20150512,3562,3562,3522,3522,3432,3432,3476,-130,-86,4,14
20150513,3432,3476,3540,3540,3540,3540,3540,64,64,2,14
20150514,3540,3540,3426,3522,3426,3522,3490,-18,-50,6,12
20150515,3522,3490,,,,3490,3490,0,0,0,12
20150518,3490,3490,,,,3490,3490,0,0,0,12
20150519,3490,3490,,,,3490,3490,0,0,0,12
20150520,3490,3490,,,,3440,3440,-50,-50,0,12
20150521,3440,3440,,,,3440,3440,0,0,0,12
20150522,3440,3440,,,,3440,3440,0,0,0,12
20150525,3440,3440,,,,3440,3440,0,0,0,12
20150526,3440,3440,,,,3440,3440,0,0,0,12
20150527,3440,3440,,,,3500,3500,60,60,0,12
20150528,3500,3500,3324,3400,3324,3400,3362,-100,-138,16,18
20150529,3400,3362,3402,3402,3376,3376,3388,14,26,4,18
20150601,3376,3388,3390,3430,3390,3430,3410,42,22,4,18
20150602,3430,3410,3420,3420,3420,3420,3420,10,10,2,16
20150603,3420,3420,,,,3452,3452,32,32,0,16
20150604,3452,3452,,,,3490,3490,38,38,0,16
20150605,3490,3490,3316,3444,3316,3328,3362,-162,-128,12,16
20150608,3328,3362,3496,3496,3328,3328,3384,-34,22,42,16
20150609,3328,3384,3408,3408,3350,3350,3366,-34,-18,14,10
20150610,3350,3366,3426,3426,3426,3426,3426,60,60,2,10
20150611,3426,3426,3466,3466,3362,3424,3410,-2,-16,18,10
20150612,3424,3410,,,,3370,3370,-40,-40,0,10
20150615,3370,3370,3228,3228,3228,3228,3228,-142,-142,6,6
20150616,3228,3228,,,,3228,3228,0,0,0,6
20150617,3228,3228,,,,3228,3228,0,0,0,6
20150618,3228,3228,,,,3228,3228,0,0,0,6
20150619,3228,3228,,,,3188,3188,-40,-40,0,6
20150623,3188,3188,,,,3138,3138,-50,-50,0,6
20150624,3138,3138,,,,3138,3138,0,0,0,6
20150625,3138,3138,,,,3138,3138,0,0,0,6
20150626,3138,3138,2980,3090,2980,3090,3040,-48,-98,16,8
20150629,3090,3040,,,,3130,3130,90,90,0,8
20150630,3130,3130,,,,3130,3130,0,0,0,8
20150701,3130,3130,,,,3130,3130,0,0,0,8
20150702,3130,3130,,,,3130,3130,0,0,0,8
20150703,3130,3130,,,,3130,3130,0,0,0,8
20150706,3130,3130,3012,3012,2972,2972,3004,-158,-126,12,4
20150707,2972,3004,2852,2852,2852,2852,2852,-152,-152,2,6
20150708,2852,2852,2718,2718,2718,2718,2718,-134,-134,2,4
20150709,2718,2718,2850,2850,2850,2850,2850,132,132,2,4
20150710,2850,2850,2714,2782,2708,2748,2736,-102,-114,18,4
20150713,2748,2736,,,,2680,2680,-56,-56,0,4
20150714,2680,2680,2808,2808,2688,2688,2732,8,52,6,4
20150715,2688,2732,,,,2732,2732,0,0,0,4
20150716,2732,2732,,,,2700,2700,-32,-32,0,4
20150717,2700,2700,,,,2700,2700,0,0,0,4
20150720,2700,2700,,,,2700,2700,0,0,0,4
20150721,2700,2700,,,,2650,2650,-50,-50,0,4
20150722,2650,2650,2780,2782,2778,2778,2780,128,130,8,2
20150723,2778,2780,2728,2730,2726,2730,2728,-50,-52,6,4
20150724,2730,2728,2796,2796,2704,2704,2744,-24,16,8,6
20150727,2704,2744,2620,2678,2608,2626,2632,-118,-112,8,8
20150728,2626,2632,2522,2582,2522,2582,2542,-50,-90,8,8
20150729,2582,2542,2666,2666,2534,2582,2592,40,50,36,8
20150730,2582,2592,,,,2520,2520,-72,-72,0,8
20150731,2520,2520,,,,2520,2520,0,0,0,8
20150803,2520,2520,2498,2516,2498,2516,2506,-4,-14,4,8
20150804,2516,2506,,,,2506,2506,0,0,0,8
20150805,2506,2506,2470,2472,2470,2472,2470,-34,-36,4,8
20150806,2472,2470,,,,2470,2470,0,0,0,8
20150807,2470,2470,,,,2470,2470,0,0,0,8
20150810,2470,2470,2590,2590,2578,2578,2584,108,114,4,6
20150811,2578,2584,2648,2656,2638,2656,2642,72,58,10,8
20150812,2656,2642,2548,2662,2548,2586,2622,-56,-20,48,46
20150813,2586,2622,2670,2680,2620,2638,2654,16,32,16,54
20150814,2638,2654,2630,2666,2630,2666,2648,12,-6,4,56
20150817,2666,2648,2582,2660,2536,2536,2594,-112,-54,8,58
20150818,2536,2594,2588,2588,2570,2570,2578,-24,-16,4,58
20150819,2570,2578,2560,2562,2488,2520,2538,-58,-40,12,58
20150820,2520,2538,2488,2488,2444,2446,2448,-92,-90,52,12
20150821,2446,2448,2428,2428,2390,2390,2408,-58,-40,4,14
20150824,2390,2408,2288,2288,2288,2288,2288,-120,-120,2,14
20150825,2288,2288,2242,2342,2242,2290,2296,2,8,26,14
20150826,2290,2296,2312,2312,2300,2302,2304,6,8,16,16
20150827,2302,2304,2290,2294,2290,2294,2292,-10,-12,4,14
20150828,2294,2292,2404,2406,2370,2370,2396,78,104,8,14
20150831,2370,2396,2396,2396,2392,2392,2394,-4,-2,4,14
20150901,2392,2394,,,,2422,2422,28,28,0,14
20150902,2422,2422,,,,2350,2350,-72,-72,0,14
20150907,2350,2350,,,,2350,2350,0,0,0,14
20150908,2350,2350,,,,2350,2350,0,0,0,14
20150909,2350,2350,,,,2366,2366,16,16,0,14
20150910,2366,2366,2444,2484,2410,2452,2474,86,108,34,42
20150911,2452,2474,2486,2486,2470,2480,2480,6,6,16,46
20150914,2480,2480,2472,2472,2472,2472,2472,-8,-8,2,44
20150915,2472,2472,2460,2498,2388,2388,2446,-84,-26,8,44
20150916,2388,2446,2448,2448,2442,2442,2444,-4,-2,4,40
20150917,2442,2444,,,,2446,2446,2,2,0,40
20150918,2446,2446,2446,2446,2436,2436,2440,-10,-6,8,40
20150921,2436,2440,2398,2438,2392,2438,2410,-2,-30,10,38
20150922,2438,2410,2444,2444,2374,2374,2412,-36,2,10,42
20150923,2374,2412,2386,2386,2362,2362,2374,-50,-38,4,42
20150924,2362,2374,2402,2404,2402,2404,2402,30,28,4,44
20150925,2404,2402,,,,2380,2380,-22,-22,0,44
20150928,2380,2380,2480,2480,2384,2384,2420,4,40,6,44
20150929,2384,2420,2488,2488,2330,2330,2412,-90,-8,14,48
20150930,2330,2412,2358,2406,2358,2370,2376,-42,-36,10,44
20151008,2370,2376,2400,2400,2400,2400,2400,24,24,2,46
20151009,2400,2400,2416,2450,2400,2450,2432,50,32,38,62
20151012,2450,2432,2418,2458,2418,2458,2432,26,0,6,60
20151013,2458,2432,2414,2414,2404,2404,2408,-28,-24,6,58
20151014,2404,2408,,,,2408,2408,0,0,0,58
20151015,2408,2408,,,,2408,2408,0,0,0,58
20151016,2408,2408,2398,2400,2398,2400,2398,-8,-10,4,58
20151019,2400,2398,2460,2460,2408,2408,2434,10,36,4,56
20151020,2408,2434,2428,2428,2364,2364,2398,-70,-36,12,58
20151021,2364,2398,2326,2396,2300,2300,2356,-98,-42,32,60
20151022,2300,2356,2264,2338,2264,2338,2288,-18,-68,6,60
20151023,2338,2288,2272,2278,2176,2176,2252,-112,-36,12,62
20151026,2176,2252,2168,2240,2168,2240,2204,-12,-48,4,62
20151027,2240,2204,2224,2224,2204,2204,2214,0,10,4,62
20151028,2204,2214,,,,2214,2214,0,0,0,62
20151029,2214,2214,,,,2214,2214,0,0,0,62
20151030,2214,2214,,,,2190,2190,-24,-24,0,62
20151102,2190,2190,,,,2190,2190,0,0,0,62
20151103,2190,2190,,,,2190,2190,0,0,0,62
20151104,2190,2190,2248,2250,2212,2248,2236,58,46,12,64
20151105,2248,2236,2234,2272,2204,2252,2222,16,-14,38,66
20151106,2252,2222,2224,2224,2224,2224,2224,2,2,2,64
20151109,2224,2224,,,,2224,2224,0,0,0,64
20151110,2224,2224,2226,2228,2212,2228,2222,4,-2,6,60
20151111,2228,2222,2230,2274,2230,2250,2250,28,28,14,62
20151112,2250,2250,2250,2266,2180,2180,2228,-70,-22,18,68
20151113,2180,2228,2208,2238,2208,2222,2220,-6,-8,32,68
20151116,2222,2220,2260,2268,2150,2150,2188,-70,-32,94,116
20151117,2150,2188,2152,2186,2080,2112,2140,-76,-48,62,148
20151118,2112,2140,2132,2142,2104,2104,2128,-36,-12,16,146
20151119,2104,2128,2112,2120,2072,2098,2094,-30,-34,102,152
20151120,2098,2094,2068,2074,2068,2074,2070,-20,-24,6,154
20151123,2074,2070,2106,2106,1950,1958,2014,-112,-56,54,164
20151124,1958,2014,1948,1990,1922,1940,1938,-74,-76,84,152
20151125,1940,1938,1986,2008,1872,1972,1976,34,38,104,174
20151126,1972,1976,1920,2030,1920,2030,1992,54,16,52,178
20151127,2030,1992,2012,2012,1938,1938,1974,-54,-18,22,182
20151130,1938,1974,1946,1958,1916,1916,1936,-58,-38,10,184
bu1604,20151016,2408,2408,,,,2408,2408,0,0,0,0
20151019,2408,2408,,,,2408,2408,0,0,0,0
20151020,2408,2408,,,,2408,2408,0,0,0,0
20151021,2408,2408,,,,2408,2408,0,0,0,0
20151022,2408,2408,,,,2374,2374,-34,-34,0,0
20151023,2374,2374,,,,2374,2374,0,0,0,0
20151026,2374,2374,,,,2374,2374,0,0,0,0
20151027,2374,2374,,,,2384,2384,10,10,0,0
20151028,2384,2384,,,,2374,2374,-10,-10,0,0
20151029,2374,2374,,,,2410,2410,36,36,0,0
20151030,2410,2410,,,,2358,2358,-52,-52,0,0
20151102,2358,2358,,,,2316,2316,-42,-42,0,0
20151103,2316,2316,,,,2310,2310,-6,-6,0,0
20151104,2310,2310,,,,2358,2358,48,48,0,0
20151105,2358,2358,,,,2344,2344,-14,-14,0,0
20151106,2344,2344,,,,2344,2344,0,0,0,0
20151109,2344,2344,2344,2344,2262,2262,2302,-82,-42,4,0
20151110,2262,2302,,,,2302,2302,0,0,0,0
20151111,2302,2302,,,,2330,2330,28,28,0,0
20151112,2330,2330,2280,2280,2244,2278,2268,-52,-62,8,0
20151113,2278,2268,2284,2300,2260,2280,2280,12,12,8,0
20151116,2280,2280,,,,2248,2248,-32,-32,0,0
20151117,2248,2248,2112,2232,2112,2232,2172,-16,-76,4,0
20151118,2232,2172,2196,2196,2106,2182,2160,10,-12,6,2
20151119,2182,2160,2088,2088,2088,2088,2088,-72,-72,2,0
20151120,2088,2088,,,,2064,2064,-24,-24,0,0
20151123,2064,2064,,,,2010,2010,-54,-54,0,0
20151124,2010,2010,1894,1980,1894,1980,1956,-30,-54,8,4
20151125,1980,1956,2012,2012,1868,1868,1932,-88,-24,8,2
20151126,1868,1932,2046,2046,1968,1968,2006,36,74,4,2
20151127,1968,2006,1968,1968,1968,1968,1968,-38,-38,2,0
20151130,1968,1968,,,,1968,1968,0,0,0,0
bu1605,20151117,2248,2248,2112,2244,2082,2122,2158,-126,-90,524,72
20151118,2122,2158,2088,2192,2088,2190,2156,32,-2,58,72
20151119,2190,2156,2180,2200,2088,2106,2164,-50,8,100,72
20151120,2106,2164,2070,2100,2058,2076,2088,-88,-76,114,30
20151123,2076,2088,2108,2144,1962,2008,2068,-80,-20,56,10
20151124,2008,2068,1964,2044,1944,2036,1996,-32,-72,128,12
20151125,2036,1996,2008,2080,1928,2016,1982,20,-14,426,22
20151126,2016,1982,2066,2082,1984,2040,2048,58,66,94,32
20151127,2040,2048,2082,2082,1978,2012,2020,-36,-28,292,156
20151130,2012,2020,2020,2042,1952,1992,2032,-28,12,1738,1022
bu1606,20150105,3400,3400,,,,3376,3376,-24,-24,0,0
20150106,3376,3376,,,,3422,3422,46,46,0,0
20150107,3422,3422,,,,3384,3384,-38,-38,0,0
20150108,3384,3384,,,,3342,3342,-42,-42,0,0
20150109,3342,3342,,,,3318,3318,-24,-24,0,0
20150112,3318,3318,,,,3158,3158,-160,-160,0,0
20150113,3158,3158,,,,3152,3152,-6,-6,0,0
20150114,3152,3152,,,,2994,2994,-158,-158,0,0
20150115,2994,2994,,,,3008,3008,14,14,0,0
20150116,3008,3008,,,,3020,3020,12,12,0,0
20150119,3020,3020,,,,2964,2964,-56,-56,0,0
20150120,2964,2964,,,,2928,2928,-36,-36,0,0
20150121,2928,2928,,,,2902,2902,-26,-26,0,0
20150122,2902,2902,,,,3046,3046,144,144,0,0
20150123,3046,3046,,,,3040,3040,-6,-6,0,0
20150126,3040,3040,,,,2888,2888,-152,-152,0,0
20150127,2888,2888,3028,3028,3024,3024,3026,136,138,8,8
20150128,3024,3026,,,,3036,3036,10,10,0,8
20150129,3036,3036,,,,3050,3050,14,14,0,8
20150130,3050,3050,3056,3056,3056,3056,3056,6,6,2,8
20150202,3056,3056,,,,3104,3104,48,48,0,8
20150203,3104,3104,,,,3208,3208,104,104,0,8
20150204,3208,3208,,,,3208,3208,0,0,0,8
20150205,3208,3208,3366,3366,3366,3366,3366,158,158,2,8
20150206,3366,3366,,,,3412,3412,46,46,0,8
20150209,3412,3412,,,,3420,3420,8,8,0,8
20150210,3420,3420,,,,3396,3396,-24,-24,0,8
20150211,3396,3396,,,,3410,3410,14,14,0,8
20150212,3410,3410,,,,3418,3418,8,8,0,8
20150213,3418,3418,,,,3350,3350,-68,-68,0,8
20150216,3350,3350,,,,3422,3422,72,72,0,8
20150217,3422,3422,,,,3422,3422,0,0,0,8
20150225,3422,3422,3422,3422,3422,3422,3422,0,0,2,8
20150226,3422,3422,3250,3386,3250,3386,3296,-36,-126,6,8
20150227,3386,3296,,,,3296,3296,0,0,0,8
20150302,3296,3296,,,,3460,3460,164,164,0,8
20150303,3460,3460,3626,3626,3344,3388,3492,-72,32,8,8
20150304,3388,3492,,,,3492,3492,0,0,0,8
20150305,3492,3492,,,,3492,3492,0,0,0,8
20150306,3492,3492,3612,3658,3540,3540,3600,48,108,56,38
20150309,3540,3600,,,,3586,3586,-14,-14,0,38
20150310,3586,3586,3522,3522,3490,3490,3500,-96,-86,6,36
20150311,3490,3500,3324,3384,3324,3384,3334,-116,-166,12,32
20150312,3384,3334,3402,3402,3402,3402,3402,68,68,2,30
20150313,3402,3402,3470,3494,3406,3460,3458,58,56,16,26
20150316,3460,3458,3444,3480,3430,3450,3456,-8,-2,22,34
20150317,3450,3456,3404,3486,3400,3472,3438,16,-18,54,32
20150318,3472,3438,,,,3438,3438,0,0,0,32
20150319,3438,3438,3410,3410,3410,3410,3410,-28,-28,2,32
20150320,3410,3410,3366,3520,3366,3468,3450,58,40,12,32
20150323,3468,3450,3548,3568,3546,3568,3554,118,104,12,34
20150324,3568,3554,3600,3640,3546,3600,3604,46,50,20,32
20150325,3600,3604,3588,3588,3588,3588,3588,-16,-16,2,32
20150326,3588,3588,3630,3630,3546,3598,3584,10,-4,24,30
20150327,3598,3584,3594,3608,3568,3570,3580,-14,-4,10,28
20150330,3570,3580,3562,3562,3542,3542,3548,-38,-32,6,26
20150331,3542,3548,,,,3548,3548,0,0,0,26
20150401,3548,3548,3456,3596,3456,3482,3528,-66,-20,8,26
20150402,3482,3528,3618,3648,3618,3648,3628,120,100,26,26
20150403,3648,3628,3670,3670,3566,3566,3636,-62,8,10,24
20150407,3566,3636,3650,3666,3602,3666,3636,30,0,10,26
20150408,3666,3636,3634,3696,3602,3602,3656,-34,20,32,26
20150409,3602,3656,3622,3630,3590,3630,3614,-26,-42,10,26
20150410,3630,3614,3688,3700,3502,3674,3640,60,26,184,32
20150413,3674,3640,3718,3736,3640,3656,3686,16,46,34,28
20150414,3656,3686,3668,3680,3658,3680,3668,-6,-18,6,30
20150415,3680,3668,3708,3708,3658,3668,3682,0,14,12,32
20150416,3668,3682,3668,3752,3668,3712,3708,30,26,36,42
20150417,3712,3708,3722,3722,3700,3704,3708,-4,0,6,44
20150420,3704,3708,3680,3728,3668,3668,3684,-40,-24,28,40
20150421,3668,3684,3582,3638,3582,3600,3616,-84,-68,10,40
20150422,3600,3616,3628,3650,3586,3650,3624,34,8,34,56
20150423,3650,3624,3648,3678,3600,3600,3630,-24,6,34,52
20150424,3600,3630,3630,3660,3578,3650,3620,20,-10,184,70
20150427,3650,3620,3612,3744,3440,3710,3638,90,18,156,80
20150428,3710,3638,3700,3766,3690,3698,3720,60,82,72,98
20150429,3698,3720,3734,3734,3702,3702,3718,-18,-2,8,94
20150430,3702,3718,3716,3718,3684,3708,3702,-10,-16,16,100
20150504,3708,3702,3718,3728,3718,3720,3722,18,20,6,102
20150505,3720,3722,3768,3768,3738,3738,3752,16,30,24,104
20150506,3738,3752,3756,3784,3732,3738,3746,-14,-6,24,108
20150507,3738,3746,3732,3736,3636,3686,3702,-60,-44,54,106
20150508,3686,3702,3652,3690,3652,3690,3668,-12,-34,6,106
20150511,3690,3668,3700,3706,3682,3682,3692,14,24,8,106
20150512,3682,3692,3652,3652,3650,3650,3650,-42,-42,16,104
20150513,3650,3650,3662,3692,3660,3660,3678,10,28,14,100
20150514,3660,3678,3620,3658,3620,3658,3638,-20,-40,4,102
20150515,3658,3638,3606,3610,3566,3610,3596,-28,-42,12,100
20150518,3610,3596,3546,3664,3538,3580,3570,-16,-26,56,102
20150519,3580,3570,3628,3628,3488,3488,3550,-82,-20,8,104
20150520,3488,3550,3486,3486,3408,3432,3452,-118,-98,36,104
20150521,3432,3452,3450,3500,3432,3496,3474,44,22,14,110
20150522,3496,3474,3538,3538,3458,3490,3486,16,12,18,104
20150525,3490,3486,3482,3520,3454,3520,3478,34,-8,8,108
20150526,3520,3478,3526,3556,3470,3520,3516,42,38,16,106
20150527,3520,3516,3538,3538,3422,3496,3494,-20,-22,14,106
20150528,3496,3494,3498,3526,3474,3498,3496,4,2,12,106
20150529,3498,3496,3528,3528,3528,3528,3528,32,32,2,108
20150601,3528,3528,3528,3550,3528,3550,3538,22,10,8,112
20150602,3550,3538,3538,3548,3502,3512,3526,-26,-12,10,110
20150603,3512,3526,3564,3564,3546,3546,3554,20,28,4,108
20150604,3546,3554,3502,3502,3502,3502,3502,-52,-52,4,110
20150605,3502,3502,3450,3478,3450,3478,3466,-24,-36,6,110
20150608,3478,3466,3478,3478,3426,3448,3440,-18,-26,10,110
20150609,3448,3440,3464,3498,3442,3476,3462,36,22,16,118
20150610,3476,3462,3518,3518,3518,3518,3518,56,56,2,120
20150611,3518,3518,3574,3574,3574,3574,3574,56,56,2,122
20150612,3574,3574,3436,3480,3430,3430,3444,-144,-130,16,120
20150615,3430,3444,3436,3436,3400,3400,3418,-44,-26,8,122
20150616,3400,3418,3420,3420,3352,3390,3380,-28,-38,18,128
20150617,3390,3380,3368,3368,3320,3360,3342,-20,-38,36,130
20150618,3360,3342,3336,3356,3300,3300,3320,-42,-22,36,122
20150619,3300,3320,3306,3308,3256,3256,3278,-64,-42,12,120
20150623,3256,3278,,,,3240,3240,-38,-38,0,120
20150624,3240,3240,3268,3268,3232,3266,3254,26,14,6,122
20150625,3266,3254,3246,3264,3246,3264,3258,10,4,8,122
20150626,3264,3258,3212,3230,3212,3230,3220,-28,-38,4,122
20150629,3230,3220,3276,3278,3104,3200,3192,-20,-28,24,116
20150630,3200,3192,3100,3150,3098,3150,3104,-42,-88,36,86
20150701,3150,3104,3164,3164,3068,3118,3114,14,10,28,96
20150702,3118,3114,3088,3130,3080,3086,3092,-28,-22,12,94
20150703,3086,3092,3116,3170,3116,3132,3138,40,46,14,102
20150706,3132,3138,3102,3102,3010,3088,3066,-50,-72,16,98
20150707,3088,3066,3000,3000,2932,2932,2954,-134,-112,6,100
20150708,2932,2954,2806,2806,2806,2806,2806,-148,-148,8,102
20150709,2806,2806,2756,2800,2588,2800,2716,-6,-90,28,104
20150710,2800,2716,2808,2820,2736,2774,2782,58,66,10,104
20150713,2774,2782,2834,2834,2726,2726,2772,-56,-10,6,104
20150714,2726,2772,2798,2828,2758,2774,2786,2,14,16,106
20150715,2774,2786,2828,2828,2754,2822,2800,36,14,10,106
20150716,2822,2800,,,,2800,2800,0,0,0,106
20150717,2800,2800,2808,2840,2798,2800,2810,0,10,10,106
20150720,2800,2810,2730,2854,2730,2854,2790,44,-20,30,108
20150721,2854,2790,2858,2858,2752,2816,2802,26,12,8,110
20150722,2816,2802,2886,2886,2870,2870,2878,68,76,4,110
20150723,2870,2878,2784,2846,2784,2822,2822,-56,-56,8,114
20150724,2822,2822,2872,2872,2772,2772,2816,-50,-6,10,120
20150727,2772,2816,2742,2742,2674,2674,2684,-142,-132,44,150
20150728,2674,2684,2582,2652,2580,2652,2606,-32,-78,44,150
20150729,2652,2606,2586,2682,2586,2640,2642,34,36,38,154
20150730,2640,2642,2660,2660,2660,2660,2660,18,18,2,154
20150731,2660,2660,2668,2668,2560,2560,2610,-100,-50,6,156
20150803,2560,2610,2648,2648,2504,2528,2554,-82,-56,68,142
20150804,2528,2554,2482,2548,2482,2548,2514,-6,-40,4,144
20150805,2548,2514,2596,2596,2472,2530,2508,16,-6,22,146
20150806,2530,2508,2488,2490,2488,2490,2488,-18,-20,4,148
20150807,2490,2488,2472,2496,2468,2496,2476,8,-12,26,138
20150810,2496,2476,2522,2598,2520,2598,2560,122,84,68,154
20150811,2598,2560,2620,2688,2572,2632,2646,72,86,114,110
20150812,2632,2646,2554,2602,2554,2602,2578,-44,-68,30,124
20150813,2602,2578,2652,2694,2604,2694,2646,116,68,36,134
20150814,2694,2646,2636,2740,2636,2650,2654,4,8,24,128
20150817,2650,2654,2652,2678,2570,2590,2608,-64,-46,42,148
20150818,2590,2608,2600,2622,2562,2606,2596,-2,-12,36,150
20150819,2606,2596,2560,2582,2544,2582,2562,-14,-34,8,154
20150820,2582,2562,2550,2550,2476,2490,2510,-72,-52,60,154
20150821,2490,2510,2474,2520,2404,2440,2466,-70,-44,104,216
20150824,2440,2466,2450,2450,2342,2342,2376,-124,-90,176,198
20150825,2342,2376,2342,2360,2278,2310,2330,-66,-46,134,170
20150826,2310,2330,2350,2356,2334,2342,2346,12,16,30,174
20150827,2342,2346,2330,2416,2330,2410,2372,64,26,60,178
20150828,2410,2372,2454,2486,2406,2444,2452,72,80,74,180
20150831,2444,2452,2382,2486,2382,2486,2444,34,-8,22,176
20150901,2486,2444,2438,2502,2430,2502,2470,58,26,40,186
20150902,2502,2470,2460,2494,2400,2422,2450,-48,-20,30,188
20150907,2422,2450,2398,2400,2398,2400,2398,-50,-52,8,184
20150908,2400,2398,2380,2410,2380,2410,2386,12,-12,8,178
20150909,2410,2386,2410,2498,2410,2472,2448,86,62,56,194
20150910,2472,2448,2456,2518,2436,2502,2484,54,36,34,200
20150911,2502,2484,2514,2530,2492,2510,2516,26,32,72,172
20150914,2510,2516,2494,2572,2484,2516,2526,0,10,70,168
20150915,2516,2526,2528,2542,2456,2456,2498,-70,-28,56,164
20150916,2456,2498,2434,2482,2434,2474,2464,-24,-34,34,164
20150917,2474,2464,2488,2496,2470,2470,2482,6,18,106,162
20150918,2470,2482,2456,2472,2418,2424,2438,-58,-44,40,166
20150921,2424,2438,2410,2446,2408,2446,2420,8,-18,32,160
20150922,2446,2420,2450,2452,2398,2422,2424,2,4,90,134
20150923,2422,2424,2394,2416,2392,2412,2402,-12,-22,46,138
20150924,2412,2402,2346,2430,2346,2428,2406,26,4,68,158
20150925,2428,2406,2428,2448,2422,2448,2432,42,26,18,168
20150928,2448,2432,2392,2424,2392,2404,2406,-28,-26,20,162
20150929,2404,2406,2412,2430,2372,2390,2390,-16,-16,40,154
20150930,2390,2390,2390,2396,2364,2376,2378,-14,-12,42,152
20151008,2376,2378,2432,2438,2398,2404,2420,26,42,34,170
20151009,2404,2420,2406,2476,2406,2476,2436,56,16,74,188
20151012,2476,2436,2448,2476,2436,2470,2450,34,14,36,200
20151013,2470,2450,2426,2440,2402,2428,2418,-22,-32,68,214
20151014,2428,2418,2418,2460,2418,2440,2446,22,28,78,228
20151015,2440,2446,2444,2460,2436,2436,2440,-10,-6,20,224
20151016,2436,2440,2428,2456,2428,2438,2438,-2,-2,46,216
20151019,2438,2438,2450,2500,2432,2446,2452,8,14,62,226
20151020,2446,2452,2440,2450,2384,2384,2404,-68,-48,56,210
20151021,2384,2404,2384,2398,2330,2330,2354,-74,-50,218,142
20151022,2330,2354,2330,2352,2320,2344,2336,-10,-18,42,152
20151023,2344,2336,2348,2358,2278,2300,2300,-36,-36,118,194
20151026,2300,2300,2300,2318,2276,2288,2292,-12,-8,68,214
20151027,2288,2292,2282,2318,2260,2280,2284,-12,-8,112,244
20151028,2280,2284,2284,2284,2268,2268,2272,-16,-12,14,246
20151029,2268,2272,2288,2320,2274,2284,2292,12,20,100,276
20151030,2284,2292,2298,2308,2258,2258,2274,-34,-18,104,240
20151102,2258,2274,2246,2270,2246,2270,2258,-4,-16,36,238
20151103,2270,2258,2270,2272,2248,2260,2258,2,0,86,292
20151104,2260,2258,2274,2310,2270,2300,2290,42,32,108,310
20151105,2300,2290,2302,2302,2280,2298,2292,8,2,34,316
20151106,2298,2292,2296,2328,2286,2322,2310,30,18,64,320
20151109,2322,2310,2322,2322,2296,2296,2306,-14,-4,124,330
20151110,2296,2306,2290,2366,2286,2304,2302,-2,-4,52,346
20151111,2304,2302,2312,2330,2298,2300,2318,-2,16,222,408
20151112,2300,2318,2298,2318,2278,2300,2296,-18,-22,640,808
20151113,2300,2296,2300,2320,2292,2294,2306,-2,10,488,1028
20151116,2294,2306,2298,2298,2170,2206,2248,-100,-58,1032,1332
20151117,2206,2248,2216,2216,2138,2164,2164,-84,-84,1406,2200
20151118,2164,2164,2150,2180,2130,2156,2158,-8,-6,640,2228
20151119,2156,2158,2170,2178,2094,2100,2124,-58,-34,702,2550
20151120,2100,2124,2082,2146,2078,2120,2104,-4,-20,566,2466
20151123,2120,2104,2104,2152,1996,2006,2042,-98,-62,2816,3962
20151124,2006,2042,2020,2060,1990,2052,2010,10,-32,3930,3900
20151125,2052,2010,2048,2110,1990,2074,2044,64,34,4558,4158
20151126,2074,2044,2056,2142,2022,2094,2090,50,46,3428,4572
20151127,2094,2090,2088,2096,2026,2030,2054,-60,-36,3792,5476
20151130,2030,2054,2032,2050,2000,2016,2018,-38,-36,3496,6140
bu1609,20150105,3494,3494,,,,3470,3470,-24,-24,0,0
20150106,3470,3470,,,,3470,3470,0,0,0,0
20150107,3470,3470,,,,3502,3502,32,32,0,0
20150108,3502,3502,,,,3502,3502,0,0,0,0
20150109,3502,3502,,,,3478,3478,-24,-24,0,0
20150112,3478,3478,,,,3310,3310,-168,-168,0,0
20150113,3310,3310,,,,3304,3304,-6,-6,0,0
20150114,3304,3304,,,,3138,3138,-166,-166,0,0
20150115,3138,3138,,,,3154,3154,16,16,0,0
20150116,3154,3154,,,,3166,3166,12,12,0,0
20150119,3166,3166,,,,3108,3108,-58,-58,0,0
20150120,3108,3108,,,,3070,3070,-38,-38,0,0
20150121,3070,3070,,,,3044,3044,-26,-26,0,0
20150122,3044,3044,,,,3062,3062,18,18,0,0
20150123,3062,3062,,,,3056,3056,-6,-6,0,0
20150126,3056,3056,3200,3200,3180,3180,3184,124,128,8,6
20150127,3180,3184,3342,3342,3190,3190,3244,6,60,6,10
20150128,3190,3244,3296,3296,3238,3296,3276,52,32,6,10
20150129,3296,3276,3416,3418,3258,3258,3336,-18,60,18,8
20150130,3258,3336,3222,3222,3222,3222,3222,-114,-114,2,8
20150202,3222,3222,3200,3380,3200,3380,3216,158,-6,22,28
20150203,3380,3216,,,,3324,3324,108,108,0,28
20150204,3324,3324,,,,3324,3324,0,0,0,28
20150205,3324,3324,3256,3256,3160,3180,3206,-144,-118,10,34
20150206,3180,3206,,,,3206,3206,0,0,0,34
20150209,3206,3206,,,,3206,3206,0,0,0,34
20150210,3206,3206,,,,3206,3206,0,0,0,34
20150211,3206,3206,,,,3206,3206,0,0,0,34
20150212,3206,3206,3200,3200,3050,3200,3150,-6,-56,6,36
20150213,3200,3150,3190,3242,3190,3242,3212,92,62,10,40
20150216,3242,3212,,,,3242,3242,30,30,0,40
20150217,3242,3242,,,,3242,3242,0,0,0,40
20150225,3242,3242,3242,3278,3242,3278,3260,36,18,4,40
20150226,3278,3260,3300,3348,3300,3348,3316,88,56,6,36
20150227,3348,3316,,,,3316,3316,0,0,0,36
20150302,3316,3316,,,,3360,3360,44,44,0,36
20150303,3360,3360,,,,3360,3360,0,0,0,36
20150304,3360,3360,,,,3370,3370,10,10,0,36
20150305,3370,3370,3370,3450,3360,3380,3384,10,14,10,34
20150306,3380,3384,3552,3552,3426,3426,3482,42,98,8,38
20150309,3426,3482,3500,3538,3420,3538,3486,56,4,6,40
20150310,3538,3486,3480,3480,3480,3480,3480,-6,-6,2,42
20150311,3480,3480,3412,3412,3412,3412,3412,-68,-68,2,40
20150312,3412,3412,,,,3412,3412,0,0,0,40
20150313,3412,3412,3476,3476,3476,3476,3476,64,64,2,42
20150316,3476,3476,3420,3480,3420,3480,3450,4,-26,4,42
20150317,3480,3450,,,,3450,3450,0,0,0,42
20150318,3450,3450,3450,3450,3450,3450,3450,0,0,2,44
20150319,3450,3450,3488,3500,3488,3500,3494,50,44,4,40
20150320,3500,3494,,,,3494,3494,0,0,0,40
20150323,3494,3494,3508,3570,3508,3570,3528,76,34,6,42
20150324,3570,3528,3528,3528,3528,3528,3528,0,0,4,42
20150325,3528,3528,3650,3650,3518,3526,3552,-2,24,12,46
20150326,3526,3552,3578,3636,3578,3636,3616,84,64,6,42
20150327,3636,3616,,,,3598,3598,-18,-18,0,42
20150330,3598,3598,,,,3598,3598,0,0,0,42
20150331,3598,3598,,,,3596,3596,-2,-2,0,42
20150401,3596,3596,,,,3596,3596,0,0,0,42
20150402,3596,3596,3650,3650,3650,3650,3650,54,54,2,42
20150403,3650,3650,,,,3650,3650,0,0,0,42
20150407,3650,3650,,,,3650,3650,0,0,0,42
20150408,3650,3650,,,,3650,3650,0,0,0,42
20150409,3650,3650,,,,3628,3628,-22,-22,0,42
20150410,3628,3628,3680,3680,3666,3666,3670,38,42,6,42
20150413,3666,3670,3678,3678,3652,3654,3660,-16,-10,10,42
20150414,3654,3660,3680,3698,3668,3692,3686,32,26,18,36
20150415,3692,3686,3686,3700,3650,3700,3678,14,-8,6,36
20150416,3700,3678,3652,3700,3652,3700,3682,22,4,8,36
20150417,3700,3682,3684,3684,3680,3680,3682,-2,0,4,40
20150420,3680,3682,3768,3768,3622,3638,3676,-44,-6,58,42
20150421,3638,3676,3600,3600,3570,3570,3584,-106,-92,4,44
20150422,3570,3584,3620,3648,3588,3588,3612,4,28,8,46
20150423,3588,3612,3650,3650,3598,3598,3624,-14,12,36,52
20150424,3598,3624,3566,3650,3566,3634,3626,10,2,30,52
20150427,3634,3626,3654,3688,3568,3688,3638,62,12,100,68
20150428,3688,3638,3708,3760,3708,3748,3744,110,106,40,92
20150429,3748,3744,3810,3810,3720,3726,3756,-18,12,50,104
20150430,3726,3756,3732,3752,3704,3704,3724,-52,-32,10,106
20150504,3704,3724,3776,3776,3728,3730,3744,6,20,8,104
20150505,3730,3744,3768,3790,3762,3790,3774,46,30,12,102
20150506,3790,3774,3762,3796,3754,3754,3782,-20,8,40,90
20150507,3754,3782,3760,3762,3734,3744,3746,-38,-36,14,90
20150508,3744,3746,3740,3740,3700,3700,3720,-46,-26,22,90
20150511,3700,3720,3748,3748,3706,3712,3722,-8,2,44,88
20150512,3712,3722,3704,3710,3670,3700,3696,-22,-26,28,82
20150513,3700,3696,3692,3704,3686,3686,3692,-10,-4,14,80
20150514,3686,3692,3688,3688,3638,3642,3668,-50,-24,14,72
20150515,3642,3668,3748,3748,3576,3600,3632,-68,-36,22,74
20150518,3600,3632,3594,3596,3544,3588,3576,-44,-56,46,78
20150519,3588,3576,3562,3570,3480,3480,3534,-96,-42,44,78
20150520,3480,3534,3458,3458,3408,3452,3444,-82,-90,22,74
20150521,3452,3444,3468,3504,3440,3504,3484,60,40,12,68
20150522,3504,3484,3510,3548,3510,3548,3528,64,44,4,68
20150525,3548,3528,3454,3454,3454,3454,3454,-74,-74,2,68
20150526,3454,3454,,,,3456,3456,2,2,0,68
20150527,3456,3456,,,,3456,3456,0,0,0,68
20150528,3456,3456,3460,3536,3460,3536,3510,80,54,12,70
20150529,3536,3510,3424,3518,3424,3472,3486,-38,-24,10,70
20150601,3472,3486,3546,3548,3512,3512,3534,26,48,6,68
20150602,3512,3534,3482,3568,3482,3524,3528,-10,-6,12,68
20150603,3524,3528,3578,3578,3504,3504,3540,-24,12,4,68
20150604,3504,3540,3472,3554,3462,3494,3504,-46,-36,38,70
20150605,3494,3504,3456,3456,3432,3432,3444,-72,-60,4,72
20150608,3432,3444,3422,3422,3420,3420,3420,-24,-24,8,74
20150609,3420,3420,3490,3494,3450,3450,3474,30,54,10,72
20150610,3450,3474,,,,3474,3474,0,0,0,72
20150611,3474,3474,3482,3486,3482,3486,3484,12,10,6,72
20150612,3486,3484,3432,3432,3366,3392,3398,-92,-86,22,76
20150615,3392,3398,3392,3446,3360,3368,3392,-30,-6,26,78
20150616,3368,3392,3386,3404,3346,3346,3376,-46,-16,20,86
20150617,3346,3376,3324,3344,3300,3300,3318,-76,-58,24,92
20150618,3300,3318,3318,3318,3302,3310,3310,-8,-8,10,90
20150619,3310,3310,3282,3296,3230,3230,3264,-80,-46,28,104
20150623,3230,3264,3224,3224,3224,3224,3224,-40,-40,2,104
20150624,3224,3224,3182,3258,3182,3248,3236,24,12,20,96
20150625,3248,3236,,,,3240,3240,4,4,0,96
20150626,3240,3240,3210,3210,3208,3208,3208,-32,-32,18,84
20150629,3208,3208,3188,3258,3150,3240,3196,32,-12,26,86
20150630,3240,3196,3164,3208,3080,3150,3128,-46,-68,26,94
20150701,3150,3128,3070,3136,3070,3088,3098,-40,-30,6,96
20150702,3088,3098,3098,3100,3098,3100,3098,2,0,6,98
20150703,3100,3098,3140,3176,3124,3130,3150,32,52,40,86
20150706,3130,3150,3130,3136,3022,3036,3100,-114,-50,30,96
20150707,3036,3100,3016,3114,2944,2944,2978,-156,-122,42,106
20150708,2944,2978,2850,2850,2828,2828,2830,-150,-148,24,106
20150709,2828,2830,2660,2890,2660,2820,2760,-10,-70,32,102
20150710,2820,2760,2760,2864,2760,2828,2812,68,52,42,98
20150713,2828,2812,2844,2846,2764,2764,2804,-48,-8,34,104
20150714,2764,2804,2762,2804,2762,2776,2782,-28,-22,16,98
20150715,2776,2782,2724,2858,2724,2798,2804,16,22,18,96
20150716,2798,2804,2768,2828,2768,2768,2788,-36,-16,6,98
20150717,2768,2788,,,,2788,2788,0,0,0,98
20150720,2788,2788,2794,2824,2772,2824,2808,36,20,12,94
20150721,2824,2808,2800,2810,2800,2810,2804,2,-4,4,94
20150722,2810,2804,2880,2880,2874,2874,2876,70,72,4,92
20150723,2874,2876,2862,2862,2826,2840,2842,-36,-34,10,92
20150724,2840,2842,2796,2836,2782,2830,2810,-12,-32,22,94
20150727,2830,2810,2790,2790,2668,2668,2690,-142,-120,90,128
20150728,2668,2690,2628,2646,2614,2642,2628,-48,-62,48,118
20150729,2642,2628,2676,2698,2650,2650,2672,22,44,18,124
20150730,2650,2672,2650,2652,2650,2652,2650,-20,-22,4,126
20150731,2652,2650,2654,2654,2630,2630,2636,-20,-14,10,124
20150803,2630,2636,2584,2604,2534,2544,2588,-92,-48,52,162
20150804,2544,2588,2552,2570,2552,2570,2562,-18,-26,6,164
20150805,2570,2562,2546,2560,2500,2550,2544,-12,-18,18,172
20150806,2550,2544,2492,2554,2492,2554,2510,10,-34,8,170
20150807,2554,2510,2498,2530,2498,2530,2506,20,-4,8,170
20150810,2530,2506,2510,2630,2510,2630,2584,124,78,54,166
20150811,2630,2584,2648,2712,2630,2712,2686,128,102,72,120
20150812,2712,2686,2650,2666,2554,2610,2600,-76,-86,42,136
20150813,2610,2600,2660,2684,2630,2684,2646,84,46,30,116
20150814,2684,2646,2680,2724,2656,2658,2674,12,28,22,132
20150817,2658,2674,2640,2640,2586,2586,2620,-88,-54,16,144
20150818,2586,2620,2612,2612,2604,2604,2608,-16,-12,12,154
20150819,2604,2608,2564,2594,2544,2592,2568,-16,-40,44,160
20150820,2592,2568,2540,2540,2508,2520,2520,-48,-48,50,196
20150821,2520,2520,2500,2500,2454,2460,2484,-60,-36,60,202
20150824,2460,2484,2444,2528,2370,2382,2414,-102,-70,114,220
20150825,2382,2414,2398,2398,2324,2350,2360,-64,-54,84,216
20150826,2350,2360,2438,2438,2354,2354,2374,-6,14,62,226
20150827,2354,2374,2356,2450,2356,2450,2406,76,32,46,234
20150828,2450,2406,2414,2500,2414,2480,2476,74,70,70,242
20150831,2480,2476,2462,2500,2382,2498,2460,22,-16,72,268
20150901,2498,2460,2470,2538,2468,2508,2516,48,56,156,196
20150902,2508,2516,2498,2498,2430,2430,2464,-86,-52,106,188
20150907,2430,2464,2438,2458,2418,2418,2430,-46,-34,44,214
20150908,2418,2430,2426,2426,2400,2400,2414,-30,-16,12,212
20150909,2400,2414,2436,2500,2434,2472,2478,58,64,38,204
20150910,2472,2478,2488,2522,2486,2512,2504,34,26,48,224
20150911,2512,2504,2508,2544,2506,2542,2522,38,18,62,222
20150914,2542,2522,2502,2590,2502,2536,2546,14,24,64,238
20150915,2536,2546,2540,2560,2476,2478,2520,-68,-26,60,244
20150916,2478,2520,2464,2520,2458,2510,2490,-10,-30,40,246
20150917,2510,2490,2520,2520,2490,2490,2508,0,18,18,238
20150918,2490,2508,2480,2500,2452,2466,2478,-42,-30,32,244
20150921,2466,2478,2450,2460,2428,2460,2446,-18,-32,38,242
20150922,2460,2446,2472,2476,2440,2452,2456,6,10,28,228
20150923,2452,2456,2430,2462,2428,2450,2442,-6,-14,42,232
20150924,2450,2442,2458,2462,2436,2452,2446,10,4,42,206
20150925,2452,2446,2450,2478,2440,2440,2452,-6,6,46,186
20150928,2440,2452,2430,2438,2418,2438,2428,-14,-24,16,180
20150929,2438,2428,2444,2444,2398,2410,2418,-18,-10,18,180
20150930,2410,2418,2414,2414,2400,2400,2404,-18,-14,18,184
20151008,2400,2404,2402,2450,2402,2426,2422,22,18,36,198
20151009,2426,2422,2448,2482,2448,2472,2466,50,44,96,200
20151012,2472,2466,2470,2484,2452,2480,2464,14,-2,24,204
20151013,2480,2464,2456,2456,2432,2452,2438,-12,-26,32,210
20151014,2452,2438,2432,2480,2432,2446,2452,8,14,26,218
20151015,2446,2452,2430,2478,2430,2450,2454,-2,2,24,222
20151016,2450,2454,2422,2478,2422,2450,2448,-4,-6,28,226
20151019,2450,2448,2468,2500,2450,2450,2468,2,20,54,234
20151020,2450,2468,2442,2444,2392,2404,2418,-64,-50,114,224
20151021,2404,2418,2398,2428,2356,2356,2388,-62,-30,136,254
20151022,2356,2388,2352,2400,2344,2370,2362,-18,-26,146,282
20151023,2370,2362,2358,2376,2300,2340,2338,-22,-24,148,342
20151026,2340,2338,2308,2346,2308,2324,2332,-14,-6,16,342
20151027,2324,2332,2324,2340,2298,2340,2316,8,-16,92,354
20151028,2340,2316,2302,2328,2302,2308,2310,-8,-6,28,336
20151029,2308,2310,2332,2346,2318,2318,2332,8,22,16,338
20151030,2318,2332,2312,2338,2290,2300,2306,-32,-26,60,364
20151102,2300,2306,2300,2300,2286,2286,2294,-20,-12,42,370
20151103,2286,2294,2298,2310,2290,2306,2302,12,8,88,370
20151104,2306,2302,2310,2336,2310,2326,2320,24,18,42,376
20151105,2326,2320,2338,2348,2300,2320,2318,0,-2,56,368
20151106,2320,2318,2316,2340,2316,2340,2332,22,14,38,366
20151109,2340,2332,2340,2340,2312,2312,2316,-20,-16,26,366
20151110,2312,2316,2310,2318,2310,2318,2312,2,-4,6,360
20151111,2318,2312,,,,2312,2312,0,0,0,360
20151112,2312,2312,2310,2312,2296,2310,2302,-2,-10,38,364
20151113,2310,2302,2298,2330,2296,2310,2308,8,6,88,364
20151116,2310,2308,2300,2300,2236,2236,2276,-72,-32,238,428
20151117,2236,2276,2240,2254,2210,2212,2232,-64,-44,156,478
20151118,2212,2232,2216,2226,2212,2226,2214,-6,-18,140,482
20151119,2226,2214,2216,2216,2166,2166,2190,-48,-24,58,470
20151120,2166,2190,2154,2188,2106,2138,2134,-52,-56,324,558
20151123,2138,2134,2140,2170,2012,2016,2084,-118,-50,340,532
20151124,2016,2084,2012,2080,2000,2072,2030,-12,-54,204,526
20151125,2072,2030,2084,2128,2028,2078,2076,48,46,210,528
20151126,2078,2076,2070,2174,2032,2110,2112,34,36,234,556
20151127,2110,2112,2092,2100,2048,2050,2068,-62,-44,78,542
20151130,2050,2068,2050,2062,2012,2040,2040,-28,-28,86,566
bu1612,20150105,3538,3538,,,,3514,3514,-24,-24,0,0
20150106,3514,3514,,,,3562,3562,48,48,0,0
20150107,3562,3562,,,,3522,3522,-40,-40,0,0
20150108,3522,3522,,,,3478,3478,-44,-44,0,0
20150109,3478,3478,,,,3454,3454,-24,-24,0,0
20150112,3454,3454,,,,3286,3286,-168,-168,0,0
20150113,3286,3286,,,,3280,3280,-6,-6,0,0
20150114,3280,3280,,,,3116,3116,-164,-164,0,0
20150115,3116,3116,,,,3132,3132,16,16,0,0
20150116,3132,3132,,,,3144,3144,12,12,0,0
20150119,3144,3144,,,,3086,3086,-58,-58,0,0
20150120,3086,3086,3240,3240,2932,3240,3162,154,76,8,2
20150121,3240,3162,,,,3134,3134,-28,-28,0,2
20150122,3134,3134,3290,3290,3162,3162,3230,28,96,6,4
20150123,3162,3230,3102,3238,3102,3238,3170,8,-60,4,4
20150126,3238,3170,3320,3320,3030,3030,3174,-140,4,4,2
20150127,3030,3174,,,,3174,3174,0,0,0,2
20150128,3174,3174,,,,3204,3204,30,30,0,2
20150129,3204,3204,,,,3204,3204,0,0,0,2
20150130,3204,3204,,,,3204,3204,0,0,0,2
20150202,3204,3204,,,,3204,3204,0,0,0,2
20150203,3204,3204,,,,3310,3310,106,106,0,2
20150204,3310,3310,3208,3208,3208,3208,3208,-102,-102,2,2
20150205,3208,3208,,,,3216,3216,8,8,0,2
20150206,3216,3216,,,,3218,3218,2,2,0,2
20150209,3218,3218,,,,3218,3218,0,0,0,2
20150210,3218,3218,,,,3218,3218,0,0,0,2
20150211,3218,3218,,,,3218,3218,0,0,0,2
20150212,3218,3218,,,,3218,3218,0,0,0,2
20150213,3218,3218,,,,3220,3220,2,2,0,2
20150216,3220,3220,3222,3222,3222,3222,3222,2,2,2,4
20150217,3222,3222,3440,3440,3202,3202,3320,-20,98,4,4
20150225,3202,3320,,,,3320,3320,0,0,0,4
20150226,3320,3320,,,,3320,3320,0,0,0,4
20150227,3320,3320,,,,3320,3320,0,0,0,4
20150302,3320,3320,,,,3320,3320,0,0,0,4
20150303,3320,3320,,,,3320,3320,0,0,0,4
20150304,3320,3320,,,,3320,3320,0,0,0,4
20150305,3320,3320,,,,3320,3320,0,0,0,4
20150306,3320,3320,3448,3486,3408,3484,3454,164,134,12,6
20150309,3484,3454,3306,3442,3306,3442,3374,-12,-80,4,4
20150310,3442,3374,3396,3396,3396,3396,3396,22,22,2,4
20150311,3396,3396,3240,3356,3240,3356,3298,-40,-98,4,4
20150312,3356,3298,,,,3306,3306,8,8,0,4
20150313,3306,3306,,,,3388,3388,82,82,0,4
20150316,3388,3388,,,,3388,3388,0,0,0,4
20150317,3388,3388,,,,3388,3388,0,0,0,4
20150318,3388,3388,,,,3388,3388,0,0,0,4
20150319,3388,3388,3400,3400,3400,3400,3400,12,12,4,4
20150320,3400,3400,,,,3400,3400,0,0,0,4
20150323,3400,3400,3494,3494,3492,3492,3492,92,92,4,4
20150324,3492,3492,3568,3568,3362,3502,3448,10,-44,8,6
20150325,3502,3448,,,,3480,3480,32,32,0,6
20150326,3480,3480,3580,3580,3580,3580,3580,100,100,2,8
20150327,3580,3580,3516,3516,3516,3516,3516,-64,-64,2,8
20150330,3516,3516,3484,3484,3484,3484,3484,-32,-32,2,8
20150331,3484,3484,,,,3554,3554,70,70,0,8
20150401,3554,3554,3452,3572,3452,3480,3512,-74,-42,14,8
20150402,3480,3512,3598,3598,3516,3572,3562,60,50,6,8
20150403,3572,3562,,,,3620,3620,58,58,0,8
20150407,3620,3620,3680,3680,3680,3680,3680,60,60,2,10
20150408,3680,3680,3570,3690,3570,3672,3646,-8,-34,10,10
20150409,3672,3646,3628,3642,3552,3642,3596,-4,-50,12,6
20150410,3642,3596,3610,3670,3610,3666,3652,70,56,8,6
20150413,3666,3652,3654,3654,3654,3654,3654,2,2,2,8
20150414,3654,3654,3648,3650,3612,3612,3638,-42,-16,8,6
20150415,3612,3638,3608,3652,3608,3652,3634,14,-4,6,6
20150416,3652,3634,3648,3686,3648,3686,3668,52,34,8,6
20150417,3686,3668,3628,3666,3628,3666,3646,-2,-22,4,6
20150420,3666,3646,3634,3634,3592,3592,3612,-54,-34,4,8
20150421,3592,3612,3532,3612,3532,3590,3574,-22,-38,12,10
20150422,3590,3574,3650,3650,3600,3600,3624,26,50,4,12
20150423,3600,3624,3602,3602,3562,3562,3590,-62,-34,8,8
20150424,3562,3590,3522,3650,3522,3604,3608,14,18,22,10
20150427,3604,3608,3658,3698,3608,3660,3676,52,68,20,14
20150428,3660,3676,3660,3780,3660,3738,3748,62,72,48,52
20150429,3738,3748,3652,3792,3652,3732,3754,-16,6,20,56
20150430,3732,3754,3702,3704,3702,3704,3702,-50,-52,4,58
20150504,3704,3702,,,,3726,3726,24,24,0,58
20150505,3726,3726,3798,3830,3740,3830,3800,104,74,12,64
20150506,3830,3800,3802,3802,3802,3802,3802,2,2,2,64
20150507,3802,3802,3804,3804,3720,3772,3772,-30,-30,14,62
20150508,3772,3772,3712,3712,3702,3702,3706,-70,-66,4,62
20150511,3702,3706,3712,3712,3662,3680,3676,-26,-30,56,18
20150512,3680,3676,3662,3662,3642,3642,3652,-34,-24,4,18
20150513,3642,3652,,,,3666,3666,14,14,0,18
20150514,3666,3666,3602,3602,3602,3602,3602,-64,-64,2,18
20150515,3602,3602,3602,3602,3602,3602,3602,0,0,2,16
20150518,3602,3602,3532,3638,3532,3638,3608,36,6,8,22
20150519,3638,3608,,,,3598,3598,-10,-10,0,22
20150520,3598,3598,3528,3528,3436,3482,3480,-116,-118,18,28
20150521,3482,3480,3500,3532,3500,3510,3514,30,34,10,24
20150522,3510,3514,3530,3560,3468,3560,3494,46,-20,22,28
20150525,3560,3494,3402,3618,3402,3618,3510,124,16,4,30
20150526,3618,3510,3588,3618,3588,3618,3602,108,92,4,34
20150527,3618,3602,3580,3626,3578,3578,3602,-24,0,16,38
20150528,3578,3602,3568,3604,3568,3604,3580,2,-22,6,40
20150529,3604,3580,3588,3618,3568,3618,3594,38,14,18,44
20150601,3618,3594,3616,3616,3576,3576,3600,-18,6,6,40
20150602,3576,3600,3612,3648,3590,3594,3616,-6,16,22,44
20150603,3594,3616,3618,3644,3600,3610,3614,-6,-2,12,48
20150604,3610,3614,3616,3616,3540,3540,3584,-74,-30,8,48
20150605,3540,3584,3544,3544,3520,3520,3528,-64,-56,6,50
20150608,3520,3528,3520,3548,3450,3548,3490,20,-38,24,48
20150609,3548,3490,3506,3558,3496,3512,3512,22,22,14,50
20150610,3512,3512,3530,3558,3516,3532,3536,20,24,12,56
20150611,3532,3536,3612,3612,3532,3532,3558,-4,22,10,56
20150612,3532,3558,3502,3502,3502,3502,3502,-56,-56,2,58
20150615,3502,3502,3488,3488,3388,3430,3432,-72,-70,16,52
20150616,3430,3432,3408,3430,3392,3402,3408,-30,-24,12,52
20150617,3402,3408,3410,3410,3354,3368,3374,-40,-34,12,54
20150618,3368,3374,3330,3340,3328,3340,3332,-34,-42,6,56
20150619,3340,3332,3232,3256,3220,3256,3232,-76,-100,8,58
20150623,3256,3232,,,,3280,3280,48,48,0,58
20150624,3280,3280,3270,3326,3270,3326,3284,46,4,8,60
20150625,3326,3284,,,,3320,3320,36,36,0,60
20150626,3320,3320,,,,3320,3320,0,0,0,60
20150629,3320,3320,,,,3320,3320,0,0,0,60
20150630,3320,3320,,,,3218,3218,-102,-102,0,60
20150701,3218,3218,3102,3196,3102,3196,3160,-22,-58,8,66
20150702,3196,3160,3112,3230,3112,3130,3156,-30,-4,6,66
20150703,3130,3156,3230,3230,3230,3230,3230,74,74,2,68
20150706,3230,3230,3140,3140,3140,3140,3140,-90,-90,2,68
20150707,3140,3140,3010,3100,2982,2982,3012,-158,-128,10,64
20150708,2982,3012,2860,2860,2860,2860,2860,-152,-152,2,64
20150709,2860,2860,2718,2900,2718,2900,2808,40,-52,6,68
20150710,2900,2808,2926,2926,2780,2908,2866,100,58,56,70
20150713,2908,2866,2804,2804,2800,2800,2802,-66,-64,4,68
20150714,2800,2802,2792,2862,2784,2808,2806,6,4,12,68
20150715,2808,2806,2864,2864,2770,2862,2824,56,18,26,68
20150716,2862,2824,,,,2850,2850,26,26,0,68
20150717,2850,2850,,,,2900,2900,50,50,0,68
20150720,2900,2900,,,,2884,2884,-16,-16,0,68
20150721,2884,2884,2908,2908,2908,2908,2908,24,24,2,68
20150722,2908,2908,2950,2950,2950,2950,2950,42,42,2,70
20150723,2950,2950,2850,2910,2850,2910,2882,-40,-68,6,72
20150724,2910,2882,2840,2908,2810,2810,2848,-72,-34,16,80
20150727,2810,2848,2750,2830,2704,2704,2728,-144,-120,14,82
20150728,2704,2728,,,,2718,2718,-10,-10,0,82
20150729,2718,2718,2666,2734,2666,2734,2700,16,-18,8,84
20150730,2734,2700,,,,2700,2700,0,0,0,84
20150731,2700,2700,2666,2666,2566,2566,2616,-134,-84,4,86
20150803,2566,2616,2650,2650,2484,2484,2588,-132,-28,12,88
20150804,2484,2588,2494,2586,2494,2586,2540,-2,-48,4,92
20150805,2586,2540,2588,2588,2488,2548,2538,8,-2,14,94
20150806,2548,2538,2452,2532,2452,2532,2500,-6,-38,14,100
20150807,2532,2500,2456,2524,2456,2524,2498,24,-2,12,102
20150810,2524,2498,2586,2622,2570,2622,2600,124,102,34,94
20150811,2622,2600,2632,2730,2632,2672,2696,72,96,82,34
20150812,2672,2696,,,,2676,2676,-20,-20,0,34
20150813,2676,2676,2708,2730,2634,2704,2684,28,8,30,52
20150814,2704,2684,2748,2748,2610,2682,2688,-2,4,10,52
20150817,2682,2688,2666,2690,2592,2600,2626,-88,-62,12,58
20150818,2600,2626,2610,2634,2584,2634,2602,8,-24,34,76
20150819,2634,2602,2598,2598,2598,2598,2598,-4,-4,2,78
20150820,2598,2598,2586,2586,2492,2584,2554,-14,-44,24,74
20150821,2584,2554,2500,2500,2440,2480,2466,-74,-88,12,86
20150824,2480,2466,2430,2528,2430,2450,2470,-16,4,30,90
20150825,2450,2470,2348,2448,2348,2388,2398,-82,-72,26,94
20150826,2388,2398,2378,2446,2370,2408,2402,10,4,62,108
20150827,2408,2402,2428,2508,2416,2490,2446,88,44,42,114
20150828,2490,2446,2470,2550,2470,2476,2532,30,86,110,88
20150831,2476,2532,2542,2544,2414,2480,2484,-52,-48,34,90
20150901,2480,2484,2450,2558,2450,2544,2518,60,34,32,70
20150902,2544,2518,2518,2518,2466,2466,2488,-52,-30,14,82
20150907,2466,2488,,,,2430,2430,-58,-58,0,82
20150908,2430,2430,,,,2430,2430,0,0,0,82
20150909,2430,2430,2430,2526,2430,2518,2496,88,66,48,82
20150910,2518,2496,2474,2500,2474,2500,2486,4,-10,4,86
20150911,2500,2486,2518,2570,2518,2536,2540,50,54,30,70
20150914,2536,2540,2504,2552,2502,2544,2526,4,-14,36,64
20150915,2544,2526,2536,2554,2450,2518,2512,-8,-14,84,72
20150916,2518,2512,2476,2528,2476,2524,2508,12,-4,152,104
20150917,2524,2508,2500,2540,2498,2502,2512,-6,4,90,90
20150918,2502,2512,2502,2536,2456,2456,2488,-56,-24,68,102
20150921,2456,2488,2420,2488,2420,2452,2460,-36,-28,58,92
20150922,2452,2460,2452,2494,2440,2466,2458,6,-2,42,90
20150923,2466,2458,2406,2466,2406,2442,2428,-16,-30,50,88
20150924,2442,2428,2494,2494,2442,2442,2476,14,48,94,88
20150925,2442,2476,2460,2512,2456,2456,2498,-20,22,92,88
20150928,2456,2498,2448,2466,2448,2452,2452,-46,-46,10,92
20150929,2452,2452,2448,2488,2410,2416,2450,-36,-2,140,82
20150930,2416,2450,2440,2440,2404,2418,2414,-32,-36,30,70
20151008,2418,2414,,,,2432,2432,18,18,0,70
20151009,2432,2432,2448,2534,2448,2498,2504,66,72,28,68
20151012,2498,2504,2500,2510,2458,2490,2496,-14,-8,48,76
20151013,2490,2496,2480,2480,2444,2458,2462,-38,-34,12,76
20151014,2458,2462,,,,2462,2462,0,0,0,76
20151015,2462,2462,,,,2462,2462,0,0,0,76
20151016,2462,2462,2458,2458,2458,2458,2458,-4,-4,2,76
20151019,2458,2458,2550,2550,2466,2468,2476,10,18,32,58
20151020,2468,2476,2444,2458,2338,2408,2394,-68,-82,28,64
20151021,2408,2394,2380,2408,2380,2384,2392,-10,-2,80,68
20151022,2384,2392,2382,2440,2298,2398,2352,6,-40,186,90
20151023,2398,2352,2356,2418,2266,2310,2310,-42,-42,428,86
20151026,2310,2310,2338,2356,2338,2348,2346,38,36,10,88
20151027,2348,2346,2350,2350,2350,2350,2350,4,4,2,86
20151028,2350,2350,,,,2350,2350,0,0,0,86
20151029,2350,2350,2350,2364,2350,2358,2356,8,6,6,84
20151030,2358,2356,2348,2348,2348,2348,2348,-8,-8,16,72
20151102,2348,2348,2328,2334,2328,2334,2330,-14,-18,16,72
20151103,2334,2330,2396,2396,2314,2316,2344,-14,14,70,74
20151104,2316,2344,2330,2366,2324,2336,2342,-8,-2,44,68
20151105,2336,2342,2340,2340,2316,2316,2334,-26,-8,10,68
20151106,2316,2334,2352,2368,2338,2368,2352,34,18,98,56
20151109,2368,2352,2288,2288,2288,2288,2288,-64,-64,14,42
20151110,2288,2288,2300,2348,2300,2340,2312,52,24,92,90
20151111,2340,2312,2196,2380,2196,2340,2342,28,30,76,84
20151112,2340,2342,2330,2350,2330,2350,2340,8,-2,4,84
20151113,2350,2340,2348,2366,2304,2320,2314,-20,-26,70,120
20151116,2320,2314,2292,2398,2270,2290,2326,-24,12,76,86
20151117,2290,2326,2290,2308,2286,2286,2290,-40,-36,16,78
20151118,2286,2290,,,,2290,2290,0,0,0,78
20151119,2290,2290,2250,2250,2246,2246,2248,-44,-42,4,78
20151120,2246,2248,,,,2248,2248,0,0,0,78
20151123,2248,2248,2160,2160,2112,2112,2132,-136,-116,64,42
20151124,2112,2132,2062,2106,2060,2060,2072,-72,-60,16,38
20151125,2060,2072,2104,2162,2074,2076,2104,4,32,8,40
20151126,2076,2104,,,,2146,2146,42,42,0,40
20151127,2146,2146,2142,2142,2098,2100,2120,-46,-26,12,40
20151130,2100,2120,2088,2098,2088,2096,2094,-24,-26,8,40
bu1703,20150317,3388,3388,,,,3388,3388,0,0,0,0
20150318,3388,3388,,,,3388,3388,0,0,0,0
20150319,3388,3388,,,,3388,3388,0,0,0,0
20150320,3388,3388,,,,3388,3388,0,0,0,0
20150323,3388,3388,,,,3388,3388,0,0,0,0
20150324,3388,3388,,,,3344,3344,-44,-44,0,0
20150325,3344,3344,,,,3368,3368,24,24,0,0
20150326,3368,3368,,,,3464,3464,96,96,0,0
20150327,3464,3464,,,,3464,3464,0,0,0,0
20150330,3464,3464,,,,3464,3464,0,0,0,0
20150331,3464,3464,,,,3464,3464,0,0,0,0
20150401,3464,3464,,,,3464,3464,0,0,0,0
20150402,3464,3464,,,,3464,3464,0,0,0,0
20150403,3464,3464,,,,3464,3464,0,0,0,0
20150407,3464,3464,,,,3520,3520,56,56,0,0
20150408,3520,3520,,,,3520,3520,0,0,0,0
20150409,3520,3520,,,,3520,3520,0,0,0,0
20150410,3520,3520,,,,3520,3520,0,0,0,0
20150413,3520,3520,,,,3520,3520,0,0,0,0
20150414,3520,3520,,,,3526,3526,6,6,0,0
20150415,3526,3526,,,,3526,3526,0,0,0,0
20150416,3526,3526,,,,3526,3526,0,0,0,0
20150417,3526,3526,,,,3526,3526,0,0,0,0
20150420,3526,3526,,,,3526,3526,0,0,0,0
20150421,3526,3526,,,,3526,3526,0,0,0,0
20150422,3526,3526,,,,3526,3526,0,0,0,0
20150423,3526,3526,,,,3526,3526,0,0,0,0
20150424,3526,3526,,,,3526,3526,0,0,0,0
20150427,3526,3526,,,,3526,3526,0,0,0,0
20150428,3526,3526,,,,3656,3656,130,130,0,0
20150429,3656,3656,,,,3750,3750,94,94,0,0
20150430,3750,3750,,,,3750,3750,0,0,0,0
20150504,3750,3750,,,,3750,3750,0,0,0,0
20150505,3750,3750,,,,3756,3756,6,6,0,0
20150506,3756,3756,,,,3756,3756,0,0,0,0
20150507,3756,3756,,,,3756,3756,0,0,0,0
20150508,3756,3756,,,,3756,3756,0,0,0,0
20150511,3756,3756,,,,3756,3756,0,0,0,0
20150512,3756,3756,,,,3756,3756,0,0,0,0
20150513,3756,3756,,,,3756,3756,0,0,0,0
20150514,3756,3756,,,,3756,3756,0,0,0,0
20150515,3756,3756,,,,3756,3756,0,0,0,0
20150518,3756,3756,3910,3910,3390,3390,3650,-366,-106,4,2
20150519,3390,3650,,,,3650,3650,0,0,0,2
20150520,3650,3650,,,,3630,3630,-20,-20,0,2
20150521,3630,3630,,,,3630,3630,0,0,0,2
20150522,3630,3630,,,,3630,3630,0,0,0,2
20150525,3630,3630,,,,3630,3630,0,0,0,2
20150526,3630,3630,,,,3630,3630,0,0,0,2
20150527,3630,3630,,,,3630,3630,0,0,0,2
20150528,3630,3630,,,,3630,3630,0,0,0,2
20150529,3630,3630,,,,3630,3630,0,0,0,2
20150601,3630,3630,,,,3630,3630,0,0,0,2
20150602,3630,3630,,,,3630,3630,0,0,0,2
20150603,3630,3630,,,,3630,3630,0,0,0,2
20150604,3630,3630,,,,3630,3630,0,0,0,2
20150605,3630,3630,,,,3630,3630,0,0,0,2
20150608,3630,3630,,,,3630,3630,0,0,0,2
20150609,3630,3630,,,,3630,3630,0,0,0,2
20150610,3630,3630,,,,3630,3630,0,0,0,2
20150611,3630,3630,,,,3630,3630,0,0,0,2
20150612,3630,3630,,,,3630,3630,0,0,0,2
20150615,3630,3630,3460,3540,3448,3448,3486,-182,-144,8,4
20150616,3448,3486,3588,3588,3310,3450,3450,-36,-36,12,4
20150617,3450,3450,,,,3450,3450,0,0,0,4
20150618,3450,3450,,,,3450,3450,0,0,0,4
20150619,3450,3450,,,,3346,3346,-104,-104,0,4
20150623,3346,3346,,,,3304,3304,-42,-42,0,4
20150624,3304,3304,,,,3304,3304,0,0,0,4
20150625,3304,3304,,,,3304,3304,0,0,0,4
20150626,3304,3304,,,,3304,3304,0,0,0,4
20150629,3304,3304,,,,3304,3304,0,0,0,4
20150630,3304,3304,3140,3336,3138,3138,3216,-166,-88,14,4
20150701,3138,3216,3172,3172,3090,3120,3120,-96,-96,20,10
20150702,3120,3120,,,,3120,3120,0,0,0,10
20150703,3120,3120,3154,3164,3138,3138,3148,18,28,8,10
20150706,3138,3148,,,,3148,3148,0,0,0,10
20150707,3148,3148,2990,2990,2990,2990,2990,-158,-158,2,12
20150708,2990,2990,2754,2754,2750,2750,2750,-240,-240,6,16
20150709,2750,2750,2620,2800,2620,2800,2702,50,-48,12,18
20150710,2800,2702,2834,2834,2834,2834,2834,132,132,2,18
20150713,2834,2834,,,,2834,2834,0,0,0,18
20150714,2834,2834,2740,2842,2740,2742,2774,-92,-60,6,20
20150715,2742,2774,,,,2850,2850,76,76,0,20
20150716,2850,2850,,,,2850,2850,0,0,0,20
20150717,2850,2850,,,,2850,2850,0,0,0,20
20150720,2850,2850,2898,2898,2888,2888,2892,38,42,4,20
20150721,2888,2892,,,,2892,2892,0,0,0,20
20150722,2892,2892,2968,2968,2950,2950,2960,58,68,8,22
20150723,2950,2960,2868,2948,2868,2938,2934,-22,-26,26,8
20150724,2938,2934,2870,2918,2828,2918,2860,-16,-74,8,6
20150727,2918,2860,2750,2750,2716,2716,2732,-144,-128,4,10
20150728,2716,2732,2698,2720,2698,2720,2710,-12,-22,8,6
20150729,2720,2710,2750,2750,2750,2750,2750,40,40,2,6
20150730,2750,2750,,,,2728,2728,-22,-22,0,6
20150731,2728,2728,,,,2728,2728,0,0,0,6
20150803,2728,2728,2606,2646,2606,2642,2624,-86,-104,8,6
20150804,2642,2624,2612,2612,2612,2612,2612,-12,-12,2,6
20150805,2612,2612,2642,2716,2640,2658,2656,46,44,24,6
20150806,2658,2656,2658,2658,2560,2560,2612,-96,-44,10,8
20150807,2560,2612,2540,2624,2540,2624,2594,12,-18,6,8
20150810,2624,2594,2714,2714,2714,2714,2714,120,120,2,8
20150811,2714,2714,2760,2820,2760,2790,2786,76,72,14,8
20150812,2790,2786,,,,2786,2786,0,0,0,8
20150813,2786,2786,2800,2838,2762,2762,2794,-24,8,8,8
20150814,2762,2794,2790,2790,2790,2790,2790,-4,-4,2,10
20150817,2790,2790,2724,2724,2722,2722,2722,-68,-68,4,8
20150818,2722,2722,,,,2722,2722,0,0,0,8
20150819,2722,2722,,,,2722,2722,0,0,0,8
20150820,2722,2722,2712,2712,2652,2652,2680,-70,-42,6,10
20150821,2652,2680,2636,2636,2594,2594,2618,-86,-62,8,8
20150824,2594,2618,2562,2562,2486,2486,2522,-132,-96,24,12
20150825,2486,2522,2468,2468,2450,2450,2460,-72,-62,10,6
20150826,2450,2460,2450,2452,2450,2452,2450,-8,-10,6,8
20150827,2452,2450,2424,2558,2412,2558,2468,108,18,14,4
20150828,2558,2468,,,,2514,2514,46,46,0,4
20150831,2514,2514,,,,2514,2514,0,0,0,4
20150901,2514,2514,,,,2548,2548,34,34,0,4
20150902,2548,2548,,,,2520,2520,-28,-28,0,4
20150907,2520,2520,,,,2520,2520,0,0,0,4
20150908,2520,2520,,,,2502,2502,-18,-18,0,4
20150909,2502,2502,,,,2502,2502,0,0,0,4
20150910,2502,2502,2436,2616,2436,2612,2514,110,12,28,4
20150911,2612,2514,2560,2560,2560,2560,2560,46,46,2,4
20150914,2560,2560,2660,2660,2600,2600,2630,40,70,4,4
20150915,2600,2630,2574,2574,2574,2574,2574,-56,-56,2,4
20150916,2574,2574,2552,2552,2552,2552,2552,-22,-22,4,4
20150917,2552,2552,,,,2556,2556,4,4,0,4
20150918,2556,2556,,,,2556,2556,0,0,0,4
20150921,2556,2556,,,,2556,2556,0,0,0,4
20150922,2556,2556,,,,2556,2556,0,0,0,4
20150923,2556,2556,,,,2524,2524,-32,-32,0,4
20150924,2524,2524,,,,2524,2524,0,0,0,4
20150925,2524,2524,,,,2524,2524,0,0,0,4
20150928,2524,2524,,,,2524,2524,0,0,0,4
20150929,2524,2524,,,,2522,2522,-2,-2,0,4
20150930,2522,2522,,,,2522,2522,0,0,0,4
20151008,2522,2522,,,,2540,2540,18,18,0,4
20151009,2540,2540,,,,2616,2616,76,76,0,4
20151012,2616,2616,,,,2616,2616,0,0,0,4
20151013,2616,2616,,,,2580,2580,-36,-36,0,4
20151014,2580,2580,,,,2594,2594,14,14,0,4
20151015,2594,2594,,,,2596,2596,2,2,0,4
20151016,2596,2596,,,,2596,2596,0,0,0,4
20151019,2596,2596,2618,2618,2506,2506,2566,-90,-30,10,6
20151020,2506,2566,2702,2702,2544,2544,2648,-22,82,6,4
20151021,2544,2648,,,,2644,2644,-4,-4,0,4
20151022,2644,2644,,,,2562,2562,-82,-82,0,4
20151023,2562,2562,2506,2532,2462,2462,2500,-100,-62,6,4
20151026,2462,2500,2472,2472,2472,2472,2472,-28,-28,2,6
20151027,2472,2472,2454,2454,2454,2454,2454,-18,-18,2,4
20151028,2454,2454,2452,2452,2452,2452,2452,-2,-2,2,6
20151029,2452,2452,,,,2452,2452,0,0,0,6
20151030,2452,2452,2444,2450,2444,2450,2446,-2,-6,4,4
20151102,2450,2446,,,,2428,2428,-18,-18,0,4
20151103,2428,2428,,,,2428,2428,0,0,0,4
20151104,2428,2428,,,,2426,2426,-2,-2,0,4
20151105,2426,2426,,,,2416,2416,-10,-10,0,4
20151106,2416,2416,,,,2426,2426,10,10,0,4
20151109,2426,2426,,,,2426,2426,0,0,0,4
20151110,2426,2426,,,,2450,2450,24,24,0,4
20151111,2450,2450,,,,2450,2450,0,0,0,4
20151112,2450,2450,,,,2446,2446,-4,-4,0,4
20151113,2446,2446,,,,2446,2446,0,0,0,4
20151116,2446,2446,,,,2460,2460,14,14,0,4
20151117,2460,2460,,,,2422,2422,-38,-38,0,4
20151118,2422,2422,2376,2376,2376,2376,2376,-46,-46,2,6
20151119,2376,2376,,,,2360,2360,-16,-16,0,6
20151120,2360,2360,,,,2360,2360,0,0,0,6
20151123,2360,2360,,,,2238,2238,-122,-122,0,6
20151124,2238,2238,,,,2176,2176,-62,-62,0,6
20151125,2176,2176,,,,2208,2208,32,32,0,6
20151126,2208,2208,,,,2208,2208,0,0,0,6
20151127,2208,2208,,,,2208,2208,0,0,0,6
20151130,2208,2208,,,,2180,2180,-28,-28,0,6
bu1706,20150616,3486,3486,,,,3486,3486,0,0,0,0
20150617,3486,3486,,,,3486,3486,0,0,0,0
20150618,3486,3486,3142,3278,3142,3278,3210,-208,-276,4,0
20150619,3278,3210,,,,3112,3112,-98,-98,0,0
20150623,3112,3112,,,,3072,3072,-40,-40,0,0
20150624,3072,3072,,,,3076,3076,4,4,0,0
20150625,3076,3076,3228,3228,3228,3228,3228,152,152,2,2
20150626,3228,3228,3228,3228,3228,3228,3228,0,0,2,4
20150629,3228,3228,3220,3220,3220,3220,3220,-8,-8,2,2
20150630,3220,3220,3200,3200,3200,3200,3200,-20,-20,2,0
20150701,3200,3200,,,,3200,3200,0,0,0,0
20150702,3200,3200,,,,3200,3200,0,0,0,0
20150703,3200,3200,,,,3200,3200,0,0,0,0
20150706,3200,3200,3360,3360,3066,3200,3192,0,-8,16,4
20150707,3200,3192,3076,3076,3076,3076,3076,-116,-116,2,4
20150708,3076,3076,,,,2922,2922,-154,-154,0,4
20150709,2922,2922,2774,2900,2774,2900,2806,-22,-116,10,6
20150710,2900,2806,2740,2928,2730,2888,2810,82,4,12,2
20150713,2888,2810,,,,2810,2810,0,0,0,2
20150714,2810,2810,,,,2882,2882,72,72,0,2
20150715,2882,2882,,,,2882,2882,0,0,0,2
20150716,2882,2882,,,,2882,2882,0,0,0,2
20150717,2882,2882,,,,2882,2882,0,0,0,2
20150720,2882,2882,,,,3010,3010,128,128,0,2
20150721,3010,3010,2874,2874,2874,2874,2874,-136,-136,2,4
20150722,2874,2874,2994,2994,2888,2960,2948,86,74,8,6
20150723,2960,2948,,,,2960,2960,12,12,0,6
20150724,2960,2960,2860,2860,2860,2860,2860,-100,-100,2,4
20150727,2860,2860,2814,2990,2726,2726,2814,-134,-46,8,4
20150728,2726,2814,2674,2770,2672,2676,2712,-138,-102,16,6
20150729,2676,2712,2796,2796,2690,2790,2762,78,50,14,8
20150730,2790,2762,2632,2674,2632,2674,2652,-88,-110,4,8
20150731,2674,2652,,,,2660,2660,8,8,0,8
20150803,2660,2660,2634,2634,2564,2564,2614,-96,-46,8,12
20150804,2564,2614,2516,2734,2516,2576,2638,-38,24,10,8
20150805,2576,2638,2646,2648,2646,2648,2646,10,8,4,6
20150806,2648,2646,,,,2646,2646,0,0,0,6
20150807,2646,2646,,,,2646,2646,0,0,0,6
20150810,2646,2646,2544,2714,2544,2714,2668,68,22,10,4
20150811,2714,2668,2748,2800,2748,2790,2780,122,112,22,10
20150812,2790,2780,2764,2764,2764,2764,2764,-16,-16,2,10
20150813,2764,2764,2794,2840,2746,2814,2798,50,34,8,8
20150814,2814,2798,,,,2840,2840,42,42,0,8
20150817,2840,2840,2788,2788,2750,2750,2754,-90,-86,18,16
20150818,2750,2754,2756,2756,2712,2712,2744,-42,-10,8,12
20150819,2712,2744,2716,2716,2716,2716,2716,-28,-28,2,10
20150820,2716,2716,2698,2698,2666,2666,2678,-50,-38,6,10
20150821,2666,2678,2644,2644,2614,2614,2628,-64,-50,4,10
20150824,2614,2628,2584,2584,2500,2500,2516,-128,-112,14,22
20150825,2500,2516,2478,2478,2426,2426,2456,-90,-60,6,22
20150826,2426,2456,2558,2558,2464,2464,2508,8,52,8,22
20150827,2464,2508,,,,2508,2508,0,0,0,22
20150828,2508,2508,2598,2600,2598,2600,2598,92,90,4,20
20150831,2600,2598,2580,2580,2580,2580,2580,-18,-18,2,22
20150901,2580,2580,,,,2580,2580,0,0,0,22
20150902,2580,2580,2584,2600,2584,2600,2594,20,14,6,20
20150907,2600,2594,2532,2532,2532,2532,2532,-62,-62,2,20
20150908,2532,2532,2512,2512,2512,2512,2512,-20,-20,4,22
20150909,2512,2512,2600,2600,2586,2586,2592,74,80,4,22
20150910,2586,2592,2576,2600,2576,2600,2588,8,-4,4,24
20150911,2600,2588,,,,2588,2588,0,0,0,24
20150914,2588,2588,2678,2680,2650,2650,2672,62,84,10,22
20150915,2650,2672,2618,2618,2572,2572,2592,-100,-80,8,24
20150916,2572,2592,2582,2594,2578,2578,2584,-14,-8,6,22
20150917,2578,2584,,,,2584,2584,0,0,0,22
20150918,2584,2584,2570,2570,2544,2544,2550,-40,-34,20,22
20150921,2544,2550,2598,2598,2502,2576,2548,26,-2,10,22
20150922,2576,2548,2590,2600,2550,2556,2576,8,28,12,22
20150923,2556,2576,2550,2574,2550,2574,2562,-2,-14,4,22
20150924,2574,2562,2560,2560,2558,2558,2558,-4,-4,14,24
20150925,2558,2558,,,,2558,2558,0,0,0,24
20150928,2558,2558,,,,2558,2558,0,0,0,24
20150929,2558,2558,,,,2558,2558,0,0,0,24
20150930,2558,2558,,,,2558,2558,0,0,0,24
20151008,2558,2558,,,,2558,2558,0,0,0,24
20151009,2558,2558,,,,2558,2558,0,0,0,24
20151012,2558,2558,,,,2558,2558,0,0,0,24
20151013,2558,2558,,,,2558,2558,0,0,0,24
20151014,2558,2558,,,,2558,2558,0,0,0,24
20151015,2558,2558,,,,2558,2558,0,0,0,24
20151016,2558,2558,,,,2558,2558,0,0,0,24
20151019,2558,2558,2606,2606,2588,2588,2596,30,38,4,22
20151020,2588,2596,,,,2578,2578,-18,-18,0,22
20151021,2578,2578,2570,2570,2570,2570,2570,-8,-8,2,24
20151022,2570,2570,,,,2570,2570,0,0,0,24
20151023,2570,2570,,,,2570,2570,0,0,0,24
20151026,2570,2570,,,,2570,2570,0,0,0,24
20151027,2570,2570,,,,2550,2550,-20,-20,0,24
20151028,2550,2550,,,,2546,2546,-4,-4,0,24
20151029,2546,2546,,,,2546,2546,0,0,0,24
20151030,2546,2546,,,,2490,2490,-56,-56,0,24
20151102,2490,2490,2462,2462,2460,2460,2460,-30,-30,4,28
20151103,2460,2460,2426,2510,2426,2452,2476,-8,16,52,26
20151104,2452,2476,2478,2478,2478,2478,2478,2,2,2,26
20151105,2478,2478,,,,2478,2478,0,0,0,26
20151106,2478,2478,,,,2478,2478,0,0,0,26
20151109,2478,2478,,,,2478,2478,0,0,0,26
20151110,2478,2478,,,,2478,2478,0,0,0,26
20151111,2478,2478,,,,2478,2478,0,0,0,26
20151112,2478,2478,,,,2478,2478,0,0,0,26
20151113,2478,2478,2508,2510,2412,2442,2470,-36,-8,14,28
20151116,2442,2470,2430,2430,2400,2400,2416,-70,-54,10,24
20151117,2400,2416,,,,2414,2414,-2,-2,0,24
20151118,2414,2414,2398,2398,2398,2398,2398,-16,-16,2,26
20151119,2398,2398,2388,2388,2344,2344,2368,-54,-30,8,26
20151120,2344,2368,,,,2308,2308,-60,-60,0,26
20151123,2308,2308,2228,2228,2214,2214,2220,-94,-88,4,24
20151124,2214,2220,,,,2220,2220,0,0,0,24
20151125,2220,2220,2296,2298,2110,2110,2208,-110,-12,34,26
20151126,2110,2208,,,,2208,2208,0,0,0,26
20151127,2208,2208,2206,2208,2206,2208,2206,0,-2,8,24
20151130,2208,2206,2170,2170,2170,2170,2170,-36,-36,2,24
bu1709,20150916,2592,2592,,,,2592,2592,0,0,0,0
20150917,2592,2592,,,,2596,2596,4,4,0,0
20150918,2596,2596,2472,2588,2442,2588,2520,-8,-76,12,8
20150921,2588,2520,2520,2578,2520,2578,2554,58,34,10,16
20150922,2578,2554,2676,2676,2548,2598,2624,44,70,12,16
20150923,2598,2624,,,,2624,2624,0,0,0,16
20150924,2624,2624,,,,2624,2624,0,0,0,16
20150925,2624,2624,,,,2624,2624,0,0,0,16
20150928,2624,2624,,,,2622,2622,-2,-2,0,16
20150929,2622,2622,,,,2620,2620,-2,-2,0,16
20150930,2620,2620,,,,2620,2620,0,0,0,16
20151008,2620,2620,,,,2620,2620,0,0,0,16
20151009,2620,2620,2618,2738,2618,2738,2678,118,58,8,12
20151012,2738,2678,2676,2676,2666,2666,2670,-12,-8,4,10
20151013,2666,2670,,,,2670,2670,0,0,0,10
20151014,2670,2670,,,,2670,2670,0,0,0,10
20151015,2670,2670,,,,2670,2670,0,0,0,10
20151016,2670,2670,,,,2670,2670,0,0,0,10
20151019,2670,2670,,,,2670,2670,0,0,0,10
20151020,2670,2670,,,,2598,2598,-72,-72,0,10
20151021,2598,2598,,,,2586,2586,-12,-12,0,10
20151022,2586,2586,,,,2580,2580,-6,-6,0,10
20151023,2580,2580,,,,2578,2578,-2,-2,0,10
20151026,2578,2578,,,,2578,2578,0,0,0,10
20151027,2578,2578,,,,2578,2578,0,0,0,10
20151028,2578,2578,,,,2578,2578,0,0,0,10
20151029,2578,2578,,,,2578,2578,0,0,0,10
20151030,2578,2578,,,,2576,2576,-2,-2,0,10
20151102,2576,2576,2568,2568,2568,2568,2568,-8,-8,2,8
20151103,2568,2568,2558,2558,2558,2558,2558,-10,-10,2,8
20151104,2558,2558,2546,2558,2546,2558,2550,0,-8,8,16
20151105,2558,2550,,,,2550,2550,0,0,0,16
20151106,2550,2550,,,,2550,2550,0,0,0,16
20151109,2550,2550,,,,2550,2550,0,0,0,16
20151110,2550,2550,,,,2550,2550,0,0,0,16
20151111,2550,2550,,,,2550,2550,0,0,0,16
20151112,2550,2550,,,,2550,2550,0,0,0,16
20151113,2550,2550,,,,2550,2550,0,0,0,16
20151116,2550,2550,2458,2458,2458,2458,2458,-92,-92,2,16
20151117,2458,2458,2350,2438,2350,2426,2420,-32,-38,22,14
20151118,2426,2420,2426,2426,2426,2426,2426,6,6,2,12
20151119,2426,2426,2380,2380,2280,2280,2330,-146,-96,4,14
20151120,2280,2330,2330,2330,2330,2330,2330,0,0,4,14
20151123,2330,2330,,,,2276,2276,-54,-54,0,14
20151124,2276,2276,2194,2288,2148,2250,2208,-26,-68,24,16
20151125,2250,2208,2314,2314,2302,2302,2308,94,100,6,18
20151126,2302,2308,,,,2310,2310,2,2,0,18
20151127,2310,2310,2380,2380,2234,2270,2294,-40,-16,16,12
20151130,2270,2294,,,,2256,2256,-38,-38,0,12
cu1501,20150105,46500,46560,46340,46360,45910,45960,46100,-600,-460,21224,37210
20150106,45960,46100,45960,45960,44950,45680,45560,-420,-540,17660,31940
20150107,45680,45560,45620,45670,45300,45430,45530,-130,-30,16130,29270
20150108,45430,45530,45650,45700,45430,45500,45580,-30,50,16410,26200
20150109,45500,45580,45780,45800,45200,45200,45360,-380,-220,16660,24540
20150112,45200,45360,45200,45300,44620,44750,44980,-610,-380,14520,20810
20150113,44750,44980,45030,45030,43650,43700,44290,-1280,-690,9380,16360
20150114,43700,44290,42420,43360,42070,42070,42540,-2220,-1750,2690,14200
20150115,42070,42540,39130,41500,39130,41150,40870,-1390,-1670,14660,6260
cu1502,20150105,46250,46090,46040,46040,45470,45550,45730,-540,-360,42206,111238
20150106,45550,45730,44750,45370,43710,45270,45090,-460,-640,66402,102798
20150107,45270,45090,45180,45300,44880,45080,45110,-10,20,37274,101126
20150108,45080,45110,45040,45320,45030,45080,45160,-30,50,29970,98628
20150109,45080,45160,45320,45460,44700,44720,44930,-440,-230,45092,96072
20150112,44720,44930,44590,44900,44220,44400,44530,-530,-400,46160,92124
20150113,44400,44530,43890,44140,43330,43330,43790,-1200,-740,47098,91702
20150114,43330,43790,42870,43140,41600,41600,42410,-2190,-1380,36432,89444
20150115,41600,42410,40980,41540,40030,41300,40880,-1110,-1530,92318,86056
20150116,41300,40880,42000,42020,40910,41320,41270,440,390,49570,79064
20150119,41320,41270,41140,42170,41040,41980,41760,710,490,45202,76360
20150120,41980,41760,41400,41810,41260,41450,41560,-310,-200,39000,73162
20150121,41450,41560,41670,41790,41330,41450,41530,-110,-30,26598,69576
20150122,41450,41530,41080,42310,41080,41760,41820,230,290,38258,64144
20150123,41760,41820,41700,42000,41000,41240,41350,-580,-470,39214,60836
20150126,41240,41350,41100,41100,39280,39680,40030,-1670,-1320,45504,56030
20150127,39680,40030,40030,41150,40030,40690,40660,660,630,31720,49560
20150128,40690,40660,40500,40650,39850,40190,40170,-470,-490,38010,39990
20150129,40190,40170,40210,40440,39850,39870,40030,-300,-140,24400,36714
20150130,39870,40030,39810,40010,39480,39570,39730,-460,-300,30696,29190
20150202,39570,39730,40020,40630,39860,40570,40410,840,680,18870,26420
20150203,40570,40410,40490,41000,40360,41000,40800,590,390,18170,19510
20150204,41000,40800,41300,42090,41120,41330,41580,530,780,9890,16580
20150205,41330,41580,41550,41610,41160,41260,41300,-320,-280,8480,14340
20150206,41260,41300,41000,41800,41000,41790,41670,490,370,7530,11500
20150209,41790,41670,41700,41700,41210,41370,41310,-300,-360,3590,10020
20150210,41370,41310,41350,41500,41150,41300,41300,-10,-10,4020,9410
cu1503,20150105,45800,45620,45500,45570,44990,45080,45250,-540,-370,189194,325160
20150106,45080,45250,44210,44910,43980,44800,44570,-450,-680,447986,310542
20150107,44800,44570,44640,44840,44420,44650,44660,80,90,317816,301058
20150108,44650,44660,44650,44890,44580,44680,44740,20,80,208524,297932
20150109,44680,44740,45000,45050,44250,44250,44550,-490,-190,384066,308602
20150112,44250,44550,44100,44450,43790,43960,44140,-590,-410,403724,307588
20150113,43960,44140,43400,43720,42880,42890,43360,-1250,-780,404006,315628
20150114,42890,43360,42300,42700,41190,41190,42150,-2170,-1210,408472,309766
20150115,41190,42150,40600,41230,39820,40920,40520,-1230,-1630,1020638,312866
20150116,40920,40520,41320,41710,40570,41040,41070,520,550,656280,303626
20150119,41040,41070,40850,41910,40750,41770,41400,700,330,517860,287290
20150120,41770,41400,41200,41590,41020,41250,41340,-150,-60,418760,276198
20150121,41250,41340,41510,41590,41110,41260,41320,-80,-20,351830,268638
20150122,41260,41320,41040,42180,40930,41560,41600,240,280,526812,253644
20150123,41560,41600,41480,41800,40670,41010,41210,-590,-390,507322,243656
20150126,41010,41210,40680,40800,39140,39470,39970,-1740,-1240,497198,219780
20150127,39470,39970,39970,40950,39860,40520,40440,550,470,385612,199462
20150128,40520,40440,40320,40450,39590,39970,39980,-470,-460,309462,182224
20150129,39970,39980,40000,40190,39560,39640,39830,-340,-150,249496,171044
20150130,39640,39830,39510,39820,39230,39450,39550,-380,-280,245102,159712
20150202,39450,39550,39900,40660,39650,40530,40120,980,570,172556,144580
20150203,40530,40120,40390,41000,40270,40920,40670,800,550,135792,134494
20150204,40920,40670,41330,42110,41040,41310,41490,640,820,108632,125344
20150205,41310,41490,41500,41690,41130,41240,41320,-250,-170,94156,120096
20150206,41240,41320,41060,41880,41000,41830,41570,510,250,89362,113104
20150209,41830,41570,41550,41740,41250,41470,41460,-100,-110,84300,109024
20150210,41470,41460,41500,41700,41280,41470,41490,10,30,50996,105060
20150211,41470,41490,41120,41360,41020,41240,41180,-250,-310,53456,100922
20150212,41240,41180,41280,41340,41000,41210,41140,30,-40,39306,96570
20150213,41210,41140,41580,42290,41330,42200,41880,1060,740,69138,88296
20150216,42200,41880,42400,42400,41800,42300,41970,420,90,34560,87170
20150217,42300,41970,42160,42330,42020,42240,42150,270,180,20220,84674
20150225,42240,42150,42240,42380,42020,42150,42150,0,0,12426,82160
20150226,42150,42150,42180,42770,42090,42690,42440,540,290,35366,69996
20150227,42690,42440,43040,43070,42680,42880,42840,440,400,41178,55678
20150302,42880,42840,42800,43400,42630,43350,43070,510,230,17278,52990
20150303,43350,43070,43100,43370,42630,42700,42780,-370,-290,21080,47740
20150304,42700,42780,42550,42680,42380,42610,42610,-170,-170,13390,44750
20150305,42610,42610,42630,42630,42360,42560,42560,-50,-50,14210,40680
20150306,42560,42560,42500,42740,42190,42260,42410,-300,-150,12670,37220
20150309,42260,42410,42320,42430,41850,42410,42050,0,-360,17570,31050
20150310,42410,42050,42370,42800,42300,42300,42520,250,470,12210,28100
20150311,42300,42520,42100,42300,42000,42150,42210,-370,-310,11800,25040
20150312,42150,42210,41290,42500,41290,42500,42090,290,-120,10260,20860
20150313,42500,42090,42500,42800,42310,42670,42640,580,550,6820,18660
20150316,42670,42640,42500,42700,41500,42700,42460,60,-180,4690,16160
cu1504,20150105,45470,45310,45120,45260,44660,44720,44940,-590,-370,73638,128618
20150106,44720,44940,43800,44550,43610,44440,44250,-500,-690,179344,140898
20150107,44440,44250,44280,44480,44050,44240,44300,-10,50,117592,146880
20150108,44240,44300,44200,44520,44200,44340,44380,40,80,95434,145272
20150109,44340,44380,44690,44690,43900,43900,44190,-480,-190,180492,161564
20150112,43900,44190,43780,44100,43400,43590,43770,-600,-420,189136,178732
20150113,43590,43770,43000,43340,42500,42520,42960,-1250,-810,214952,195202
20150114,42520,42960,41950,42300,40810,40810,41740,-2150,-1220,217662,197350
20150115,40810,41740,40350,41020,39640,40730,40350,-1010,-1390,414178,200092
20150116,40730,40350,41080,41470,40330,40780,40800,430,450,323734,218520
20150119,40780,40800,40630,41660,40510,41560,41190,760,390,298172,218328
20150120,41560,41190,40970,41450,40860,41080,41170,-110,-20,259190,231348
20150121,41080,41170,41310,41420,40970,41100,41180,-70,10,236348,243784
20150122,41100,41180,40850,41990,40730,41390,41410,210,230,350340,253778
20150123,41390,41410,41290,41620,40410,40750,40910,-660,-500,480318,302022
20150126,40750,40910,40420,40540,38860,39250,39660,-1660,-1250,715356,338392
20150127,39250,39660,39730,40730,39650,40260,40210,600,550,604476,352686
20150128,40260,40210,40050,40210,39260,39690,39690,-520,-520,687248,372070
20150129,39690,39690,39710,39960,39240,39320,39520,-370,-170,602624,388782
20150130,39320,39520,39160,39520,38890,39090,39210,-430,-310,647928,414782
20150202,39090,39210,39580,40370,39330,40290,39830,1080,620,586236,416396
20150203,40290,39830,40110,40830,40050,40760,40440,930,610,543294,400826
20150204,40760,40440,41150,41980,40840,41160,41260,720,820,616042,384294
20150205,41160,41260,41360,41540,40930,41000,41190,-260,-70,573146,390944
20150206,41000,41190,40870,41710,40790,41670,41320,480,130,522050,367218
20150209,41670,41320,41400,41600,41040,41260,41310,-60,-10,442210,341890
20150210,41260,41310,41280,41530,41080,41320,41320,10,10,300508,326612
20150211,41320,41320,40990,41270,40860,41100,41040,-220,-280,358612,294416
20150212,41100,41040,41200,41240,40840,41110,41040,70,0,280814,287330
20150213,41110,41040,41330,42280,41240,42120,41730,1080,690,429840,270008
20150216,42120,41730,41930,42250,41720,42220,41910,490,180,239460,252100
20150217,42220,41910,42100,42290,41950,42200,42100,290,190,154340,236648
20150225,42200,42100,42310,42370,41940,42080,42090,-20,-10,93516,226524
20150226,42080,42090,42120,42770,42030,42680,42370,590,280,210814,196110
20150227,42680,42370,43000,43080,42650,42910,42840,540,470,202076,171354
20150302,42910,42840,42800,43430,42560,43310,42990,470,150,134754,161074
20150303,43310,42990,42990,43360,42600,42690,42900,-300,-90,124360,152874
20150304,42690,42900,42650,42700,42300,42610,42580,-290,-320,81116,149794
20150305,42610,42580,42660,42760,42320,42630,42580,50,0,73876,146114
20150306,42630,42580,42580,42860,42200,42330,42500,-250,-80,59764,143804
20150309,42330,42500,42370,42470,41860,42450,42120,-50,-380,98300,139140
20150310,42450,42120,42510,42870,42310,42320,42610,200,490,56438,138732
20150311,42320,42610,42210,42390,42050,42160,42220,-450,-390,52356,136016
20150312,42160,42220,42120,42620,41920,42570,42180,350,-40,65110,133182
20150313,42570,42180,42820,42970,42420,42790,42740,610,560,62140,125468
20150316,42790,42740,42680,42800,42420,42780,42630,40,-110,40366,121764
20150317,42780,42630,42800,42940,42260,42410,42540,-220,-90,49800,113374
20150318,42410,42540,42150,42400,41660,41660,42130,-880,-410,53174,107112
20150319,41660,42130,41590,42080,41200,41750,41680,-380,-450,47568,98656
20150320,41750,41680,42090,42490,41880,42040,42180,360,500,34508,95750
20150323,42040,42180,42480,44050,42420,43650,43440,1470,1260,61192,85434
20150324,43650,43440,43740,44620,43540,43880,43920,440,480,46394,79182
20150325,43880,43920,43800,43960,43470,43730,43660,-190,-260,33710,74844
20150326,43730,43660,43760,44040,43660,43990,43910,330,250,39602,65344
20150327,43990,43910,44000,44370,43500,43870,43820,-40,-90,36280,58280
20150330,43870,43820,43760,44000,43530,43900,43740,80,-80,33476,51712
20150331,43900,43740,43920,44100,43320,43320,43760,-420,20,26826,45536
20150401,43320,43760,43530,43680,43250,43330,43440,-430,-320,13446,43650
20150402,43330,43440,43300,43650,43190,43620,43450,180,10,13050,42370
20150403,43620,43450,43440,43550,43280,43390,43450,-60,0,12250,40100
20150407,43390,43450,43480,43670,43480,43550,43550,100,100,12490,35540
20150408,43550,43550,43630,43850,43470,43540,43570,-10,20,16720,30520
20150409,43540,43570,43490,43600,43210,43420,43350,-150,-220,15030,27890
20150410,43420,43350,43490,43700,43340,43620,43530,270,180,17850,23670
20150413,43620,43530,43620,44000,43500,43750,43690,220,160,10490,19690
20150414,43750,43690,43700,43700,42900,43010,43380,-680,-310,9400,16390
20150415,43010,43380,43200,43920,42750,43090,43080,-290,-300,4570,15920
cu1505,20150105,45240,45080,44980,45050,44450,44580,44710,-500,-370,21854,50930
20150106,44580,44710,43680,44300,43410,44250,44040,-460,-670,39180,57088
20150107,44250,44040,44090,44240,43800,43980,44040,-60,0,20844,59612
20150108,43980,44040,43880,44230,43880,44060,44080,20,40,18310,61138
20150109,44060,44080,44360,44400,43640,43650,43920,-430,-160,30866,64892
20150112,43650,43920,43460,43810,43120,43270,43480,-650,-440,36958,73866
20150113,43270,43480,42670,43020,42200,42210,42650,-1270,-830,48186,85700
20150114,42210,42650,41600,41960,40510,40510,41420,-2140,-1230,51142,90298
20150115,40510,41420,39610,40900,39490,40610,40180,-810,-1240,132456,92810
20150116,40610,40180,40910,41300,40150,40640,40630,460,450,86926,98506
20150119,40640,40630,40500,41490,40340,41410,41060,780,430,91228,99118
20150120,41410,41060,40880,41360,40740,40980,41070,-80,10,83282,101836
20150121,40980,41070,41250,41300,40880,41000,41090,-70,20,54028,107232
20150122,41000,41090,40760,41830,40650,41270,41320,180,230,90890,109340
20150123,41270,41320,41150,41500,40280,40600,40770,-720,-550,118018,123838
20150126,40600,40770,40250,40390,38730,39120,39530,-1650,-1240,180068,142734
20150127,39120,39530,39690,40620,39540,40180,40090,650,560,153348,149844
20150128,40180,40090,39930,40100,39130,39530,39540,-560,-550,156454,159686
20150129,39530,39540,39600,39790,39000,39110,39330,-430,-210,155880,175272
20150130,39110,39330,39000,39300,38690,38870,39000,-460,-330,176290,189546
20150202,38870,39000,39410,40220,39130,40170,39700,1170,700,194134,185960
20150203,40170,39700,39950,40740,39930,40650,40360,950,660,215952,186362
20150204,40650,40360,41040,41890,40040,41020,41180,660,820,284154,178532
20150205,41020,41180,41300,41410,40800,40850,41040,-330,-140,224582,191814
20150206,40850,41040,40780,41600,40630,41530,41230,490,190,226056,191660
20150209,41530,41230,41260,41460,40850,41100,41130,-130,-100,212198,207948
20150210,41100,41130,41100,41360,40900,41160,41140,30,10,161450,219692
20150211,41160,41140,40800,41090,40660,40930,40870,-210,-270,216186,239504
20150212,40930,40870,41040,41060,40650,40930,40860,60,-10,182414,250358
20150213,40930,40860,41170,42120,41070,41980,41590,1120,730,295288,249962
20150216,41980,41590,41800,42080,41540,42060,41750,470,160,188022,246268
20150217,42060,41750,41950,42100,41770,42000,41930,250,180,132284,250464
20150225,42000,41930,42160,42190,41780,41900,41920,-30,-10,103964,270800
20150226,41900,41920,41940,42610,41850,42510,42190,590,270,301590,313040
20150227,42510,42190,42810,42930,42450,42730,42690,540,500,417708,334112
20150302,42730,42690,42600,43280,42370,43200,42830,510,140,402994,320530
20150303,43200,42830,42890,43220,42430,42540,42800,-290,-30,403956,324956
20150304,42540,42800,42480,42560,42120,42460,42400,-340,-400,279060,328168
20150305,42460,42400,42580,42620,42140,42500,42420,100,20,313682,333640
20150306,42500,42420,42420,42720,42060,42200,42390,-220,-30,321600,339796
20150309,42200,42390,42250,42350,41670,42300,42000,-90,-390,455574,322428
20150310,42300,42000,42320,42760,42210,42230,42510,230,510,374268,319692
20150311,42230,42510,42060,42320,41910,42080,42100,-430,-410,309400,315952
20150312,42080,42100,42040,42610,41800,42560,42090,460,-10,456438,311016
20150313,42560,42090,42710,43000,42400,42840,42690,750,600,415176,302458
20150316,42840,42690,42700,42850,42440,42810,42620,120,-70,299488,300712
20150317,42810,42620,42600,42960,42260,42430,42650,-190,30,363952,291280
20150318,42430,42650,42040,42420,41590,41620,42120,-1030,-530,392596,289070
20150319,41620,42120,41430,42790,41120,41720,41510,-400,-610,406544,275844
20150320,41720,41510,42030,42500,41850,42040,42130,530,620,367510,270656
20150323,42040,42130,42480,44050,42400,43690,43280,1560,1150,593582,231790
20150324,43690,43280,43660,44760,43570,43910,43920,630,640,368804,206084
20150325,43910,43920,43880,43990,43460,43740,43730,-180,-190,226328,193636
20150326,43740,43730,43770,44100,43670,44040,43910,310,180,193132,175690
20150327,44040,43910,44150,44440,43500,43910,43960,0,50,222244,157050
20150330,43910,43960,43780,44050,43550,43900,43730,-60,-230,156164,148960
20150331,43900,43730,43910,44140,43450,43460,43840,-270,110,118988,141514
20150401,43460,43840,43540,43750,43210,43380,43480,-460,-360,91398,136628
20150402,43380,43480,43180,43700,43150,43640,43450,160,-30,86428,133532
20150403,43640,43450,43450,43540,43280,43390,43440,-60,-10,49672,132724
20150407,43390,43440,43390,43640,43390,43570,43560,130,120,28690,131346
20150408,43570,43560,43620,43900,43460,43560,43620,0,60,46924,127166
20150409,43560,43620,43530,43630,43180,43430,43360,-190,-260,45392,125322
20150410,43430,43360,43490,43650,43280,43600,43500,240,140,40576,124188
20150413,43600,43500,43550,44060,43530,43750,43710,250,210,46358,123028
20150414,43750,43710,43750,43770,42750,43020,43260,-690,-450,67696,116818
20150415,43020,43260,42950,43280,42730,43130,43040,-130,-220,51462,112032
20150416,43130,43040,42980,43590,42850,43480,43350,440,310,47440,105982
20150417,43480,43350,43900,43990,43680,43750,43810,400,460,48230,99266
20150420,43750,43810,43500,44100,43500,43910,43920,100,110,44162,94994
20150421,43910,43920,43510,43570,43280,43470,43460,-450,-460,50310,87774
20150422,43470,43460,43240,43490,43210,43400,43350,-60,-110,41466,83088
20150423,43400,43350,43320,43470,42900,43180,43160,-170,-190,61916,81244
20150424,43180,43160,43280,43570,43250,43410,43420,250,260,32946,76760
20150427,43410,43420,43910,44090,43620,43950,43890,530,470,43222,71236
20150428,43950,43890,44130,44340,43830,43970,44050,80,160,37062,64370
20150429,43970,44050,44040,44270,43910,44000,44020,-50,-30,29366,58200
20150430,44000,44020,44070,44550,44020,44440,44300,420,280,27650,52562
20150504,44440,44300,45380,45960,45380,45910,45650,1610,1350,14342,50940
20150505,45910,45650,46050,46070,45680,45830,45830,180,180,15790,47100
20150506,45830,45830,46030,46480,45950,46260,46180,430,350,21030,37620
20150507,46260,46180,46210,46260,45830,45920,45930,-260,-250,14230,33980
20150508,45920,45930,45960,46100,45860,46020,45970,90,40,12100,30380
20150511,46020,45970,46000,46070,45720,45860,45810,-110,-160,11550,25900
20150512,45860,45810,45800,45960,45740,45940,45810,130,0,11260,20770
20150513,45940,45810,46200,46460,45900,46310,46100,500,290,6900,16840
20150514,46310,46100,46200,46200,45880,46120,45990,20,-110,5030,13320
20150515,46120,45990,45960,46080,45760,46020,45860,30,-130,3490,12920
cu1506,20150105,45040,44940,44680,44870,44310,44400,44530,-540,-410,3198,25540
20150106,44400,44530,43560,44110,43260,44040,43900,-490,-630,10984,27170
20150107,44040,43900,43820,44040,43600,43720,43810,-180,-90,11210,29192
20150108,43720,43810,43660,43980,43660,43800,43840,-10,30,10280,31618
20150109,43800,43840,44110,44150,43390,43430,43660,-410,-180,11264,33918
20150112,43430,43660,43380,43600,42900,43060,43250,-600,-410,9610,35466
20150113,43060,43250,42400,42780,41960,41980,42450,-1270,-800,14276,38600
20150114,41980,42450,41430,41700,40320,40320,41090,-2130,-1360,13730,41216
20150115,40320,41090,39420,40800,39340,40480,40100,-610,-990,50820,43194
20150116,40480,40100,40880,41180,40050,40520,40570,420,470,28040,46718
20150119,40520,40570,40300,41390,40230,41390,41000,820,430,20786,47692
20150120,41390,41000,40700,41280,40640,40920,41030,-80,30,31074,45486
20150121,40920,41030,41150,41230,40840,40940,41050,-90,20,19716,47866
20150122,40940,41050,40640,41750,40600,41250,41280,200,230,25320,46838
20150123,41250,41280,41150,41460,40200,40520,40670,-760,-610,28988,52628
20150126,40520,40670,40280,40340,38630,39080,39370,-1590,-1300,51826,60116
20150127,39080,39370,39600,40550,39490,40110,40070,740,700,51664,64494
20150128,40110,40070,39920,40040,39080,39440,39460,-630,-610,37076,67058
20150129,39440,39460,39500,39680,38970,39000,39220,-460,-240,41852,70444
20150130,39000,39220,38900,39200,38600,38780,38900,-440,-320,42760,77058
20150202,38780,38900,39240,40140,39030,40040,39650,1140,750,49956,77146
20150203,40040,39650,39850,40660,39850,40570,40300,920,650,54258,75522
20150204,40570,40300,41000,41810,40620,40960,41140,660,840,60272,80912
20150205,40960,41140,41140,41320,40710,40710,40930,-430,-210,45444,81784
20150206,40710,40930,40570,41490,40530,41430,41160,500,230,41858,80104
20150209,41430,41160,41230,41380,40760,41000,41010,-160,-150,36830,84952
20150210,41000,41010,41070,41240,40810,41060,41040,50,30,27894,86800
20150211,41060,41040,40760,40980,40540,40820,40760,-220,-280,44348,89172
20150212,40820,40760,40980,40980,40560,40850,40730,90,-30,25010,91358
20150213,40850,40730,41060,42000,40950,41890,41520,1160,790,51680,88828
20150216,41890,41520,41720,41990,41440,41950,41650,430,130,30372,89868
20150217,41950,41650,41770,42000,41660,41930,41820,280,170,32460,85216
20150225,41930,41820,42080,42280,41690,41810,41820,-10,0,23102,88222
20150226,41810,41820,41880,42510,41710,42380,42130,560,310,84884,106310
20150227,42380,42130,42650,42820,42350,42620,42580,490,450,78206,109744
20150302,42620,42580,42510,43140,42260,43000,42750,420,170,122786,119560
20150303,43000,42750,42750,43110,42320,42420,42670,-330,-80,116090,128270
20150304,42420,42670,42400,42440,42000,42360,42300,-310,-370,83770,134196
20150305,42360,42300,42480,42510,42020,42380,42320,80,20,88078,138746
20150306,42380,42320,42300,42610,41980,42130,42270,-190,-50,99958,140918
20150309,42130,42270,42180,42230,41550,42170,41880,-100,-390,170050,145366
20150310,42170,41880,42180,42670,42080,42100,42360,220,480,156524,159172
20150311,42100,42360,41970,42220,41790,41970,41990,-390,-370,128850,161532
20150312,41970,41990,41910,42550,41710,42500,42030,510,40,196664,161306
20150313,42500,42030,42610,43040,42400,42860,42710,830,680,183550,167476
20150316,42860,42710,42750,42880,42430,42850,42640,140,-70,157974,175122
20150317,42850,42640,42620,43030,42300,42450,42670,-190,30,212744,197446
20150318,42450,42670,42050,42460,41570,41600,42100,-1070,-570,273746,229072
20150319,41600,42100,41430,41980,41080,41710,41540,-390,-560,291716,246774
20150320,41710,41540,42060,42520,41820,42020,42130,480,590,351498,256722
20150323,42020,42130,42500,44040,42400,43690,43300,1560,1170,571670,267430
20150324,43690,43300,43650,44690,43530,43850,43910,550,610,459758,297482
20150325,43850,43910,43810,43940,43390,43680,43670,-230,-240,413712,317368
20150326,43680,43670,43700,44000,43610,43930,43820,260,150,419412,334338
20150327,43930,43820,44050,44340,43360,43770,43870,-50,50,560376,361418
20150330,43770,43870,43690,43990,43410,43830,43620,-40,-250,431488,370238
20150331,43830,43620,43820,44070,43330,43350,43770,-270,150,421054,383528
20150401,43350,43770,43430,43670,43080,43260,43380,-510,-390,407462,387568
20150402,43260,43380,43120,43630,43030,43520,43350,140,-30,435988,378180
20150403,43520,43350,43310,43450,43160,43280,43330,-70,-20,273380,371554
20150407,43280,43330,43300,43560,43300,43480,43450,150,120,116826,375402
20150408,43480,43450,43550,43820,43360,43460,43580,10,130,272338,372156
20150409,43460,43580,43380,43540,43050,43310,43280,-270,-300,238872,379268
20150410,43310,43280,43380,43600,43150,43530,43380,250,100,235236,375940
20150413,43530,43380,43510,44000,43430,43680,43670,300,290,317282,377226
20150414,43680,43670,43650,43710,42580,42860,43160,-810,-510,361446,387860
20150415,42860,43160,42760,43180,42570,43000,42890,-160,-270,330834,381474
20150416,43000,42890,42830,43510,42720,43340,43140,450,250,274218,361406
20150417,43340,43140,43780,43950,43590,43690,43750,550,610,295034,336706
20150420,43690,43750,43590,44200,43510,43870,43800,120,50,245716,325646
20150421,43870,43800,43380,43500,43170,43370,43360,-430,-440,248810,307216
20150422,43370,43360,43180,43430,43080,43310,43250,-50,-110,184900,296946
20150423,43310,43250,43210,43390,42670,42990,43080,-260,-170,273026,282348
20150424,42990,43080,43130,43440,43110,43310,43270,230,190,202648,256692
20150427,43310,43270,43690,44050,43530,43880,43760,610,490,251608,229510
20150428,43880,43760,43900,44280,43730,43910,44010,150,250,194158,201414
20150429,43910,44010,43950,44180,43810,43930,43970,-80,-40,158298,182258
20150430,43930,43970,43940,44430,43920,44390,44210,420,240,132608,162144
20150504,44390,44210,45500,45920,45200,45830,45580,1620,1370,97906,149640
20150505,45830,45580,45910,46050,45630,45810,45800,230,220,78082,144346
20150506,45810,45800,45990,46450,45910,46240,46170,440,370,124282,130884
20150507,46240,46170,46250,46270,45770,45920,45950,-250,-220,69018,124136
20150508,45920,45950,45920,46110,45860,46050,45960,100,10,59032,119742
20150511,46050,45960,45940,46090,45660,45830,45830,-130,-130,46088,114858
20150512,45830,45830,45830,45980,45680,45900,45820,70,-10,31096,115524
20150513,45900,45820,46120,46430,45960,46300,46130,480,310,38716,114936
20150514,46300,46130,46290,46330,45840,46110,46010,-20,-120,38990,111786
20150515,46110,46010,46090,46170,45820,46100,45950,90,-60,31172,110072
20150518,46100,45950,45950,46190,45810,46120,46030,170,80,31032,107992
20150519,46120,46030,45960,46010,45740,45780,45850,-250,-180,35496,102962
20150520,45780,45850,45400,45470,44740,44880,45020,-970,-830,59156,91806
20150521,44880,45020,45100,45260,44800,45220,45100,200,80,28392,86924
20150522,45220,45100,45130,45340,45110,45160,45190,60,90,29102,81950
20150525,45160,45190,44610,44850,44600,44850,44710,-340,-480,30798,77542
20150526,44850,44710,44850,45220,44570,44600,44920,-110,210,38982,68350
20150527,44600,44920,44550,44610,44250,44500,44440,-420,-480,32540,58968
20150528,44500,44440,44260,44540,44180,44440,44310,0,-130,35484,50152
20150529,44440,44310,44330,44900,44170,44470,44400,160,90,22900,43554
20150601,44470,44400,44200,44300,43750,43810,43890,-590,-510,20164,39660
20150602,43810,43890,43720,43900,43570,43810,43730,-80,-160,15330,36260
20150603,43810,43730,43950,43990,43650,43650,43870,-80,140,11830,34810
20150604,43650,43870,43760,43820,43520,43550,43620,-320,-250,14460,30620
20150605,43550,43620,43480,43600,42950,42970,43130,-650,-490,14800,26540
20150608,42970,43130,43000,43370,42960,43330,43290,200,160,8030,24880
20150609,43330,43290,43270,43500,43220,43420,43360,130,70,12630,22090
20150610,43420,43360,43700,43890,43400,43510,43480,150,120,11070,18460
20150611,43510,43480,43760,43880,43400,43400,43720,-80,240,7660,14620
20150612,43400,43720,43250,46330,42800,42850,43000,-870,-720,8390,10990
20150615,42850,43000,43890,43890,42510,42700,42830,-300,-170,4490,8470
cu1507,20150105,45000,44930,44730,44770,44210,44280,44340,-650,-590,868,9280
20150106,44280,44340,43380,43970,43200,43910,43750,-430,-590,2406,10362
20150107,43910,43750,43850,43900,43460,43540,43660,-210,-90,4622,12578
20150108,43540,43660,43630,43800,43570,43650,43690,-10,30,1736,12862
20150109,43650,43690,43950,43980,43260,43300,43490,-390,-200,2900,13416
20150112,43300,43490,43220,43500,42770,42880,43060,-610,-430,3034,14504
20150113,42880,43060,42250,42600,41800,41800,42270,-1260,-790,5318,16596
20150114,41800,42270,41220,41540,40150,40150,40930,-2120,-1340,4166,17970
20150115,40150,40930,39250,40700,39240,40480,40120,-450,-810,13006,19342
20150116,40480,40120,40910,41130,40020,40450,40400,330,280,7838,21358
20150119,40450,40400,40280,41300,40180,41290,40910,890,510,4636,22318
20150120,41290,40910,40700,41220,40580,40870,40990,-40,80,11328,22756
20150121,40870,40990,41090,41180,40830,40890,40990,-100,0,3456,24094
20150122,40890,40990,40670,41630,40540,41160,41170,170,180,3820,24764
20150123,41160,41170,41160,41350,40150,40490,40560,-680,-610,6126,25562
20150126,40490,40560,40220,40250,38550,39060,39340,-1500,-1220,12128,28998
20150127,39060,39340,39470,40550,39470,40100,40030,760,690,8054,29982
20150128,40100,40030,39750,39970,39000,39400,39400,-630,-630,7792,30854
20150129,39400,39400,39440,39610,38930,38980,39160,-420,-240,9898,33536
20150130,38980,39160,38720,39150,38530,38680,38800,-480,-360,9508,36068
20150202,38680,38800,39000,40050,38950,40000,39550,1200,750,12330,36506
20150203,40000,39550,39830,40570,39790,40480,40220,930,670,19254,36162
20150204,40480,40220,40710,41720,40540,40890,41080,670,860,17570,39420
20150205,40890,41080,41020,41230,40610,40630,40860,-450,-220,8726,40372
20150206,40630,40860,40510,41400,40440,41400,41080,540,220,12730,40444
20150209,41400,41080,41150,41280,40680,40900,40910,-180,-170,15094,43646
20150210,40900,40910,40880,41110,40690,41010,40930,100,20,11260,46118
20150211,41010,40930,40630,40880,40450,40800,40660,-130,-270,10878,46248
20150212,40800,40660,40800,40830,40480,40740,40610,80,-50,8146,46616
20150213,40740,40610,41060,41900,40880,41770,41410,1160,800,12922,46114
20150216,41770,41410,41660,41850,41340,41850,41560,440,150,8032,45258
20150217,41850,41560,41730,41910,41580,41830,41760,270,200,8562,43238
20150225,41830,41760,42000,42000,41600,41720,41720,-40,-40,4398,44088
20150226,41720,41720,41760,42390,41620,42270,41970,550,250,20934,49558
20150227,42270,41970,42510,42700,42240,42530,42490,560,520,16170,51858
20150302,42530,42490,42430,43050,42170,42990,42720,500,230,22490,54268
20150303,42990,42720,42620,43010,42240,42310,42520,-410,-200,15698,55424
20150304,42310,42520,42240,42350,41910,42260,42210,-260,-310,13556,57438
20150305,42260,42210,42390,42400,41950,42290,42240,80,30,12780,58222
20150306,42290,42240,42220,42540,41920,42050,42170,-190,-70,12208,58590
20150309,42050,42170,42050,42140,41450,42060,41780,-110,-390,28442,63448
20150310,42060,41780,42070,42560,41960,42000,42260,220,480,26004,66764
20150311,42000,42260,41760,42110,41700,41890,41900,-370,-360,16976,66530
20150312,41890,41900,41840,42500,41610,42420,42040,520,140,32670,66674
20150313,42420,42040,42600,43050,42370,42860,42730,820,690,39436,68330
20150316,42860,42730,42730,42910,42450,42900,42660,170,-70,25244,71464
20150317,42900,42660,42650,43050,42360,42510,42680,-150,20,40652,75014
20150318,42510,42680,42160,42500,41610,41610,42160,-1070,-520,58826,78194
20150319,41610,42160,41450,42460,41100,41720,41640,-440,-520,57600,83316
20150320,41720,41640,42050,42550,41860,42030,42190,390,550,72088,88632
20150323,42030,42190,42480,44090,42450,43680,43400,1490,1210,165986,114852
20150324,43680,43400,43750,44590,43550,43830,43930,430,530,111214,123650
20150325,43830,43930,43810,43940,43400,43660,43650,-270,-280,75788,130052
20150326,43660,43650,43660,43960,43590,43830,43790,180,140,82310,138830
20150327,43830,43790,43930,44290,43310,43710,43780,-80,-10,129564,152966
20150330,43710,43780,43600,43940,43350,43810,43580,30,-200,94596,155994
20150331,43810,43580,43800,44030,43290,43310,43720,-270,140,104100,163542
20150401,43310,43720,43440,43650,43090,43230,43360,-490,-360,108932,166278
20150402,43230,43360,43120,43600,43030,43450,43340,90,-20,148424,162358
20150403,43450,43340,43260,43410,43100,43210,43270,-130,-70,95210,164784
20150407,43210,43270,43270,43500,43230,43430,43400,160,130,44732,165038
20150408,43430,43400,43490,43750,43300,43410,43490,10,90,94760,168806
20150409,43410,43490,43300,43490,43010,43260,43210,-230,-280,96092,175766
20150410,43260,43210,43300,43500,43080,43450,43300,240,90,106498,181204
20150413,43450,43300,43420,43900,43350,43620,43570,320,270,113530,182902
20150414,43620,43570,43550,43640,42480,42770,43060,-800,-510,161982,197524
20150415,42770,43060,42700,43100,42490,42910,42820,-150,-240,139966,203390
20150416,42910,42820,42780,43420,42640,43250,43090,430,270,139508,206302
20150417,43250,43090,43670,43840,43480,43600,43650,510,560,158680,213542
20150420,43600,43650,43470,44050,43400,43760,43720,110,70,160708,226590
20150421,43760,43720,43260,43390,43080,43240,43250,-480,-470,168176,234800
20150422,43240,43250,43020,43320,42950,43200,43140,-50,-110,151950,245358
20150423,43200,43140,43110,43280,42540,42850,42940,-290,-200,257064,269594
20150424,42850,42940,43030,43310,42990,43190,43150,250,210,164886,270852
20150427,43190,43150,43610,43970,43390,43730,43670,580,520,318420,284454
20150428,43730,43670,43740,44140,43570,43740,43850,70,180,312606,311234
20150429,43740,43850,43800,44050,43640,43730,43830,-120,-20,306368,345074
20150430,43730,43830,43770,44300,43750,44240,44070,410,240,316342,351078
20150504,44240,44070,45330,45800,45130,45710,45470,1640,1400,267168,342084
20150505,45710,45470,45830,45930,45530,45730,45700,260,230,233228,324728
20150506,45730,45700,45850,46360,45830,46130,46090,430,390,414292,306694
20150507,46130,46090,46170,46170,45650,45860,45880,-230,-210,302190,289710
20150508,45860,45880,45910,46050,45780,45970,45890,90,10,249800,294960
20150511,45970,45890,45860,46030,45570,45790,45780,-100,-110,273964,289446
20150512,45790,45780,45690,45930,45600,45830,45740,50,-40,188694,285424
20150513,45830,45740,46070,46390,45900,46260,46080,520,340,241570,291246
20150514,46260,46080,46180,46280,45770,46070,46000,-10,-80,254606,285044
20150515,46070,46000,46060,46130,45770,46040,45930,40,-70,195046,287092
20150518,46040,45930,45850,46190,45750,46110,45970,180,40,202992,287370
20150519,46110,45970,45960,45990,45680,45710,45810,-260,-160,216182,278098
20150520,45710,45810,45320,45390,44610,44760,44950,-1050,-860,366894,265216
20150521,44760,44950,44820,45220,44700,45120,44980,170,30,203548,245194
20150522,45120,44980,45100,45280,45030,45110,45160,130,180,153804,229260
20150525,45110,45160,44600,44750,44520,44710,44630,-450,-530,163400,215614
20150526,44710,44630,44760,45170,44480,44520,44870,-110,240,201400,189810
20150527,44520,44870,44450,44480,44140,44420,44340,-450,-530,188484,165394
20150528,44420,44340,44220,44470,44090,44390,44270,50,-70,165046,146796
20150529,44390,44270,44260,44440,44130,44410,44310,140,40,108928,130068
20150601,44410,44310,44150,44270,43710,43760,43920,-550,-390,107606,117232
20150602,43760,43920,43630,43910,43510,43770,43700,-150,-220,73064,112960
20150603,43770,43700,43810,43950,43590,43610,43830,-90,130,64088,109156
20150604,43610,43830,43690,43760,43460,43500,43590,-330,-240,62400,106426
20150605,43500,43590,43430,43520,42860,42930,43100,-660,-490,75238,103392
20150608,42930,43100,43060,43350,42890,43250,43180,150,80,47204,100356
20150609,43250,43180,43200,43430,43170,43350,43290,170,110,34866,99530
20150610,43350,43290,43370,44200,43290,43440,43430,150,140,32228,96498
20150611,43440,43430,43730,43840,43270,43330,43630,-100,200,37352,95204
20150612,43330,43630,43170,43170,42610,42640,42810,-990,-820,47150,94980
20150615,42640,42810,42710,42950,42270,42420,42590,-390,-220,35410,93714
20150616,42420,42590,42320,42470,42160,42290,42320,-300,-270,40874,89874
20150617,42290,42320,42220,42220,41870,41940,41990,-380,-330,35916,84186
20150618,41940,41990,42060,42340,41770,42240,42110,250,120,34318,81354
20150619,42240,42110,42050,42200,41910,41990,42020,-120,-90,41338,75200
20150623,41990,42020,41780,42100,41730,42030,42010,10,-10,27906,72786
20150624,42030,42010,42030,42410,41920,42400,42150,390,140,35568,68252
20150625,42400,42150,42450,42480,41510,42060,42070,-90,-80,44190,65326
20150626,42060,42070,42030,42720,41850,42420,42170,350,100,50772,58090
20150629,42420,42170,42240,42860,42160,42800,42430,630,260,58472,50508
20150630,42800,42430,42580,42700,42260,42380,42490,-50,60,30094,45026
20150701,42380,42490,42150,42550,41900,42280,42300,-210,-190,22436,42870
20150702,42280,42300,42280,42720,42200,42510,42490,210,190,12680,41840
20150703,42510,42490,42610,42700,42440,42650,42570,160,80,12770,41200
20150706,42650,42570,42530,42550,40730,41260,41790,-1310,-780,24320,35250
20150707,41260,41790,41140,41390,40440,40480,40910,-1310,-880,15530,31180
20150708,40480,40910,39810,40180,38450,39060,39160,-1850,-1750,24750,22060
20150709,39060,39160,39460,41320,39460,41140,40930,1980,1770,13430,20150
20150710,41140,40930,41660,41660,41060,41160,41360,230,430,10940,18430
20150713,41160,41360,42310,42310,40700,40900,40840,-460,-520,8380,14570
20150714,40900,40840,41080,41340,41060,41120,41180,280,340,6810,10540
20150715,41120,41180,41200,41420,41000,41200,41330,20,150,3720,8820
cu1508,20150105,44870,44760,44660,44660,44120,44250,44230,-510,-530,244,4320
20150106,44250,44230,43380,43880,43100,43800,43750,-430,-480,1234,5068
20150107,43800,43750,43670,43810,43330,43420,43560,-330,-190,2070,6456
20150108,43420,43560,43500,43700,43430,43510,43570,-50,10,662,6668
20150109,43510,43570,43730,43730,43170,43200,43330,-370,-240,1026,6794
20150112,43200,43330,43240,43270,42650,42770,43080,-560,-250,1860,6722
20150113,42770,43080,42100,42480,41670,41710,42150,-1370,-930,2056,7532
20150114,41710,42150,40650,41400,40040,40040,40730,-2110,-1420,2820,9008
20150115,40040,40730,39890,40600,39270,40410,39960,-320,-770,5610,9576
20150116,40410,39960,40670,40980,39950,40360,40250,400,290,2514,10728
20150119,40360,40250,40190,41230,40190,41190,40820,940,570,1288,10678
20150120,41190,40820,40930,41180,40550,40800,40940,-20,120,2152,10890
20150121,40800,40940,41000,41130,40820,40850,40980,-90,40,734,11068
20150122,40850,40980,40720,41550,40530,41110,41130,130,150,1008,11158
20150123,41110,41130,41070,41350,40140,40460,40480,-670,-650,2508,12360
20150126,40460,40480,40210,40210,38520,39060,39370,-1420,-1110,4498,13938
20150127,39060,39370,39590,40530,39510,40120,40050,750,680,1680,13706
20150128,40120,40050,39900,39980,39030,39380,39360,-670,-690,2366,14278
20150129,39380,39360,39450,39450,38920,38930,39110,-430,-250,2164,14692
20150130,38930,39110,38810,39080,38520,38660,38750,-450,-360,2216,15794
20150202,38660,38750,39140,40000,38920,39940,39530,1190,780,2020,15632
20150203,39940,39530,39840,40530,39760,40470,40200,940,670,3788,14436
20150204,40470,40200,40880,41660,40510,40830,41110,630,910,2614,14814
20150205,40830,41110,41090,41170,40580,40580,40760,-530,-350,2072,14918
20150206,40580,40760,40480,41350,40440,41290,41040,530,280,1192,15178
20150209,41290,41040,41120,41210,40650,40850,40860,-190,-180,1288,15502
20150210,40850,40860,40770,41060,40690,40920,40910,60,50,1268,15544
20150211,40920,40910,40630,40810,40420,40640,40620,-270,-290,2998,15600
20150212,40640,40620,40780,40790,40420,40680,40570,60,-50,1936,16056
20150213,40680,40570,40820,41840,40820,41700,41510,1130,940,2144,15824
20150216,41700,41510,41630,41830,41330,41830,41510,320,0,1620,16106
20150217,41830,41510,41510,41870,41330,41770,41700,260,190,1346,16352
20150225,41770,41700,41780,41910,41560,41670,41650,-30,-50,540,16420
20150226,41670,41650,41790,42300,41570,42250,41830,600,180,3492,17346
20150227,42250,41830,42500,42640,42200,42490,42430,660,600,2028,17818
20150302,42490,42430,42380,43000,42130,42970,42670,540,240,3350,17710
20150303,42970,42670,42700,42980,42200,42280,42470,-390,-200,3182,18542
20150304,42280,42470,42210,42310,41890,42230,42200,-240,-270,2320,18672
20150305,42230,42200,42380,42380,41910,42270,42210,70,10,2264,19150
20150306,42270,42210,42180,42480,41890,42020,42150,-190,-60,3830,19862
20150309,42020,42150,42100,42100,41420,42020,41660,-130,-490,8032,22314
20150310,42020,41660,41930,42490,41900,41970,42190,310,530,3934,22856
20150311,41970,42190,41860,42050,41660,41850,41820,-340,-370,3928,23878
20150312,41850,41820,41760,42460,41560,42430,41970,610,150,5654,24110
20150313,42430,41970,42500,43030,42380,42900,42670,930,700,6718,23566
20150316,42900,42670,42770,42930,42480,42900,42680,230,10,4300,24062
20150317,42900,42680,42710,43060,42410,42550,42750,-130,70,8448,25718
20150318,42550,42750,42200,42540,41650,41680,42160,-1070,-590,15140,29006
20150319,41680,42160,41500,42050,41120,41750,41660,-410,-500,12290,30670
20150320,41750,41660,42230,42580,41880,42090,42210,430,550,9570,30890
20150323,42090,42210,42510,44120,42490,43700,43380,1490,1170,28390,32380
20150324,43700,43380,43740,44580,43600,43820,43950,440,570,23804,36124
20150325,43820,43950,43910,43950,43400,43670,43660,-280,-290,14930,38514
20150326,43670,43660,43740,43920,43600,43770,43760,110,100,12808,39050
20150327,43770,43760,43920,44250,43280,43650,43730,-110,-30,20238,43786
20150330,43650,43730,43650,43900,43310,43740,43560,10,-170,17222,44512
20150331,43740,43560,43750,43980,43290,43290,43680,-270,120,16396,46402
20150401,43290,43680,43350,43640,43110,43220,43360,-460,-320,18448,48794
20150402,43220,43360,43090,43580,43020,43460,43340,100,-20,20010,48848
20150403,43460,43340,43250,43360,43070,43160,43230,-180,-110,15958,50658
20150407,43160,43230,43200,43460,43200,43390,43360,160,130,10812,51706
20150408,43390,43360,43410,43690,43260,43370,43450,10,90,20734,54748
20150409,43370,43450,43320,43460,42970,43220,43130,-230,-320,20276,57974
20150410,43220,43130,43290,43450,43010,43380,43250,250,120,20848,60674
20150413,43380,43250,43260,43850,43260,43560,43520,310,270,24232,61398
20150414,43560,43520,43500,43580,42440,42710,42910,-810,-610,40412,67646
20150415,42710,42910,42690,43030,42440,42840,42770,-70,-140,19694,68526
20150416,42840,42770,42670,43370,42600,43200,43060,430,290,25582,68412
20150417,43200,43060,43510,43780,43450,43640,43590,580,530,31532,69464
20150420,43640,43590,43490,43920,43360,43700,43700,110,110,27640,74012
20150421,43700,43700,43260,43300,43020,43190,43190,-510,-510,33434,77662
20150422,43190,43190,42960,43230,42880,43140,43060,-50,-130,27358,80098
20150423,43140,43060,43030,43190,42480,42790,42820,-270,-240,46418,86190
20150424,42790,42820,42990,43240,42940,43130,43080,310,260,38248,85662
20150427,43130,43080,43420,43890,43340,43650,43600,570,520,55538,90416
20150428,43650,43600,43710,44020,43500,43680,43730,80,130,56134,97852
20150429,43680,43730,43730,43970,43550,43650,43720,-80,-10,49700,99416
20150430,43650,43720,43690,44200,43670,44180,43980,460,260,70076,103720
20150504,44180,43980,45200,45720,45040,45640,45360,1660,1380,81340,109116
20150505,45640,45360,45750,45830,45450,45650,45600,290,240,66826,117444
20150506,45650,45600,45760,46270,45740,46030,46000,430,400,104956,123072
20150507,46030,46000,46050,46080,45560,45740,45790,-260,-210,70672,128798
20150508,45740,45790,45900,45960,45700,45920,45810,130,20,63586,131292
20150511,45920,45810,45770,45950,45500,45710,45700,-100,-110,72496,132762
20150512,45710,45700,45630,45860,45530,45760,45680,60,-20,56900,135250
20150513,45760,45680,46000,46320,45840,46200,46010,520,330,81840,138830
20150514,46200,46010,46110,46220,45720,46000,45940,-10,-70,78860,141320
20150515,46000,45940,46000,46070,45730,46010,45890,70,-50,67074,141128
20150518,46010,45890,45850,46150,45720,46080,45940,190,50,76748,145330
20150519,46080,45940,45930,45980,45650,45660,45780,-280,-160,84556,151298
20150520,45660,45780,45300,45330,44520,44670,44860,-1110,-920,176150,170010
20150521,44670,44860,44750,45110,44610,45030,44910,170,50,114362,172968
20150522,45030,44910,44980,45180,44940,45020,45060,110,150,94614,186404
20150525,45020,45060,44480,44640,44430,44620,44540,-440,-520,110772,197058
20150526,44620,44540,44690,45060,44350,44400,44720,-140,180,199788,226338
20150527,44400,44720,44300,44350,42030,44300,44190,-420,-530,236238,249528
20150528,44300,44190,44080,44360,43950,44250,44130,60,-60,281792,253868
20150529,44250,44130,44130,44320,43970,44300,44160,170,30,208388,256104
20150601,44300,44160,44010,44140,43570,43650,43810,-510,-350,271036,268494
20150602,43650,43810,43550,43820,43410,43690,43610,-120,-200,236858,269474
20150603,43690,43610,43730,43870,43490,43530,43740,-80,130,228746,270146
20150604,43530,43740,43600,43660,43330,43400,43490,-340,-250,240492,269388
20150605,43400,43490,43310,43440,42740,42810,43040,-680,-450,328872,274048
20150608,42810,43040,42930,43250,42790,43160,43080,120,40,242348,265440
20150609,43160,43080,43100,43350,43090,43250,43200,170,120,162420,255718
20150610,43250,43200,43320,43520,43190,43370,43370,170,170,169556,256578
20150611,43370,43370,43630,43760,43160,43230,43560,-140,190,200008,252002
20150612,43230,43560,42990,43060,42480,42490,42720,-1070,-840,312702,268302
20150615,42490,42720,42590,42820,42140,42210,42520,-510,-200,217688,271054
20150616,42210,42520,42120,42380,42000,42150,42170,-370,-350,225950,267800
20150617,42150,42170,42050,42080,41730,41810,41860,-360,-310,205258,261768
20150618,41810,41860,41940,42240,41620,42080,41920,220,60,213452,251110
20150619,42080,41920,41950,42080,41780,41820,41900,-100,-20,231946,241718
20150623,41820,41900,41610,41990,41580,41910,41860,10,-40,110098,237256
20150624,41910,41860,41890,42290,41770,42190,42030,330,170,233332,225792
20150625,42190,42030,42290,42360,41000,41920,41970,-110,-60,312490,209464
20150626,41920,41970,41900,42590,41670,42300,42010,330,40,259030,186054
20150629,42300,42010,42150,42770,42020,42680,42290,670,280,349244,148378
20150630,42680,42290,42490,42600,42150,42240,42370,-50,80,220640,136088
20150701,42240,42370,42100,42430,41720,42110,42090,-260,-280,146552,128750
20150702,42110,42090,42160,42620,42030,42340,42330,250,240,97868,123422
20150703,42340,42330,42390,42590,42250,42510,42440,180,110,84066,118864
20150706,42510,42440,42450,42450,40310,40940,41410,-1500,-1030,157592,114784
20150707,40940,41410,41010,41070,39960,40030,40590,-1380,-820,131316,115236
20150708,40030,40590,39850,39940,38150,38400,38830,-2190,-1760,302268,99974
20150709,38400,38830,39000,41060,38970,40760,40370,1930,1540,154652,92212
20150710,40760,40370,41200,41490,40550,40690,41020,320,650,89966,90984
20150713,40690,41020,40740,40920,40120,40450,40450,-570,-570,65884,90052
20150714,40450,40450,40770,40920,40580,40610,40750,160,300,42918,90632
20150715,40610,40750,40610,41100,40420,41100,40830,350,80,39992,90114
20150716,41100,40830,41050,41060,40490,41010,40770,180,-60,50520,84062
20150717,41010,40770,40780,40930,40660,40820,40780,50,10,35690,80552
20150720,40820,40780,40490,40590,39930,40150,40190,-630,-590,58990,75606
20150721,40150,40190,40100,40530,39980,40360,40300,170,110,35418,73974
20150722,40360,40300,40220,40360,39400,39460,39920,-840,-380,55050,72152
20150723,39460,39920,39440,39770,39050,39500,39410,-420,-510,44184,68902
20150724,39500,39410,39480,39550,38300,38420,38700,-990,-710,62348,69478
20150727,38420,38700,38700,39160,38460,38640,38830,-60,130,45878,65038
20150728,38640,38830,38380,38700,38180,38640,38520,-190,-310,43568,63706
20150729,38640,38520,38780,39950,38750,39390,39400,870,880,50472,58772
20150730,39390,39400,39320,39520,39010,39130,39220,-270,-180,34064,54610
20150731,39130,39220,38920,39100,38730,38830,38910,-390,-310,29052,50354
20150803,38830,38910,38880,39190,38460,38530,38690,-380,-220,18224,45720
20150804,38530,38690,38530,38760,38290,38730,38480,40,-210,19660,41910
20150805,38730,38480,38880,38900,38450,38600,38550,120,70,13470,39040
20150806,38600,38550,38620,38640,38400,38580,38550,30,0,12580,36820
20150807,38580,38550,38400,38600,38000,38520,38300,-30,-250,18530,32950
20150810,38520,38300,38300,38620,38150,38530,38340,230,40,13690,30030
20150811,38530,38340,38560,39960,38560,39420,39480,1080,1140,23210,25760
20150812,39420,39480,39010,39650,38960,39580,39290,100,-190,17190,21330
20150813,39580,39290,39880,40150,39500,39700,39710,410,420,10420,16510
20150814,39700,39710,39540,39730,38990,39430,39560,-280,-150,5840,13570
20150817,39430,39560,38580,39650,38580,39210,39190,-350,-370,4290,11580
cu1509,20150105,44810,44700,44570,44570,44060,44180,44290,-520,-410,122,3454
20150106,44180,44290,43300,43820,43230,43750,43690,-540,-600,444,3626
20150107,43750,43690,43710,43710,43290,43320,43550,-370,-140,2008,4660
20150108,43320,43550,43390,43620,43370,43440,43500,-110,-50,992,5100
20150109,43440,43500,43530,43630,43110,43120,43280,-380,-220,656,5260
20150112,43120,43280,43090,43160,42560,42650,42940,-630,-340,778,5416
20150113,42650,42940,42140,42380,41640,41650,41970,-1290,-970,2568,6866
20150114,41650,41970,41070,41330,39870,39870,40290,-2100,-1680,2582,7918
20150115,39870,40290,39390,40580,39180,40370,39860,80,-430,3970,8794
20150116,40370,39860,40800,40980,39880,40340,40250,480,390,1106,9156
20150119,40340,40250,40140,41130,40030,41100,40820,850,570,582,9078
20150120,41100,40820,40670,41120,40500,40790,40850,-30,30,2418,8630
20150121,40790,40850,40920,41060,40800,40870,40900,20,50,1002,8574
20150122,40870,40900,40740,41540,40520,41110,41080,210,180,814,8610
20150123,41110,41080,41080,41260,40130,40450,40530,-630,-550,1236,8938
20150126,40450,40530,40180,40190,38600,39100,39450,-1430,-1080,2938,10214
20150127,39100,39450,39530,40530,39470,40100,40040,650,590,1304,10180
20150128,40100,40040,39970,39980,39000,39350,39400,-690,-640,3036,10066
20150129,39350,39400,39470,39500,38860,38910,39070,-490,-330,1806,9804
20150130,38910,39070,38830,39080,38400,38660,38730,-410,-340,1136,9874
20150202,38660,38730,39100,39940,38890,39940,39450,1210,720,1128,9490
20150203,39940,39450,39890,40500,39750,40440,40240,990,790,1612,8876
20150204,40440,40240,40880,41610,40490,40790,41040,550,800,1384,9198
20150205,40790,41040,41070,41130,40580,40600,40780,-440,-260,1290,9132
20150206,40600,40780,40480,41350,40470,41270,40940,490,160,756,9044
20150209,41270,40940,41190,41230,40620,40880,40850,-60,-90,650,9100
20150210,40880,40850,40710,41050,40640,40870,40860,20,10,1120,9600
20150211,40870,40860,40550,40800,40410,40650,40600,-210,-260,820,9832
20150212,40650,40600,40800,40800,40410,40690,40560,90,-40,598,9852
20150213,40690,40560,40890,41830,40890,41720,41550,1160,990,1042,9892
20150216,41720,41550,41620,41810,41320,41810,41520,260,-30,806,10128
20150217,41810,41520,41610,41840,41560,41750,41710,230,190,1166,10368
20150225,41750,41710,41750,41810,41560,41660,41640,-50,-70,1570,11006
20150226,41660,41640,41700,42300,41560,42220,41910,580,270,1498,11176
20150227,42220,41910,42560,42600,42180,42450,42390,540,480,1330,11518
20150302,42450,42390,42370,42980,42120,42900,42530,510,140,3386,12084
20150303,42900,42530,42650,42920,42180,42280,42430,-250,-100,1442,12178
20150304,42280,42430,42210,42270,41860,42180,42090,-250,-340,1490,12260
20150305,42180,42090,42280,42300,41900,42240,42180,150,90,752,12208
20150306,42240,42180,42190,42480,41880,42000,42140,-180,-40,1338,12388
20150309,42000,42140,42020,42070,41430,41990,41690,-150,-450,2112,12894
20150310,41990,41690,42020,42470,41930,41980,42190,290,500,1634,13196
20150311,41980,42190,41800,42060,41650,41810,41850,-380,-340,2528,13970
20150312,41810,41850,41660,42420,41550,42400,41920,550,70,1070,13914
20150313,42400,41920,42580,43060,42410,42900,42750,980,830,3888,14142
20150316,42900,42750,42800,42960,42500,42960,42700,210,-50,2518,14268
20150317,42960,42700,42760,43080,42460,42630,42770,-70,70,4684,15072
20150318,42630,42770,42180,42640,41740,41740,42250,-1030,-520,5318,15856
20150319,41740,42250,41500,42140,41170,41810,41730,-440,-520,3752,16106
20150320,41810,41730,42100,42630,41950,42160,42250,430,520,2824,16040
20150323,42160,42250,42590,44160,42530,43730,43350,1480,1100,14648,16790
20150324,43730,43350,43720,44500,43630,43830,43940,480,590,9670,18900
20150325,43830,43940,43830,43950,43410,43640,43690,-300,-250,3808,19714
20150326,43640,43690,43690,43920,43610,43760,43750,70,60,4476,20156
20150327,43760,43750,43940,44230,43270,43660,43770,-90,20,9094,22230
20150330,43660,43770,43560,43890,43300,43760,43550,-10,-220,5254,22814
20150331,43760,43550,43730,43980,43290,43290,43690,-260,140,5240,22956
20150401,43290,43690,43330,43640,43140,43240,43360,-450,-330,8620,23878
20150402,43240,43360,43000,43580,43000,43420,43360,60,0,10734,23776
20150403,43420,43360,43230,43350,43070,43150,43230,-210,-130,6624,24744
20150407,43150,43230,43280,43450,43230,43380,43350,150,120,2610,24764
20150408,43380,43350,43440,43660,43250,43370,43430,20,80,6740,25948
20150409,43370,43430,43300,43430,42960,43220,43130,-210,-300,5238,26978
20150410,43220,43130,43270,43450,43020,43380,43260,250,130,5012,27750
20150413,43380,43260,43370,43830,43300,43500,43500,240,240,11052,29486
20150414,43500,43500,43600,43600,42440,42680,42890,-820,-610,15366,32886
20150415,42680,42890,42680,42980,42400,42830,42740,-60,-150,7672,33932
20150416,42830,42740,42660,43340,42590,43170,43080,430,340,8704,34130
20150417,43170,43080,43650,43730,43410,43500,43550,420,470,16156,36442
20150420,43500,43550,43410,43860,43350,43650,43670,100,120,13640,38096
20150421,43650,43670,43240,43250,42980,43150,43160,-520,-510,17926,40984
20150422,43150,43160,43050,43160,42850,43080,43010,-80,-150,12066,42814
20150423,43080,43010,42990,43120,42430,42720,42780,-290,-230,19978,44848
20150424,42720,42780,42900,43210,42880,43090,43070,310,290,19752,43342
20150427,43090,43070,43550,43830,43280,43590,43540,520,470,23136,42686
20150428,43590,43540,43620,43940,43440,43610,43660,70,120,15214,44290
20150429,43610,43660,43630,43900,43490,43600,43670,-60,10,19708,45978
20150430,43600,43670,43690,44110,43610,44080,43910,410,240,23578,48150
20150504,44080,43910,45020,45660,44940,45580,45300,1670,1390,38224,55814
20150505,45580,45300,45740,45790,45390,45570,45540,270,240,24086,57132
20150506,45570,45540,45780,46200,45680,46000,45930,460,390,36206,59764
20150507,46000,45930,45980,46000,45500,45660,45700,-270,-230,20472,63250
20150508,45660,45700,45740,45900,45630,45850,45750,150,50,19340,63746
20150511,45850,45750,45700,45870,45450,45650,45650,-100,-100,24580,64628
20150512,45650,45650,45600,45820,45480,45710,45630,60,-20,15944,66268
20150513,45710,45630,45910,46270,45770,46200,45960,570,330,22306,68480
20150514,46200,45960,46100,46180,45670,45970,45890,10,-70,24244,70158
20150515,45970,45890,46020,46030,45690,46000,45840,110,-50,15768,71738
20150518,46000,45840,45760,46110,45690,46000,45920,160,80,22848,73700
20150519,46000,45920,45890,45930,45600,45600,45760,-320,-160,23784,75172
20150520,45600,45760,45260,45270,44500,44640,44830,-1120,-930,51060,79298
20150521,44640,44830,44640,45070,44560,44990,44890,160,60,28800,80370
20150522,44990,44890,44940,45140,44910,44950,45020,60,130,24704,81964
20150525,44950,45020,44400,44590,44360,44570,44500,-450,-520,32422,84378
20150526,44570,44500,44620,45010,44310,44360,44670,-140,170,45910,91716
20150527,44360,44670,44260,44310,43780,44250,44130,-420,-540,48710,95536
20150528,44250,44130,44010,44310,43850,44160,44050,30,-80,56380,102464
20150529,44160,44050,44080,44260,43880,44260,44100,210,50,44058,103860
20150601,44260,44100,43980,44080,43520,43590,43740,-510,-360,52262,108902
20150602,43590,43740,43470,43760,43370,43640,43560,-100,-180,48682,112320
20150603,43640,43560,43650,43820,43450,43480,43690,-80,130,42714,114054
20150604,43480,43690,43530,43610,43280,43400,43430,-290,-260,52868,118634
20150605,43400,43430,43280,43400,42710,42750,42970,-680,-460,74472,128036
20150608,42750,42970,42840,43210,42750,43150,43050,180,80,57992,132466
20150609,43150,43050,43090,43280,43050,43190,43150,140,100,40142,136942
20150610,43190,43150,43230,43450,43140,43290,43300,140,150,43680,137422
20150611,43290,43300,43550,43690,43120,43150,43490,-150,190,57408,138306
20150612,43150,43490,42930,43010,42400,42400,42660,-1090,-830,89000,148150
20150615,42400,42660,42480,42750,42070,42100,42450,-560,-210,69690,150070
20150616,42100,42450,42050,42320,41930,42070,42110,-380,-340,82872,158176
20150617,42070,42110,42000,42010,41650,41710,41780,-400,-330,76576,167308
20150618,41710,41780,41890,42150,41530,42010,41870,230,90,87234,168200
20150619,42010,41870,41910,42000,41700,41720,41820,-150,-50,103358,176948
20150623,41720,41820,41560,41920,41500,41820,41790,0,-30,70700,184250
20150624,41820,41790,41800,42180,41680,42090,41920,300,130,118918,203172
20150625,42090,41920,42180,42240,41320,41810,41860,-110,-60,152702,207570
20150626,41810,41860,41800,42500,41560,42240,41930,380,70,204164,212188
20150629,42240,41930,42050,42620,41920,42500,42180,570,250,276048,209702
20150630,42500,42180,42340,42470,41990,42090,42210,-90,30,257752,231696
20150701,42090,42210,41950,42300,41560,41970,41950,-240,-260,323088,223404
20150702,41970,41950,41980,42490,41890,42200,42190,250,240,218806,219912
20150703,42200,42190,42290,42470,42120,42380,42310,190,120,225938,221676
20150706,42380,42310,42300,42320,40100,40730,41220,-1580,-1090,490330,257318
20150707,40730,41220,40730,40860,39690,39780,40390,-1440,-830,518564,271380
20150708,39780,40390,39510,39600,37960,38070,38550,-2320,-1840,1262028,285910
20150709,38070,38550,38650,40800,38620,40470,40060,1920,1510,894496,232758
20150710,40470,40060,40870,41220,40260,40360,40720,300,660,650284,235950
20150713,40360,40720,40410,40630,39740,40130,40180,-590,-540,379240,240758
20150714,40130,40180,40480,40610,40250,40280,40430,100,250,296534,233130
20150715,40280,40430,40310,40750,40130,40750,40460,320,30,289106,228616
20150716,40750,40460,40670,40740,40150,40680,40430,220,-30,374544,224794
20150717,40680,40430,40430,40650,40360,40480,40470,50,40,217696,222354
20150720,40480,40470,40070,40290,39590,39800,39940,-670,-530,375168,230994
20150721,39800,39940,39800,40230,39640,40080,39980,140,40,268612,223900
20150722,40080,39980,39850,40110,39070,39150,39650,-830,-330,338470,235744
20150723,39150,39650,39150,39490,38710,39180,39110,-470,-540,380740,239418
20150724,39180,39110,39070,39230,37870,38050,38470,-1060,-640,484414,235550
20150727,38050,38470,38350,38800,38080,38310,38450,-160,-20,362436,210644
20150728,38310,38450,38030,38420,37790,38330,38140,-120,-310,322726,195954
20150729,38330,38140,38490,39690,38410,39090,39040,950,900,327974,172790
20150730,39090,39040,39060,39290,38720,38840,38950,-200,-90,222100,167434
20150731,38840,38950,38610,38870,38470,38530,38650,-420,-300,170520,158448
20150803,38530,38650,38580,38950,38130,38180,38500,-470,-150,173304,153474
20150804,38180,38500,38140,38560,37980,38490,38260,-10,-240,140020,146932
20150805,38490,38260,38660,38720,38170,38380,38400,120,140,80410,145884
20150806,38380,38400,38470,38470,38120,38330,38290,-70,-110,76802,142136
20150807,38330,38290,38150,38370,37660,38280,38030,-10,-260,108008,142250
20150810,38280,38030,38000,38400,37870,38280,38130,250,100,76598,139364
20150811,38280,38130,38300,39850,38290,39250,39190,1120,1060,161122,127598
20150812,39250,39190,38880,39610,38750,39480,39120,290,-70,128176,121024
20150813,39480,39120,39690,40080,39380,39670,39710,550,590,94630,115454
20150814,39670,39710,39650,39690,39380,39410,39530,-300,-180,54742,112224
20150817,39410,39530,39420,39660,39120,39300,39310,-230,-220,52590,111134
20150818,39300,39310,39000,39270,38980,38990,39130,-320,-180,51740,108074
20150819,38990,39130,38870,38970,38390,38930,38700,-200,-430,63314,102778
20150820,38930,38700,38660,38990,38540,38820,38760,120,60,46022,99200
20150821,38820,38760,39180,39380,39030,39090,39160,330,400,54576,91896
20150824,39090,39160,39060,39090,37880,38450,38500,-710,-660,75536,90730
20150825,38450,38500,38240,39240,38080,38950,38840,450,340,75268,83928
20150826,38950,38840,39500,39770,38930,38980,39310,140,470,59998,76722
20150827,38980,39310,38790,39140,38400,38970,38880,-340,-430,46056,69480
20150828,38970,38880,39010,39870,38960,39370,39440,490,560,47186,60240
20150831,39370,39440,39360,39730,39190,39350,39400,-90,-40,36700,51650
20150901,39350,39400,39210,39640,39100,39370,39390,-30,-10,20040,48280
20150902,39370,39390,39200,39460,39150,39290,39240,-100,-150,17190,45260
20150907,39290,39240,39260,39560,39260,39540,39440,300,200,18500,42750
20150908,39540,39440,39610,39640,39420,39610,39550,170,110,20290,39220
20150909,39610,39550,40200,41500,40120,41190,40870,1640,1320,29770,28110
20150910,41190,40870,41250,41260,40820,41080,40970,210,100,21110,22430
20150911,41080,40970,41150,41300,41090,41170,41160,200,190,10610,17960
20150914,41170,41160,40920,41200,40700,40770,40980,-390,-180,9030,13250
20150915,40770,40980,40700,40710,40280,40280,40620,-700,-360,6060,9970
cu1510,20150105,44750,44540,44410,44410,43940,44030,44080,-510,-460,58,4092
20150106,44030,44080,43060,43770,43030,43720,43550,-360,-530,170,4158
20150107,43720,43550,43620,43620,43260,43300,43430,-250,-120,144,4216
20150108,43300,43430,43400,43540,43250,43350,43430,-80,0,146,4248
20150109,43350,43430,43450,43530,43060,43100,43230,-330,-200,380,4424
20150112,43100,43230,43020,43140,42500,42600,42850,-630,-380,212,4500
20150113,42600,42850,42150,42320,41600,41610,41970,-1240,-880,574,4590
20150114,41610,41970,40420,41260,39870,39870,40240,-2100,-1730,742,5002
20150115,39870,40240,39390,40510,39160,40300,40020,60,-220,2494,5814
20150116,40300,40020,40550,40950,39880,40320,40210,300,190,814,6162
20150119,40320,40210,40370,41080,40340,41080,40810,870,600,234,6134
20150120,41080,40810,40600,41070,40500,40780,40830,-30,20,262,6142
20150121,40780,40830,40960,41050,40760,40860,40890,30,60,180,6130
20150122,40860,40890,40660,41500,40510,41100,41040,210,150,268,6172
20150123,41100,41040,41150,41150,40130,40350,40500,-690,-540,552,6140
20150126,40350,40500,40070,40130,38570,39150,39230,-1350,-1270,504,6280
20150127,39150,39230,39780,40500,39780,40110,40080,880,850,354,6184
20150128,40110,40080,39950,39950,39050,39310,39350,-770,-730,396,6324
20150129,39310,39350,39300,39310,38860,38880,39090,-470,-260,1378,6724
20150130,38880,39090,38850,39010,38480,38620,38700,-470,-390,370,6820
20150202,38620,38700,38880,39900,38880,39880,39290,1180,590,278,6802
20150203,39880,39290,39820,40460,39810,40420,40160,1130,870,588,6942
20150204,40420,40160,40720,41560,40510,40770,40980,610,820,450,6860
20150205,40770,40980,40930,41230,40570,40650,40750,-330,-230,254,6910
20150206,40650,40750,40660,41280,40620,41280,41120,530,370,290,6878
20150209,41280,41120,41210,41210,40670,40860,40850,-260,-270,420,7078
20150210,40860,40850,40730,41000,40620,40890,40850,40,0,128,7096
20150211,40890,40850,40660,40740,40450,40660,40600,-190,-250,186,7088
20150212,40660,40600,40750,40770,40400,40640,40530,40,-70,140,7048
20150213,40640,40530,40980,41820,40870,41700,41500,1170,970,420,7030
20150216,41700,41500,41650,41810,41300,41810,41500,310,0,160,7072
20150217,41810,41500,43070,43070,41600,41790,41720,290,220,446,7248
20150225,41790,41720,41830,41830,41600,41660,41620,-60,-100,158,7254
20150226,41660,41620,43040,43040,41550,42230,42030,610,410,378,7358
20150227,42230,42030,42510,42630,42170,42460,42410,430,380,580,7346
20150302,42460,42410,42300,42970,42130,42970,42590,560,180,1062,7204
20150303,42970,42590,42620,42860,42200,42200,42460,-390,-130,454,7146
20150304,42200,42460,42000,42280,42000,42200,42220,-260,-240,236,7292
20150305,42200,42220,42340,42340,41900,42270,42200,50,-20,128,7280
20150306,42270,42200,42450,42450,41890,42000,42130,-200,-70,1014,7298
20150309,42000,42130,41970,42070,41460,42000,41760,-130,-370,1226,7458
20150310,42000,41760,42000,42460,41980,42010,42170,250,410,722,7684
20150311,42010,42170,41640,42020,41630,41870,41900,-300,-270,808,8042
20150312,41870,41900,41680,42450,41630,42410,42010,510,110,626,7972
20150313,42410,42010,42620,43080,42480,42950,42720,940,710,1668,7792
20150316,42950,42720,42790,43000,42570,43000,42730,280,10,1778,7862
20150317,43000,42730,42750,43130,42520,42710,42780,-20,50,2828,7868
20150318,42710,42780,42500,42610,41800,41800,42310,-980,-470,2818,8082
20150319,41800,42310,41640,42280,41240,41900,41830,-410,-480,1424,8096
20150320,41900,41830,42250,42680,42010,42190,42370,360,540,1218,8082
20150323,42190,42370,42630,44210,42600,43780,43410,1410,1040,2124,7754
20150324,43780,43410,43730,44770,43700,43880,44000,470,590,1926,7110
20150325,43880,44000,43830,43890,43500,43680,43700,-320,-300,674,6838
20150326,43680,43700,43750,43910,43650,43780,43750,80,50,1432,6766
20150327,43780,43750,43900,44200,43300,43650,43630,-100,-120,910,6890
20150330,43650,43630,43620,43870,43320,43750,43590,120,-40,1050,7140
20150331,43750,43590,43770,43930,43310,43340,43690,-250,100,866,7478
20150401,43340,43690,43350,43590,43150,43230,43430,-460,-260,1480,7872
20150402,43230,43430,43200,43600,43100,43460,43470,30,40,672,8230
20150403,43460,43470,43360,43360,43090,43160,43270,-310,-200,552,8110
20150407,43160,43270,43370,43480,43200,43420,43370,150,100,254,8092
20150408,43420,43370,43510,43650,43260,43360,43460,-10,90,1108,8458
20150409,43360,43460,43300,43440,42960,43220,43150,-240,-310,414,8512
20150410,43220,43150,43260,43400,43030,43380,43240,230,90,474,8532
20150413,43380,43240,43400,43820,43300,43520,43490,280,250,782,8778
20150414,43520,43490,43480,43530,42460,42680,42760,-810,-730,3130,10206
20150415,42680,42760,42560,42920,42420,42790,42730,30,-30,1300,10542
20150416,42790,42730,42620,43320,42570,43140,43110,410,380,588,10520
20150417,43140,43110,43590,43740,43440,43490,43560,380,450,816,10526
20150420,43490,43560,43380,43860,43350,43680,43700,120,140,998,10808
20150421,43680,43700,43090,43240,42810,43160,43130,-540,-570,1826,11560
20150422,43160,43130,42940,43120,42860,43120,43020,-10,-110,1718,12064
20150423,43120,43020,43050,43080,42410,42730,42710,-290,-310,6448,13842
20150424,42730,42710,42820,43170,42820,43040,43030,330,320,2834,13560
20150427,43040,43030,43420,43800,43260,43530,43500,500,470,4398,14660
20150428,43530,43500,43630,43910,43390,43550,43600,50,100,4746,14836
20150429,43550,43600,43640,43850,43450,43520,43580,-80,-20,5510,16314
20150430,43520,43580,43650,44060,43600,44020,43850,440,270,4466,16130
20150504,44020,43850,45300,45640,44900,45580,45230,1730,1380,7768,16754
20150505,45580,45230,45690,45750,45340,45500,45500,270,270,4614,16704
20150506,45500,45500,45680,46140,45650,45920,45910,420,410,8980,16534
20150507,45920,45910,45880,45950,45470,45650,45660,-260,-250,4058,16680
20150508,45650,45660,45700,45850,45590,45800,45710,140,50,5710,18012
20150511,45800,45710,45670,45830,45430,45630,45600,-80,-110,5340,19128
20150512,45630,45600,45550,45780,45450,45690,45590,90,-10,4544,20488
20150513,45690,45590,45940,46240,45770,46110,45960,520,370,6234,21618
20150514,46110,45960,46090,46160,45650,45870,45860,-90,-100,3748,21804
20150515,45870,45860,45910,46010,45680,45990,45820,130,-40,2746,22078
20150518,45990,45820,45770,46090,45690,46050,45920,230,100,4724,22400
20150519,46050,45920,45900,45930,45620,45630,45760,-290,-160,7452,24906
20150520,45630,45760,45210,45280,44480,44620,44800,-1140,-960,14032,25372
20150521,44620,44800,44740,45050,44540,44970,44890,170,90,5860,26200
20150522,44970,44890,44920,45110,44900,45000,44980,110,90,6056,26786
20150525,45000,44980,44430,44580,44390,44570,44480,-410,-500,7374,28102
20150526,44570,44480,44630,45010,44280,44350,44660,-130,180,14130,28902
20150527,44350,44660,44250,44250,43910,44210,44100,-450,-560,10532,30844
20150528,44210,44100,44050,44270,42800,44140,44030,40,-70,11498,31742
20150529,44140,44030,44040,44210,43850,44210,44060,180,30,10688,31544
20150601,44210,44060,43920,44040,43460,43570,43660,-490,-400,13894,32624
20150602,43570,43660,43590,43740,43350,43610,43520,-50,-140,12364,32044
20150603,43610,43520,43700,43800,43430,43470,43670,-50,150,10470,33274
20150604,43470,43670,43540,43600,43280,43330,43420,-340,-250,13422,34926
20150605,43330,43420,43240,43370,42700,42740,42950,-680,-470,19374,38316
20150608,42740,42950,42830,43190,42730,43130,43050,180,100,12652,37472
20150609,43130,43050,43090,43270,43040,43180,43150,130,100,6912,38144
20150610,43180,43150,43250,43440,43130,43270,43280,120,130,9506,38618
20150611,43270,43280,43540,43660,43100,43140,43420,-140,140,10092,39266
20150612,43140,43420,42970,42990,42410,42430,42640,-990,-780,17258,42996
20150615,42430,42640,42550,42750,42030,42080,42340,-560,-300,18220,44040
20150616,42080,42340,42010,42280,41900,42070,42100,-270,-240,18362,46954
20150617,42070,42100,41960,41970,41600,41680,41750,-420,-350,17038,50290
20150618,41680,41750,41760,42100,41510,41980,41890,230,140,23924,54522
20150619,41980,41890,41820,41960,41650,41730,41770,-160,-120,17994,55108
20150623,41730,41770,41560,41880,41480,41800,41760,30,-10,18866,58142
20150624,41800,41760,41800,42150,41650,42060,41880,300,120,17660,59192
20150625,42060,41880,42110,42220,41310,41740,41800,-140,-80,34724,63546
20150626,41740,41800,41740,42440,41530,42200,41920,400,120,38102,63562
20150629,42200,41920,42010,42530,41890,42460,42120,540,200,50270,64386
20150630,42460,42120,42270,42390,41920,42030,42140,-90,20,31928,66584
20150701,42030,42140,41950,42190,41480,41870,41880,-270,-260,41558,70232
20150702,41870,41880,41900,42380,41800,42120,42100,240,220,31634,71264
20150703,42120,42100,42190,42380,42030,42290,42210,190,110,34166,72632
20150706,42290,42210,42160,42220,39940,40620,41020,-1590,-1190,121444,90030
20150707,40620,41020,40630,40720,39560,39660,40210,-1360,-810,106888,103348
20150708,39660,40210,39500,39500,37790,37870,38400,-2340,-1810,248340,127858
20150709,37870,38400,38510,40580,38450,40220,39940,1820,1540,208438,128934
20150710,40220,39940,40660,40990,40050,40110,40500,170,560,168550,152112
20150713,40110,40500,40180,40370,39460,39880,39860,-620,-640,123036,167568
20150714,39880,39860,40190,40370,39990,39990,40170,130,310,100198,175098
20150715,39990,40170,39930,40490,39850,40470,40190,300,20,117244,181656
20150716,40470,40190,40410,40470,39880,40400,40180,210,-10,135026,185152
20150717,40400,40180,40170,40400,40110,40250,40220,70,40,72812,190030
20150720,40250,40220,39780,40060,39330,39580,39670,-640,-550,161034,207162
20150721,39580,39670,39550,39980,39370,39850,39750,180,80,105474,205724
20150722,39850,39750,39670,39860,38850,38940,39350,-810,-400,175466,232192
20150723,38940,39350,38960,39260,38490,38930,38890,-420,-460,210558,239346
20150724,38930,38890,38800,39000,37600,37760,38120,-1130,-770,319628,285956
20150727,37760,38120,38040,38530,37800,37980,38150,-140,30,287236,295144
20150728,37980,38150,37680,38150,37440,38040,37850,-110,-300,265940,301612
20150729,38040,37850,38190,39400,38110,38810,38770,960,920,394434,292350
20150730,38810,38770,38820,39030,38450,38560,38680,-210,-90,300354,297504
20150731,38560,38680,38290,38640,38190,38250,38380,-430,-300,283054,310310
20150803,38250,38380,38350,38680,37810,37870,38200,-510,-180,436930,342842
20150804,37870,38200,37840,38290,37650,38190,37970,-10,-230,405154,316140
20150805,38190,37970,38330,38430,37860,38120,38130,150,160,269210,325206
20150806,38120,38130,38170,38200,37830,38050,38020,-80,-110,261494,326764
20150807,38050,38020,37880,38100,37310,37970,37750,-50,-270,443168,326344
20150810,37970,37750,37750,38100,37540,37990,37850,240,100,355558,319414
20150811,37990,37850,38010,39820,37980,39060,38880,1210,1030,703446,279492
20150812,39060,38880,38670,39500,38530,39350,38920,470,40,671490,269288
20150813,39350,38920,39500,39970,39190,39580,39620,660,700,472860,242844
20150814,39580,39620,39470,39580,39220,39250,39420,-370,-200,301880,236384
20150817,39250,39420,39270,39510,38930,39150,39200,-270,-220,301984,218366
20150818,39150,39200,38900,39110,38760,38790,38970,-410,-230,272436,221814
20150819,38790,38970,38700,38780,38140,38750,38460,-220,-510,423328,216376
20150820,38750,38460,38480,38830,38330,38620,38560,160,100,339404,212376
20150821,38620,38560,39020,39220,38860,38940,39020,380,460,324494,204458
20150824,38940,39020,38810,38950,37650,38280,38330,-740,-690,660558,216254
20150825,38280,38330,37980,39090,37870,38820,38550,490,220,663922,195670
20150826,38820,38550,39320,39600,38840,38840,39240,290,690,421568,177890
20150827,38840,39240,38670,39030,38240,38890,38680,-350,-560,365458,169534
20150828,38890,38680,38900,39860,38860,39390,39390,710,710,365790,157522
20150831,39390,39390,39450,39690,39150,39310,39420,-80,30,240082,148800
20150901,39310,39420,39160,39640,39010,39260,39320,-160,-100,151846,137826
20150902,39260,39320,39120,39340,39050,39150,39180,-170,-140,91470,132768
20150907,39150,39180,39190,39500,39110,39470,39370,290,190,58512,131604
20150908,39470,39370,39610,39630,39320,39560,39480,190,110,72972,129132
20150909,39560,39480,40050,41540,40050,41170,40850,1690,1370,200016,119848
20150910,41170,40850,41230,41310,40740,41080,40970,230,120,102142,116822
20150911,41080,40970,41000,41300,41000,41170,41150,200,180,76276,112604
20150914,41170,41150,40880,41200,40640,40680,40910,-470,-240,71994,107104
20150915,40680,40910,40560,40740,40360,40380,40570,-530,-340,68486,100682
20150916,40380,40570,40420,41010,40420,40980,40680,410,110,60844,96526
20150917,40980,40680,41010,41410,40830,41050,41090,370,410,64860,92538
20150918,41050,41090,40960,41230,40730,40750,40890,-340,-200,49704,88802
20150921,40750,40890,40430,40590,39930,40380,40200,-510,-690,58300,81582
20150922,40380,40200,40460,40540,39990,40010,40180,-190,-20,38226,76146
20150923,40010,40180,39460,39460,38360,39080,38800,-1100,-1380,69580,72892
20150924,39080,38800,39020,39310,38710,38950,38940,150,140,37442,66466
20150925,38950,38940,38750,39260,38630,39120,39050,180,110,40206,60796
20150928,39120,39050,38980,39150,38400,38400,38830,-650,-220,25278,55938
20150929,38400,38830,38150,38330,37880,37940,38030,-890,-800,35208,47054
20150930,37940,38030,38260,38830,38090,38800,38310,770,280,17904,41622
20151008,38800,38310,39600,39700,39140,39150,39410,840,1100,14722,39020
20151009,39150,39410,38190,40340,38190,40210,39700,800,290,27860,30950
20151012,40210,39700,40380,40400,40050,40290,40180,590,480,24430,22720
20151013,40290,40180,40200,40200,39620,39870,39750,-310,-430,11040,17470
20151014,39870,39750,39670,39970,39650,39660,39750,-90,0,10350,11690
20151015,39660,39750,39860,40150,39620,40070,40050,320,300,4690,10020
cu1511,20150105,44640,44480,44190,44190,43950,43990,44040,-490,-440,42,3062
20150106,43990,44040,43020,43800,43010,43670,43480,-370,-560,592,3352
20150107,43670,43480,43550,43620,43200,43200,43470,-280,-10,364,3476
20150108,43200,43470,43360,43500,43230,43350,43380,-120,-90,92,3494
20150109,43350,43380,43530,43530,42980,43000,43170,-380,-210,382,3734
20150112,43000,43170,42970,43030,42480,42550,42800,-620,-370,118,3782
20150113,42550,42800,41900,42240,41520,41520,41890,-1280,-910,416,3878
20150114,41520,41890,40950,41220,39790,39790,40230,-2100,-1660,760,4206
20150115,39790,40230,39100,40430,39060,40280,39840,50,-390,1826,4196
20150116,40280,39840,40540,40870,39810,40290,40130,450,290,290,4280
20150119,40290,40130,40400,41030,40400,41030,40730,900,600,390,4288
20150120,41030,40730,40720,40990,40460,40740,40860,10,130,354,4270
20150121,40740,40860,40850,40980,40710,40840,40870,-20,10,188,4286
20150122,40840,40870,40490,41540,40480,41050,41110,180,240,264,4238
20150123,41050,41110,41020,41020,40090,40350,40510,-760,-600,406,4236
20150126,40350,40510,40030,40060,38600,39160,39200,-1350,-1310,480,4260
20150127,39160,39200,39600,40380,39600,40070,40050,870,850,466,4404
20150128,40070,40050,39800,39800,39100,39310,39330,-740,-720,334,4460
20150129,39310,39330,39310,39450,38880,38930,39090,-400,-240,214,4492
20150130,38930,39090,38700,39040,38480,38620,38720,-470,-370,302,4528
20150202,38620,38720,38770,39890,38770,39860,39390,1140,670,210,4492
20150203,39860,39390,39750,40430,39750,40430,40160,1040,770,160,4478
20150204,40430,40160,40590,41580,40470,40750,40870,590,710,178,4460
20150205,40750,40870,40980,41030,40600,40620,40790,-250,-80,268,4422
20150206,40620,40790,40670,41300,40670,41280,41090,490,300,110,4406
20150209,41280,41090,41180,41180,40700,40820,40870,-270,-220,136,4426
20150210,40820,40870,40710,41010,40710,40900,40880,30,10,160,4418
20150211,40900,40880,40700,40730,40460,40690,40600,-190,-280,106,4426
20150212,40690,40600,40700,40700,40440,40670,40550,70,-50,104,4432
20150213,40670,40550,40860,41800,40790,41650,41350,1100,800,176,4400
20150216,41650,41350,41650,41650,41330,41430,41460,80,110,52,4416
20150217,41430,41460,41660,41790,41640,41770,41710,310,250,42,4420
20150225,41770,41710,41620,41710,41590,41660,41620,-50,-90,52,4410
20150226,41660,41620,41660,42300,41550,42270,41920,650,300,106,4416
20150227,42270,41920,42510,42560,42230,42360,42430,440,510,170,4378
20150302,42360,42430,42200,42950,42200,42950,42600,520,170,210,4394
20150303,42950,42600,42650,42700,42200,42250,42360,-350,-240,130,4390
20150304,42250,42360,42170,42260,41900,42210,42190,-150,-170,50,4404
20150305,42210,42190,42380,42380,42200,42240,42240,50,50,36,4416
20150306,42240,42240,42450,42450,41940,42000,42160,-240,-80,228,4420
20150309,42000,42160,42040,42080,41520,42050,41740,-110,-420,150,4382
20150310,42050,41740,41980,42480,41980,42080,42290,340,550,100,4380
20150311,42080,42290,41790,41990,41440,41900,41900,-390,-390,180,4420
20150312,41900,41900,41630,42450,41630,42410,42050,510,150,78,4414
20150313,42410,42050,42600,43100,42500,42950,42780,900,730,1188,4312
20150316,42950,42780,42750,43060,42680,43060,42780,280,0,2380,4082
20150317,43060,42780,42780,43160,42580,42730,42880,-50,100,2384,4064
20150318,42730,42880,42390,42710,41910,41930,42310,-950,-570,1784,4206
20150319,41930,42310,41700,42410,41270,41970,41890,-340,-420,790,4396
20150320,41970,41890,42190,42680,42090,42300,42300,410,410,700,4356
20150323,42300,42300,42700,44220,42700,43800,43620,1500,1320,1352,4288
20150324,43800,43620,44010,44350,43730,43890,44000,270,380,586,4440
20150325,43890,44000,43820,43890,43480,43710,43680,-290,-320,418,4502
20150326,43710,43680,43700,43880,43680,43740,43750,60,70,666,4536
20150327,43740,43750,44030,44150,43370,43600,43630,-150,-120,1060,4972
20150330,43600,43630,43550,43880,43330,43760,43610,130,-20,818,5184
20150331,43760,43610,43780,43980,43430,43440,43700,-170,90,368,5206
20150401,43440,43700,43270,43600,43200,43260,43370,-440,-330,236,5244
20150402,43260,43370,43200,43610,43130,43500,43410,130,40,332,5350
20150403,43500,43410,43220,43350,43150,43180,43250,-230,-160,56,5372
20150407,43180,43250,43350,43390,43240,43390,43330,140,80,128,5320
20150408,43390,43330,43560,43600,43300,43370,43480,40,150,434,5422
20150409,43370,43480,43220,43220,43020,43020,43080,-460,-400,30,5418
20150410,43020,43080,43100,43390,43060,43370,43210,290,130,66,5406
20150413,43370,43210,43640,43800,43340,43530,43550,320,340,114,5404
20150414,43530,43550,43390,43390,42520,42700,42740,-850,-810,496,5638
20150415,42700,42740,42670,42940,42450,42790,42760,50,20,166,5594
20150416,42790,42760,42610,43310,42610,43210,43170,450,410,308,5682
20150417,43210,43170,43580,43750,43440,43500,43560,330,390,204,5668
20150420,43500,43560,43500,43880,43460,43690,43730,130,170,232,5686
20150421,43690,43730,43010,43250,43000,43190,43150,-540,-580,672,6038
20150422,43190,43150,43030,43100,42880,43000,42990,-150,-160,940,6102
20150423,43000,42990,42930,43050,42440,42750,42770,-240,-220,1068,6294
20150424,42750,42770,42940,43100,42830,43040,42980,270,210,320,6318
20150427,43040,42980,43290,43720,43270,43520,43500,540,520,428,6298
20150428,43520,43500,43690,43890,43380,43480,43600,-20,100,478,6362
20150429,43480,43600,43610,43760,43470,43530,43540,-70,-60,834,6914
20150430,43530,43540,43600,44000,43600,44000,43880,460,340,558,6710
20150504,44000,43880,45000,45560,44890,45540,45150,1660,1270,700,6570
20150505,45540,45150,45670,45670,45340,45480,45470,330,320,956,6846
20150506,45480,45470,45680,46120,45680,45840,45930,370,460,1238,7132
20150507,45840,45930,45880,45950,45550,45630,45720,-300,-210,954,7738
20150508,45630,45720,45800,45830,45600,45790,45700,70,-20,1612,9132
20150511,45790,45700,45730,45810,45440,45630,45600,-70,-100,444,9098
20150512,45630,45600,45500,45750,45470,45750,45560,150,-40,188,9152
20150513,45750,45560,46000,46210,45790,46110,45940,550,380,820,9600
20150514,46110,45940,46110,46110,45760,45920,45820,-20,-120,348,9466
20150515,45920,45820,45970,46020,45660,45980,45900,160,80,196,9526
20150518,45980,45900,45810,46080,45690,45980,45900,80,0,518,9584
20150519,45980,45900,45900,45900,45630,45630,45770,-270,-130,1860,10106
20150520,45630,45770,45190,45260,44520,44660,44740,-1110,-1030,934,10394
20150521,44660,44740,44770,45030,44560,45000,44910,260,170,1318,10724
20150522,45000,44910,44980,45120,44920,44980,45000,70,90,1164,11138
20150525,44980,45000,44470,44570,44390,44560,44490,-440,-510,740,11476
20150526,44560,44490,44660,44950,44290,44290,44660,-200,170,766,11594
20150527,44290,44660,44180,44240,43930,44240,44060,-420,-600,1602,12130
20150528,44240,44060,44020,44210,43860,44150,44000,90,-60,1590,12820
20150529,44150,44000,44050,44160,43810,44130,44060,130,60,970,12880
20150601,44130,44060,43940,43990,43490,43550,43650,-510,-410,2124,13134
20150602,43550,43650,43520,43700,43330,43630,43520,-20,-130,3622,13438
20150603,43630,43520,43720,43780,43450,43450,43680,-70,160,2882,13406
20150604,43450,43680,43530,43560,43260,43330,43400,-350,-280,2572,13792
20150605,43330,43400,43300,43350,42710,42720,42950,-680,-450,3532,14052
20150608,42720,42950,42840,43170,42700,43120,42950,170,0,2866,13696
20150609,43120,42950,43020,43250,43010,43150,43150,200,200,1040,13832
20150610,43150,43150,43240,43410,43120,43250,43280,100,130,1686,14080
20150611,43250,43280,43550,43630,43100,43110,43410,-170,130,2378,14114
20150612,43110,43410,42900,42990,42370,42370,42640,-1040,-770,3850,15434
20150615,42370,42640,42530,42710,42030,42060,42370,-580,-270,2348,15796
20150616,42060,42370,42010,42290,41900,42060,42090,-310,-280,2532,15942
20150617,42060,42090,41960,41960,41500,41690,41750,-400,-340,2378,16402
20150618,41690,41750,41750,42080,41510,42000,41900,250,150,5084,17474
20150619,42000,41900,41860,41940,41630,41690,41730,-210,-170,2552,17446
20150623,41690,41730,41490,41870,41310,41770,41740,40,10,1826,17618
20150624,41770,41740,41760,42140,41650,42050,41880,310,140,3580,18222
20150625,42050,41880,42120,42200,41170,41700,41650,-180,-230,6878,20554
20150626,41700,41650,41720,42490,41500,42140,41900,490,250,9072,20708
20150629,42140,41900,41960,42470,41860,42400,42090,500,190,10270,20106
20150630,42400,42090,42180,42310,41870,41870,42070,-220,-20,7224,20684
20150701,41870,42070,41830,42110,41430,41800,41820,-270,-250,7558,21672
20150702,41800,41820,41750,42310,41750,42040,42070,220,250,6282,21682
20150703,42040,42070,42120,42290,41960,42190,42130,120,60,8180,22308
20150706,42190,42130,42020,42120,39900,40570,40930,-1560,-1200,24630,25814
20150707,40570,40930,40500,40620,39510,39560,40110,-1370,-820,21924,30744
20150708,39560,40110,39000,39340,37700,37850,38300,-2260,-1810,48512,36602
20150709,37850,38300,38370,40470,38370,40100,39900,1800,1600,45606,39410
20150710,40100,39900,40640,40880,39980,40040,40420,140,520,25752,43010
20150713,40040,40420,40050,40260,39350,39710,39710,-710,-710,35254,49242
20150714,39710,39710,39970,40220,39860,39860,40030,150,320,18642,50862
20150715,39860,40030,39920,40340,39720,40330,40080,300,50,21910,52528
20150716,40330,40080,40240,40320,39740,40270,40020,190,-60,30526,54010
20150717,40270,40020,40000,40240,39960,40100,40080,80,60,18846,57460
20150720,40100,40080,39720,39890,39180,39420,39520,-660,-560,37482,64342
20150721,39420,39520,39390,39830,39230,39710,39620,190,100,24904,67196
20150722,39710,39620,39610,39720,38720,38810,39230,-810,-390,53402,81670
20150723,38810,39230,38790,39120,38350,38820,38750,-410,-480,45556,84136
20150724,38820,38750,38690,38850,37470,37610,37930,-1140,-820,80220,104612
20150727,37610,37930,38050,38380,37630,37800,38000,-130,70,66908,108760
20150728,37800,38000,37510,37960,37280,37870,37680,-130,-320,50292,109210
20150729,37870,37680,38020,39200,37930,38630,38600,950,920,73160,111510
20150730,38630,38600,38630,38850,38280,38390,38510,-210,-90,45196,116720
20150731,38390,38510,38100,38480,38010,38080,38210,-430,-300,51078,124078
20150803,38080,38210,38180,38540,37640,37710,38000,-500,-210,71626,131706
20150804,37710,38000,37650,38100,37480,38000,37800,0,-200,82528,136216
20150805,38000,37800,38190,38240,37700,37950,37930,150,130,54300,139126
20150806,37950,37930,37940,38030,37660,37890,37860,-40,-70,48126,142244
20150807,37890,37860,37650,37930,37120,37730,37550,-130,-310,110828,149104
20150810,37730,37550,37530,37890,37310,37770,37630,220,80,80776,151400
20150811,37770,37630,37800,39370,37740,38930,38720,1300,1090,182514,152304
20150812,38930,38720,38510,39380,38350,39200,38780,480,60,196698,147996
20150813,39200,38780,39390,39840,39040,39450,39470,670,690,155390,147318
20150814,39450,39470,39350,39440,39080,39120,39280,-350,-190,82916,149522
20150817,39120,39280,39120,39360,38790,39030,39020,-250,-260,85598,153526
20150818,39030,39020,38750,38960,38600,38600,38790,-420,-230,81306,159636
20150819,38600,38790,38560,38590,37960,38580,38290,-210,-500,144098,168248
20150820,38580,38290,38330,38650,38160,38450,38400,160,110,121026,173962
20150821,38450,38400,38850,39060,38690,38760,38840,360,440,154156,174008
20150824,38760,38840,38660,38790,37530,38140,38140,-700,-700,343694,190944
20150825,38140,38140,37830,38940,37720,38650,38420,510,280,384940,189006
20150826,38650,38420,39150,39420,38710,38710,39070,290,650,280550,191986
20150827,38710,39070,38500,38870,38090,38740,38560,-330,-510,269560,191870
20150828,38740,38560,38780,39690,38700,39280,39250,720,690,315610,201114
20150831,39280,39250,39350,39580,39010,39200,39280,-50,30,242440,209628
20150901,39200,39280,39020,39540,38880,39150,39210,-130,-70,270324,211882
20150902,39150,39210,39020,39230,38900,39010,39060,-200,-150,218336,204348
20150907,39010,39060,39080,39430,38980,39370,39260,310,200,165810,213878
20150908,39370,39260,39520,39550,39210,39530,39390,270,130,300004,221486
20150909,39530,39390,40000,41550,39970,41140,40820,1750,1430,852324,233214
20150910,41140,40820,41220,41290,40690,41060,40950,240,130,594110,230840
20150911,41060,40950,40990,41280,40960,41160,41130,210,180,503240,221390
20150914,41160,41130,40850,41200,40570,40620,40870,-510,-260,499764,205204
20150915,40620,40870,40510,40690,40290,40320,40510,-550,-360,476206,201000
20150916,40320,40510,40390,40980,40390,40950,40640,440,130,548102,200040
20150917,40950,40640,40940,41380,40780,40990,41060,350,420,668968,195616
20150918,40990,41060,40940,41200,40670,40710,40920,-350,-140,491870,195032
20150921,40710,40920,40370,40530,39850,40340,40150,-580,-770,652662,184728
20150922,40340,40150,40430,40480,39900,39920,40180,-230,30,435788,190326
20150923,39920,40180,39310,39350,38250,38930,38660,-1250,-1520,841592,190554
20150924,38930,38660,38950,39180,38620,38850,38850,190,190,561310,186212
20150925,38850,38850,38650,39170,38520,39000,38900,150,50,635386,162114
20150928,39000,38900,38810,39050,38310,38310,38720,-590,-180,248798,159354
20150929,38310,38720,37930,38200,37680,37760,37920,-960,-800,468338,155006
20150930,37760,37920,38140,38700,37940,38600,38210,680,290,294520,143588
20151008,38600,38210,39700,39700,39030,39080,39330,870,1120,154482,128092
20151009,39080,39330,39010,40330,38790,40180,39610,850,280,274576,116704
20151012,40180,39610,40400,40500,39970,40200,40150,590,540,156096,112150
20151013,40200,40150,40250,40250,39600,39820,39820,-330,-330,94832,107986
20151014,39820,39820,39760,39990,39610,39700,39770,-120,-50,78016,106022
20151015,39700,39770,39820,40220,39790,40040,40050,270,280,81064,103186
20151016,40040,40050,40060,40160,39520,39600,39900,-450,-150,62904,96706
20151019,39600,39900,39600,39800,39340,39490,39550,-410,-350,53824,91662
20151020,39490,39550,39160,39390,39010,39280,39180,-270,-370,49040,87740
20151021,39280,39180,39320,39450,38920,38990,39100,-190,-80,43392,83228
20151022,38990,39100,38970,39470,38820,39310,39170,210,70,39398,82050
20151023,39310,39170,39500,39820,39330,39740,39540,570,370,49080,76176
20151026,39740,39540,39640,39700,38860,39130,39160,-410,-380,45198,69486
20151027,39130,39160,39180,39460,38880,39360,39120,200,-40,41156,65002
20151028,39360,39120,39320,39390,38920,38920,39110,-200,-10,32644,60132
20151029,38920,39110,38810,39370,38690,39080,39090,-30,-20,33292,54634
20151030,39080,39090,38970,39030,38680,38880,38800,-210,-290,27892,47732
20151102,38880,38800,38770,38850,38510,38590,38620,-210,-180,18872,42730
20151103,38590,38620,38590,38760,38500,38560,38650,-60,30,16230,40650
20151104,38560,38650,38560,38900,38400,38900,38720,250,70,16670,36270
20151105,38900,38720,38710,39110,38300,38300,38650,-420,-70,16590,33170
20151106,38300,38650,38100,38320,37960,38150,38060,-500,-590,14280,31390
20151109,38150,38060,38010,38160,37700,37700,37930,-360,-130,13590,29550
20151110,37700,37930,37800,37880,37230,37570,37470,-360,-460,15290,24730
20151111,37570,37470,37440,37570,37200,37200,37360,-270,-110,12720,19520
20151112,37200,37360,37400,37430,37200,37260,37290,-100,-70,9440,17350
20151113,37260,37290,35990,36650,35990,36190,36430,-1100,-860,7080,15720
20151116,36190,36430,36000,36340,35800,35950,36150,-480,-280,5120,15930
cu1512,20150105,44530,44400,44330,44330,43840,43860,43990,-540,-410,254,1188
20150106,43860,43990,43010,43670,42900,43610,43440,-380,-550,574,1538
20150107,43610,43440,43610,43610,43130,43160,43370,-280,-70,378,1762
20150108,43160,43370,43310,43410,43200,43200,43270,-170,-100,200,1848
20150109,43200,43270,43320,43360,42880,42960,43060,-310,-210,576,2160
20150112,42960,43060,42820,42980,42360,42360,42800,-700,-260,958,2896
20150113,42360,42800,42000,42130,41480,41480,41850,-1320,-950,1084,3630
20150114,41480,41850,40910,41130,39750,39750,40290,-2100,-1560,1908,4914
20150115,39750,40290,39150,40450,38800,40230,39990,-60,-300,2300,5756
20150116,40230,39990,40550,40860,39800,40280,40160,290,170,1094,5970
20150119,40280,40160,39990,41000,39990,41000,40630,840,470,736,6022
20150120,41000,40630,40470,40990,40420,40710,40730,80,100,294,6036
20150121,40710,40730,40910,40990,40730,40780,40820,50,90,242,6084
20150122,40780,40820,40660,41460,40440,41030,41010,210,190,540,6202
20150123,41030,41010,41010,41050,40070,40300,40600,-710,-410,776,6466
20150126,40300,40600,40100,40100,38580,39150,39300,-1450,-1300,1198,6964
20150127,39150,39300,39440,40500,39440,40060,40000,760,700,582,6940
20150128,40060,40000,39970,39970,39030,39280,39330,-720,-670,534,7142
20150129,39280,39330,39340,39360,38870,38870,39020,-460,-310,466,7330
20150130,38870,39020,38650,39000,38450,38580,38690,-440,-330,628,7564
20150202,38580,38690,38900,39890,38880,39850,39500,1160,810,806,7534
20150203,39850,39500,39790,40430,39700,40400,40140,900,640,446,7462
20150204,40400,40140,40880,41530,40500,40750,40930,610,790,622,7574
20150205,40750,40930,41080,41080,40580,40630,40840,-300,-90,1044,8018
20150206,40630,40840,40270,41300,40260,41230,41060,390,220,410,7900
20150209,41230,41060,41140,41210,40630,40800,40880,-260,-180,480,7958
20150210,40800,40880,40810,41020,40630,40870,40870,-10,-10,312,7934
20150211,40870,40870,40710,40810,40390,40680,40610,-190,-260,394,7972
20150212,40680,40610,40700,40760,40420,40650,40580,40,-30,216,7978
20150213,40650,40580,40930,41800,40800,41610,41420,1030,840,630,7900
20150216,41610,41420,41650,41820,41340,41820,41490,400,70,142,7896
20150217,41820,41490,41630,41860,41620,41780,41710,290,220,174,7888
20150225,41780,41710,41700,41760,41570,41650,41630,-60,-80,178,7920
20150226,41650,41630,41650,42280,41560,42200,41880,570,250,302,7984
20150227,42200,41880,42450,42560,42200,42470,42440,590,560,1116,8478
20150302,42470,42440,42300,42960,42160,42950,42590,510,150,688,8316
20150303,42950,42590,42710,42950,42240,42270,42440,-320,-150,210,8356
20150304,42270,42440,42210,42300,41930,42220,42170,-220,-270,206,8376
20150305,42220,42170,42320,42320,41950,42270,42130,100,-40,134,8348
20150306,42270,42130,42410,42410,41950,42010,42140,-120,10,342,8432
20150309,42010,42140,42060,42090,41500,42070,41740,-70,-400,200,8388
20150310,42070,41740,42100,42500,42020,42050,42210,310,470,544,8590
20150311,42050,42210,41780,42060,41720,41880,41880,-330,-330,256,8626
20150312,41880,41880,41920,42420,41660,42410,42010,530,130,248,8624
20150313,42410,42010,42580,43100,42500,42960,42840,950,830,1330,8326
20150316,42960,42840,42780,43070,42700,43070,42840,230,0,718,8318
20150317,43070,42840,42810,43210,42700,42800,42960,-40,120,1144,8282
20150318,42800,42960,42510,42800,41960,41960,42550,-1000,-410,4440,8334
20150319,41960,42550,41760,42400,41390,42010,41800,-540,-750,960,8168
20150320,42010,41800,42320,42800,42150,42330,42420,530,620,1734,7664
20150323,42330,42420,42750,44250,42750,43890,43610,1470,1190,1036,7576
20150324,43890,43610,43990,44590,43800,43880,44050,270,440,784,7368
20150325,43880,44050,43840,43930,43480,43700,43720,-350,-330,476,7264
20150326,43700,43720,43870,43930,43700,43810,43770,90,50,334,7258
20150327,43810,43770,43840,44200,43290,43660,43700,-110,-70,306,7236
20150330,43660,43700,43490,43860,43250,43750,43490,50,-210,1332,6740
20150331,43750,43490,43840,43930,43460,43480,43700,-10,210,564,6824
20150401,43480,43700,43420,43620,43230,43300,43400,-400,-300,254,6842
20150402,43300,43400,43250,43620,43160,43500,43430,100,30,766,6966
20150403,43500,43430,43360,43400,43150,43230,43310,-200,-120,294,7034
20150407,43230,43310,43320,43500,43320,43450,43430,140,120,182,6998
20150408,43450,43430,43550,43760,43270,43390,43510,-40,80,860,7224
20150409,43390,43510,43220,43250,43010,43230,43130,-280,-380,112,7238
20150410,43230,43130,43250,43420,43080,43380,43280,250,150,198,7258
20150413,43380,43280,43360,43820,43300,43530,43510,250,230,260,7224
20150414,43530,43510,43480,43550,42480,42750,42950,-760,-560,774,7270
20150415,42750,42950,42620,42970,42460,42800,42790,-150,-160,188,7276
20150416,42800,42790,42580,43350,42580,43150,43140,360,350,452,7336
20150417,43150,43140,43570,43750,43470,43490,43590,350,450,410,7314
20150420,43490,43590,43330,43880,43330,43670,43640,80,50,460,7292
20150421,43670,43640,43220,43340,43010,43190,43190,-450,-450,610,7478
20150422,43190,43190,43000,43110,42900,43060,43030,-130,-160,244,7460
20150423,43060,43030,43000,43080,42440,42740,42790,-290,-240,762,7454
20150424,42740,42790,42960,43150,42870,43040,42980,250,190,352,7458
20150427,43040,42980,43450,43700,43300,43510,43560,530,580,730,7410
20150428,43510,43560,43670,43880,43300,43520,43690,-40,130,792,7478
20150429,43520,43690,43600,43750,43430,43450,43590,-240,-100,708,7526
20150430,43450,43590,43600,44040,43600,44040,43880,450,290,2172,8592
20150504,44040,43880,45350,45530,44920,45530,45180,1650,1300,772,8448
20150505,45530,45180,45810,45810,45340,45480,45490,300,310,696,8636
20150506,45480,45490,45630,46130,45630,45880,45920,390,430,646,8746
20150507,45880,45920,45900,45900,45500,45580,45710,-340,-210,316,8738
20150508,45580,45710,45790,45800,45580,45730,45720,20,10,1018,9220
20150511,45730,45720,45730,45770,45440,45600,45610,-120,-110,280,9286
20150512,45600,45610,45540,45770,45460,45700,45600,90,-10,168,9292
20150513,45700,45600,45910,46190,45760,46110,45890,510,290,330,9288
20150514,46110,45890,46030,46110,45620,45900,45820,10,-70,396,9210
20150515,45900,45820,45950,46010,45660,45980,45800,160,-20,342,9156
20150518,45980,45800,45820,46070,45770,46000,45910,200,110,562,9240
20150519,46000,45910,45880,45880,45640,45640,45770,-270,-140,266,9288
20150520,45640,45770,45230,45270,44500,44670,44780,-1100,-990,1076,9370
20150521,44670,44780,44710,45050,44540,44990,44870,210,90,532,9636
20150522,44990,44870,44990,45060,44920,44970,44980,100,110,76,9634
20150525,44970,44980,44450,44560,44400,44540,44490,-440,-490,594,9866
20150526,44540,44490,44650,44960,44370,44370,44720,-120,230,1324,9942
20150527,44370,44720,44220,44220,43910,44200,44100,-520,-620,614,10090
20150528,44200,44100,44000,44240,43860,44160,44010,60,-90,632,10122
20150529,44160,44010,44020,44130,43810,44090,43990,80,-20,1886,9464
20150601,44090,43990,43860,43950,43450,43520,43670,-470,-320,1038,9374
20150602,43520,43670,43500,43680,43350,43570,43520,-100,-150,716,9654
20150603,43570,43520,43700,43780,43470,43470,43680,-50,160,774,9874
20150604,43470,43680,43510,43560,43290,43340,43390,-340,-290,412,9980
20150605,43340,43390,43240,43330,42700,42720,42830,-670,-560,1614,10500
20150608,42720,42830,42850,43150,42700,43120,42990,290,160,828,10582
20150609,43120,42990,43050,43250,43040,43180,43130,190,140,314,10618
20150610,43180,43130,43240,43400,43160,43250,43260,120,130,690,10856
20150611,43250,43260,43800,43800,43110,43110,43450,-150,190,656,11012
20150612,43110,43450,42860,43010,42300,42300,42610,-1150,-840,1412,11428
20150615,42300,42610,42520,42700,42030,42030,42340,-580,-270,1006,11554
20150616,42030,42340,42010,42270,41900,42070,42060,-270,-280,1258,11868
20150617,42070,42060,41950,41950,41500,41670,41740,-390,-320,1322,12088
20150618,41670,41740,41760,42080,41510,42020,41860,280,120,1322,12370
20150619,42020,41860,41860,41930,41630,41640,41740,-220,-120,2314,12910
20150623,41640,41740,41220,41850,41160,41760,41710,20,-30,1022,13146
20150624,41760,41710,41730,42110,41640,41990,41900,280,190,890,13148
20150625,41990,41900,42160,42180,41300,41680,41800,-220,-100,1558,13518
20150626,41680,41800,41630,42380,41510,42150,41820,350,20,1716,13778
20150629,42150,41820,41960,42410,41830,42370,42020,550,200,3228,14092
20150630,42370,42020,42110,42270,41800,41880,42040,-140,20,2988,14214
20150701,41880,42040,41740,42060,41400,41760,41790,-280,-250,3158,14510
20150702,41760,41790,41720,42210,41670,42000,42030,210,240,1686,14654
20150703,42000,42030,42080,42210,41900,42140,42100,110,70,4084,15270
20150706,42140,42100,42070,42070,39840,40500,40790,-1600,-1310,11272,18090
20150707,40500,40790,40450,40570,39490,39550,40020,-1240,-770,11040,20756
20150708,39550,40020,39130,39610,37610,37760,38210,-2260,-1810,20568,23950
20150709,37760,38210,38200,40420,38200,40140,39870,1930,1660,18210,21918
20150710,40140,39870,40660,40840,39950,40010,40350,140,480,14522,23402
20150713,40010,40350,39960,40220,39320,39680,39670,-670,-680,23420,29790
20150714,39680,39670,39780,40150,39780,39800,39950,130,280,7710,30694
20150715,39800,39950,39740,42260,39630,40220,39990,270,40,10112,32642
20150716,40220,39990,40160,40200,39640,40160,39930,170,-60,9690,33430
20150717,40160,39930,39940,40130,39880,40030,39980,100,50,9670,37046
20150720,40030,39980,39500,39780,37950,39360,39420,-620,-560,14556,39422
20150721,39360,39420,39270,39730,39150,39600,39510,180,90,10080,40862
20150722,39600,39510,39480,39620,38640,38710,39130,-800,-380,14476,43466
20150723,38710,39130,38710,39030,38250,38710,38690,-420,-440,20156,45696
20150724,38710,38690,38610,38730,37390,37520,37820,-1170,-870,27156,52720
20150727,37520,37820,37970,38260,37490,37730,37910,-90,90,18518,53410
20150728,37730,37910,37410,37860,37170,37740,37590,-170,-320,15378,54996
20150729,37740,37590,37880,39060,37750,38530,38450,940,860,29044,53132
20150730,38530,38450,38530,38730,38170,38310,38390,-140,-60,17214,55108
20150731,38310,38390,37850,38390,37850,38000,38110,-390,-280,14558,56850
20150803,38000,38110,38090,38420,37550,37610,37900,-500,-210,24182,60204
20150804,37610,37900,37580,37980,37400,37870,37670,-30,-230,29552,63472
20150805,37870,37670,38100,38110,37580,37840,37790,170,120,18400,64758
20150806,37840,37790,37860,37930,37570,37780,37770,-10,-20,14176,65840
20150807,37780,37770,37600,37810,36990,37580,37420,-190,-350,44956,72318
20150810,37580,37420,37350,37730,37170,37600,37470,180,50,29294,73412
20150811,37600,37470,37620,39160,37580,38790,38590,1320,1120,65058,75422
20150812,38790,38590,38340,39270,38220,39150,38670,560,80,61382,80590
20150813,39150,38670,39250,39750,38800,39340,39400,670,730,56238,84624
20150814,39340,39400,39340,39340,38990,39020,39170,-380,-230,26392,88288
20150817,39020,39170,39000,39250,38670,38890,38880,-280,-290,38192,89170
20150818,38890,38880,38600,38820,38500,38510,38670,-370,-210,30954,90724
20150819,38510,38670,38410,38450,37830,38430,38170,-240,-500,41816,92096
20150820,38430,38170,38160,38510,38010,38300,38270,130,100,35298,91700
20150821,38300,38270,38650,38920,38540,38620,38690,350,420,39430,92986
20150824,38620,38690,38590,38650,37430,38030,38010,-660,-680,83808,95576
20150825,38030,38010,37690,38810,37630,38500,38360,490,350,97346,99898
20150826,38500,38360,39080,39270,38600,38610,38930,250,570,76080,104530
20150827,38610,38930,38410,38770,38020,38660,38450,-270,-480,75532,103146
20150828,38660,38450,38690,39540,38610,39190,39170,740,720,73032,102532
20150831,39190,39170,39290,39490,38950,39130,39200,-40,30,54350,102422
20150901,39130,39200,38920,39450,38820,39070,39150,-130,-50,63620,104092
20150902,39070,39150,38960,39150,38850,38920,38970,-230,-180,40700,107378
20150907,38920,38970,38920,39330,38890,39280,39170,310,200,34022,109582
20150908,39280,39170,39420,39470,39130,39460,39310,290,140,46780,113442
20150909,39460,39310,39900,41500,39900,41090,40790,1780,1480,185318,127742
20150910,41090,40790,41200,41230,40640,41000,40910,210,120,97638,127740
20150911,41000,40910,40880,41200,40880,41100,41060,190,150,85712,127742
20150914,41100,41060,40800,41140,40530,40580,40800,-480,-260,107252,132672
20150915,40580,40800,40500,40630,40240,40290,40450,-510,-350,100928,135032
20150916,40290,40450,40340,40910,40340,40890,40580,440,130,110082,137848
20150917,40890,40580,40850,41310,40730,40940,41010,360,430,144178,147032
20150918,40940,41010,40890,41150,40640,40650,40860,-360,-150,99934,149262
20150921,40650,40860,40350,40500,39790,40260,40100,-600,-760,168450,145986
20150922,40260,40100,40260,40420,39840,39860,40100,-240,0,88016,152482
20150923,39860,40100,39200,39290,38190,38840,38610,-1260,-1490,244322,180038
20150924,38840,38610,38900,39100,38550,38800,38770,190,160,114122,185404
20150925,38800,38770,38550,39060,38450,38890,38820,120,50,177618,186476
20150928,38890,38820,38780,38930,38120,38170,38600,-650,-220,103954,205684
20150929,38170,38600,37710,38080,37550,37640,37780,-960,-820,244164,230082
20150930,37640,37780,38000,38490,37810,38370,38080,590,300,171862,236074
20151008,38370,38080,39340,39450,38880,38920,39160,840,1080,196074,247616
20151009,38920,39160,38890,40270,38630,40090,39580,930,420,602558,218306
20151012,40090,39580,40380,40420,39900,40150,40080,570,500,480018,226810
20151013,40150,40080,40180,40190,39510,39750,39770,-330,-310,409576,231756
20151014,39750,39770,39700,39930,39540,39630,39710,-140,-60,394322,230740
20151015,39630,39710,39750,40200,39720,40020,39990,310,280,454346,234164
20151016,40020,39990,39990,40120,39460,39540,39850,-450,-140,448574,245236
20151019,39540,39850,39560,39730,39250,39380,39500,-470,-350,454318,248280
20151020,39380,39500,39110,39290,38910,39200,39100,-300,-400,425676,250018
20151021,39200,39100,39220,39370,38830,38910,39070,-190,-30,470650,246484
20151022,38910,39070,38890,39420,38710,39270,39060,200,-10,499932,238430
20151023,39270,39060,39510,39780,39260,39700,39490,640,430,621258,233798
20151026,39700,39490,39600,39670,38800,39060,39120,-430,-370,662198,221716
20151027,39060,39120,39120,39410,38800,39310,39090,190,-30,510268,221250
20151028,39310,39090,39300,39340,38840,38930,39090,-160,0,441918,208944
20151029,38930,39090,38830,39330,38620,39030,39060,-60,-30,525966,181812
20151030,39030,39060,38920,38980,38600,38850,38770,-210,-290,417498,170810
20151102,38850,38770,38680,38820,38440,38590,38610,-180,-160,269008,164530
20151103,38590,38610,38620,38750,38460,38510,38600,-100,-10,182088,160564
20151104,38510,38600,38600,38910,38340,38900,38610,300,10,188718,146806
20151105,38900,38610,38770,39160,38290,38320,38700,-290,90,182736,140236
20151106,38320,38700,38120,38370,37910,38120,38080,-580,-620,163680,135170
20151109,38120,38080,37990,38170,37670,37690,37950,-390,-130,129816,129850
20151110,37690,37950,37760,37950,37190,37640,37540,-310,-410,114682,120008
20151111,37640,37540,37540,37640,37130,37140,37400,-400,-140,90392,116442
20151112,37140,37400,37260,37940,37230,37350,37360,-50,-40,60920,112586
20151113,37350,37360,36900,36900,36230,36290,36540,-1070,-820,82132,106460
20151116,36290,36540,36500,36520,36010,36070,36290,-470,-250,55596,103946
20151117,36070,36290,36120,36220,34560,35050,35200,-1240,-1090,119134,98266
20151118,35050,35200,35360,35440,34520,34940,34940,-260,-260,74248,93046
20151119,34940,34940,34950,35100,34300,34840,34720,-100,-220,59680,91166
20151120,34840,34720,34690,35190,34480,34930,34820,210,100,67914,84016
20151123,34930,34820,35090,35130,33350,33580,33990,-1240,-830,80706,80322
20151124,33580,33990,33580,34090,33300,33870,33630,-120,-360,61284,73318
20151125,33870,33630,33780,34950,33710,34600,34510,970,880,60766,63972
20151126,34600,34510,34270,36070,34190,35180,35120,670,610,58226,55964
20151127,35180,35120,35180,35650,34860,35360,35240,240,120,37370,50988
20151130,35360,35240,35280,35350,34460,34820,34830,-420,-410,43420,49324
cu1601,20150116,39990,39990,40180,40180,39520,40170,40020,180,30,52,34
20150119,40170,40020,39960,40890,39960,40840,40660,820,640,306,256
20150120,40840,40660,40570,40890,40510,40670,40680,10,20,22,270
20150121,40670,40680,40850,40870,40510,40700,40730,20,50,146,326
20150122,40700,40730,40410,41170,40390,41170,40910,440,180,34,318
20150123,41170,40910,40720,40980,40000,40250,40510,-660,-400,138,368
20150126,40250,40510,39900,40000,38600,39060,39250,-1450,-1260,252,542
20150127,39060,39250,39830,40300,39830,40020,40040,770,790,154,550
20150128,40020,40040,39740,39740,39010,39370,39330,-670,-710,298,716
20150129,39370,39330,39230,39250,38900,38900,39010,-430,-320,240,842
20150130,38900,39010,38670,38890,38430,38640,38650,-370,-360,376,1082
20150202,38640,38650,38950,39820,38810,39800,39420,1150,770,310,1084
20150203,39800,39420,39800,40390,39550,40390,40060,970,640,318,1142
20150204,40390,40060,40660,41540,40410,40690,40750,630,690,218,1142
20150205,40690,40750,40600,41050,40510,40630,40730,-120,-20,844,1646
20150206,40630,40730,40500,41280,40500,41220,40930,490,200,576,1926
20150209,41220,40930,41100,41170,40670,40770,40830,-160,-100,80,1940
20150210,40770,40830,40640,41010,40640,40870,40840,40,10,212,2000
20150211,40870,40840,40620,40800,40400,40730,40600,-110,-240,470,2290
20150212,40730,40600,40710,40800,40480,40700,40540,100,-60,224,2384
20150213,40700,40540,40880,41810,40880,41640,41410,1100,870,134,2378
20150216,41640,41410,41630,41780,41330,41780,41500,370,90,82,2388
20150217,41780,41500,41620,41800,41620,41770,41740,270,240,44,2384
20150225,41770,41740,41600,41770,41490,41690,41650,-50,-90,64,2390
20150226,41690,41650,41630,42240,41620,42190,41990,540,340,156,2320
20150227,42190,41990,42450,42560,42160,42450,42500,460,510,196,2216
20150302,42450,42500,42380,42970,42220,42970,42720,470,220,64,2212
20150303,42970,42720,42710,42900,42220,42380,42600,-340,-120,106,2264
20150304,42380,42600,42100,42280,42040,42200,42150,-400,-450,20,2264
20150305,42200,42150,42200,42310,42070,42260,42190,110,40,34,2254
20150306,42260,42190,42290,42300,41950,41990,42230,-200,40,126,2260
20150309,41990,42230,41760,42110,41540,42110,41740,-120,-490,70,2248
20150310,42110,41740,42040,42530,42020,42030,42290,290,550,74,2264
20150311,42030,42290,41780,42020,41710,41930,41810,-360,-480,108,2272
20150312,41930,41810,41900,42420,41700,42420,42020,610,210,134,2346
20150313,42420,42020,42600,43090,42500,42980,42800,960,780,324,2350
20150316,42980,42800,42780,43120,42690,43120,42900,320,100,468,2402
20150317,43120,42900,42910,43200,42720,42930,42970,30,70,262,2384
20150318,42930,42970,42560,42810,42080,42080,42670,-890,-300,1028,2364
20150319,42080,42670,41950,42350,41560,42170,41980,-500,-690,272,2384
20150320,42170,41980,42290,42790,42210,42410,42330,430,350,366,2198
20150323,42410,42330,42830,44320,42830,43930,43560,1600,1230,312,2246
20150324,43930,43560,44050,44500,43850,44020,44100,460,540,314,2288
20150325,44020,44100,43980,43980,43510,43720,43770,-380,-330,160,2256
20150326,43720,43770,43900,44120,43660,43800,43820,30,50,342,2318
20150327,43800,43820,43900,44220,43440,43620,43670,-200,-150,260,2362
20150330,43620,43670,43500,43860,43330,43730,43610,60,-60,152,2344
20150331,43730,43610,43940,43940,43490,43510,43660,-100,50,122,2346
20150401,43510,43660,43450,43580,43350,43370,43430,-290,-230,196,2262
20150402,43370,43430,43460,43700,43260,43540,43450,110,20,194,2256
20150403,43540,43450,43400,43420,43200,43200,43320,-250,-130,92,2262
20150407,43200,43320,43390,43510,43330,43500,43430,180,110,54,2260
20150408,43500,43430,43580,43670,43340,43340,43530,-90,100,210,2286
20150409,43340,43530,43250,43250,43080,43200,43130,-330,-400,42,2294
20150410,43200,43130,43370,43430,43030,43420,43250,290,120,108,2288
20150413,43420,43250,43400,43850,43320,43540,43480,290,230,194,2332
20150414,43540,43480,43520,43540,42610,42790,43080,-690,-400,366,2306
20150415,42790,43080,42740,43010,42500,42920,42750,-160,-330,220,2334
20150416,42920,42750,42820,43520,42820,43220,43280,470,530,284,2368
20150417,43220,43280,43630,43790,43540,43550,43630,270,350,184,2372
20150420,43550,43630,43440,43930,43440,43720,43760,90,130,382,2368
20150421,43720,43760,43310,43310,43130,43200,43230,-560,-530,374,2430
20150422,43200,43230,43000,43120,42950,43110,43060,-120,-170,368,2458
20150423,43110,43060,42960,43100,42460,42840,42840,-220,-220,510,2612
20150424,42840,42840,43060,43200,42960,43100,43050,260,210,56,2606
20150427,43100,43050,43340,43800,43340,43550,43640,500,590,384,2732
20150428,43550,43640,43720,43920,43450,43510,43630,-130,-10,448,2694
20150429,43510,43630,43570,43760,43460,43490,43590,-140,-40,346,2624
20150430,43490,43590,43620,44110,43620,44100,43840,510,250,492,2706
20150504,44100,43840,45180,45600,45000,45600,45170,1760,1330,406,2768
20150505,45600,45170,45980,45980,45350,45500,45510,330,340,206,2790
20150506,45500,45510,45720,46150,45700,45900,45900,390,390,384,2854
20150507,45900,45900,45880,45930,45530,45630,45710,-270,-190,184,2812
20150508,45630,45710,45760,45800,45580,45770,45700,60,-10,202,2752
20150511,45770,45700,45740,45770,45430,45610,45610,-90,-90,78,2794
20150512,45610,45610,45620,45680,45480,45630,45560,20,-50,90,2754
20150513,45630,45560,45850,46220,45760,46180,45950,620,390,100,2756
20150514,46180,45950,46110,46150,45630,45930,45810,-20,-140,420,2798
20150515,45930,45810,45970,46010,45650,46000,45770,190,-40,174,2782
20150518,46000,45770,45810,46020,45810,46020,45940,250,170,252,2902
20150519,46020,45940,45910,45910,45670,45680,45820,-260,-120,318,3010
20150520,45680,45820,45400,45400,44510,44670,44890,-1150,-930,1014,2962
20150521,44670,44890,44790,45050,44600,45030,44820,140,-70,234,2930
20150522,45030,44820,45020,45160,44920,45030,45010,210,190,220,2908
20150525,45030,45010,44460,44680,44400,44600,44520,-410,-490,378,3050
20150526,44600,44520,44650,45010,44390,44390,44690,-130,170,442,3214
20150527,44390,44690,44120,44250,43930,44230,44060,-460,-630,598,3322
20150528,44230,44060,44050,44290,43900,44140,44060,80,0,450,3374
20150529,44140,44060,44050,44150,43870,44150,44020,90,-40,258,3364
20150601,44150,44020,43940,44000,43500,43550,43660,-470,-360,490,3570
20150602,43550,43660,43470,43680,43380,43600,43530,-60,-130,562,3842
20150603,43600,43530,43690,43830,43480,43480,43710,-50,180,528,3868
20150604,43480,43710,43700,43700,43310,43360,43420,-350,-290,502,4052
20150605,43360,43420,43290,43380,42720,42740,42870,-680,-550,710,4490
20150608,42740,42870,42770,43180,42740,43110,43020,240,150,440,4538
20150609,43110,43020,43050,43250,43050,43210,43160,190,140,580,4646
20150610,43210,43160,43290,43440,43190,43290,43330,130,170,504,4840
20150611,43290,43330,43700,43700,43120,43140,43470,-190,140,966,5080
20150612,43140,43470,43050,43050,42000,42470,42630,-1000,-840,982,5254
20150615,42470,42630,42650,42650,42040,42040,42310,-590,-320,1218,5560
20150616,42040,42310,42120,42280,41910,42090,42050,-220,-260,378,5582
20150617,42090,42050,41900,41900,41660,41700,41750,-350,-300,784,5944
20150618,41700,41750,41740,42100,41580,42010,41840,260,90,280,5962
20150619,42010,41840,42020,42020,41650,41650,41740,-190,-100,1086,5972
20150623,41650,41740,41420,41850,41420,41790,41730,50,-10,356,5960
20150624,41790,41730,41750,42110,41660,42050,41920,320,190,554,6150
20150625,42050,41920,42040,42150,41380,41700,41770,-220,-150,648,6376
20150626,41700,41770,41460,42420,41440,42200,41850,430,80,722,6314
20150629,42200,41850,41990,42390,41870,42290,42030,440,180,782,6434
20150630,42290,42030,42130,42280,41760,41840,41980,-190,-50,904,6628
20150701,41840,41980,41710,42030,41370,41730,41720,-250,-260,716,6740
20150702,41730,41720,41700,42230,41660,42000,42010,280,290,722,6942
20150703,42000,42010,42040,42190,41850,42090,42040,80,30,446,7044
20150706,42090,42040,42010,42010,39810,40480,40800,-1560,-1240,2300,7776
20150707,40480,40800,40400,40530,39490,39530,40070,-1270,-730,3252,8912
20150708,39530,40070,39200,39200,37660,37820,38300,-2250,-1770,4106,9246
20150709,37820,38300,38020,40380,38020,40140,39800,1840,1500,3412,9362
20150710,40140,39800,40400,40830,39930,39970,40330,170,530,3404,10174
20150713,39970,40330,40020,40200,39280,39620,39600,-710,-730,2448,10850
20150714,39620,39600,39970,40080,39750,39760,39900,160,300,1532,11016
20150715,39760,39900,39700,40170,39600,40130,39910,230,10,2160,11292
20150716,40130,39910,40060,40130,39600,40070,39860,160,-50,2290,11570
20150717,40070,39860,39890,40060,39790,39960,39900,100,40,1130,11488
20150720,39960,39900,39650,39900,39080,39310,39350,-590,-550,3916,13004
20150721,39310,39350,39310,39670,39150,39540,39440,190,90,2210,13440
20150722,39540,39440,39390,39550,38610,38690,39210,-750,-230,3808,14414
20150723,38690,39210,38890,38960,38240,38650,38650,-560,-560,5010,15674
20150724,38650,38650,38580,38680,37330,37380,37740,-1270,-910,12088,20700
20150727,37380,37740,37690,38200,37490,37650,37870,-90,130,8796,20910
20150728,37650,37870,37410,37780,37140,37680,37520,-190,-350,6580,21018
20150729,37680,37520,37800,38990,37770,38440,38340,920,820,9552,20474
20150730,38440,38340,38430,38630,38100,38190,38340,-150,0,5526,20038
20150731,38190,38340,37990,38330,37830,37930,38040,-410,-300,5794,21226
20150803,37930,38040,38050,38360,37510,37510,37850,-530,-190,5836,22010
20150804,37510,37850,37510,37930,37330,37840,37630,-10,-220,9180,23064
20150805,37840,37630,38000,39200,37510,37770,37780,140,150,6176,23470
20150806,37770,37780,37860,37860,37530,37760,37680,-20,-100,4864,24216
20150807,37760,37680,37510,37750,36940,37500,37370,-180,-310,12800,25328
20150810,37500,37370,37360,37620,37090,37480,37390,110,20,11496,25540
20150811,37480,37390,37520,39080,37490,38690,38480,1300,1090,20998,26832
20150812,38690,38480,38330,39220,38140,39030,38600,550,120,18658,27986
20150813,39030,38600,39220,39700,38900,39280,39370,680,770,21968,27418
20150814,39280,39370,39150,39250,38930,38950,39120,-420,-250,7594,28134
20150817,38950,39120,39000,39170,38600,38800,38850,-320,-270,9544,28306
20150818,38800,38850,38350,38740,38350,38420,38580,-430,-270,11714,30150
20150819,38420,38580,38230,38340,37740,38280,38060,-300,-520,16926,30762
20150820,38280,38060,38380,38400,37910,38200,38160,140,100,12818,30960
20150821,38200,38160,38600,38790,38450,38520,38610,360,450,14928,32740
20150824,38520,38610,38480,38540,37330,37890,37920,-720,-690,29468,35278
20150825,37890,37920,37500,38730,37500,38500,38260,580,340,29420,36668
20150826,38500,38260,38990,39200,38550,38550,38830,290,570,25422,37956
20150827,38550,38830,38340,38690,37990,38610,38380,-220,-450,24508,37684
20150828,38610,38380,38650,39520,38550,39150,39140,770,760,31606,39782
20150831,39150,39140,39160,39400,38870,39090,39150,-50,10,21682,41106
20150901,39090,39150,38950,39370,38790,39020,39100,-130,-50,21312,40974
20150902,39020,39100,38760,39090,38760,38870,38900,-230,-200,17212,42642
20150907,38870,38900,38800,39260,38800,39200,39090,300,190,13376,44130
20150908,39200,39090,39300,39400,39060,39380,39240,290,150,17244,46014
20150909,39380,39240,39710,41500,39710,41060,40720,1820,1480,57392,50574
20150910,41060,40720,41170,41240,40610,40960,40860,240,140,37628,53688
20150911,40960,40860,40950,41140,40850,41040,41020,180,160,35956,56244
20150914,41040,41020,40770,41100,40500,40510,40760,-510,-260,34842,60396
20150915,40510,40760,40450,40610,40210,40250,40440,-510,-320,35568,61856
20150916,40250,40440,40360,40870,40320,40850,40560,410,120,34494,62012
20150917,40850,40560,40850,41270,40690,40920,40980,360,420,39780,63016
20150918,40920,40980,40800,41120,40610,40610,40830,-370,-150,33164,67018
20150921,40610,40830,40190,40470,39780,40200,40060,-630,-770,50018,66102
20150922,40200,40060,40200,40380,39780,39820,40060,-240,0,25130,68746
20150923,39820,40060,39200,39240,38140,38800,38530,-1260,-1530,69058,79528
20150924,38800,38530,38730,39060,38500,38740,38740,210,210,36594,81242
20150925,38740,38740,38510,38990,38400,38810,38750,70,10,50418,80522
20150928,38810,38750,38790,38860,38050,38100,38550,-650,-200,24154,83566
20150929,38100,38550,37600,38010,37490,37580,37710,-970,-840,55092,94798
20150930,37580,37710,37820,38390,37740,38290,38000,580,290,42654,98000
20151008,38290,38000,39300,39310,38770,38820,39040,820,1040,41320,98600
20151009,38820,39040,38780,40180,38520,40000,39530,960,490,109190,101820
20151012,40000,39530,40290,40330,39810,40080,39990,550,460,75634,106992
20151013,40080,39990,40090,40100,39440,39690,39670,-300,-320,69502,114702
20151014,39690,39670,39650,39860,39470,39550,39630,-120,-40,61800,118380
20151015,39550,39630,39680,40110,39640,39920,39920,290,290,68356,123318
20151016,39920,39920,39910,40050,39410,39480,39780,-440,-140,77198,129822
20151019,39480,39780,39480,39680,39190,39320,39420,-460,-360,84672,134020
20151020,39320,39420,39070,39220,38830,39130,39020,-290,-400,99496,141064
20151021,39130,39020,39190,39300,38740,38820,38970,-200,-50,110634,149446
20151022,38820,38970,38800,39350,38650,39210,39000,240,30,111328,148508
20151023,39210,39000,39360,39710,39200,39680,39430,680,430,161570,157772
20151026,39680,39430,39520,39590,38720,38990,39040,-440,-390,184010,169264
20151027,38990,39040,39050,39320,38730,39230,39000,190,-40,145386,175204
20151028,39230,39000,39210,39260,38750,38830,38990,-170,-10,157508,195504
20151029,38830,38990,38700,39230,38520,38930,38960,-60,-30,200626,208684
20151030,38930,38960,38790,38890,38500,38770,38680,-190,-280,200902,226344
20151102,38770,38680,38560,38720,38320,38500,38500,-180,-180,187276,241114
20151103,38500,38500,38520,38650,38360,38420,38500,-80,0,191210,260126
20151104,38420,38500,38480,38830,38240,38830,38530,330,30,331122,268036
20151105,38830,38530,38680,39110,38180,38220,38610,-310,80,515196,296380
20151106,38220,38610,37970,38280,37800,38030,37980,-580,-630,616296,281018
20151109,38030,37980,37940,38080,37580,37620,37850,-360,-130,558072,321632
20151110,37620,37850,37650,37880,37090,37570,37460,-280,-390,636506,312346
20151111,37570,37460,37500,37580,37050,37100,37330,-360,-130,613418,327070
20151112,37100,37330,37170,37500,37170,37310,37320,-20,-10,432018,312976
20151113,37310,37320,36860,36860,36170,36230,36480,-1090,-840,840792,334960
20151116,36230,36480,36490,36500,35960,36030,36250,-450,-230,537316,336568
20151117,36030,36250,36090,36190,34470,34970,35180,-1280,-1070,1162190,328468
20151118,34970,35180,35300,35370,34420,34880,34920,-300,-260,886530,328344
20151119,34880,34920,34840,35030,34210,34770,34680,-150,-240,841008,323048
20151120,34770,34680,34600,35170,34410,34910,34770,230,90,904142,291650
20151123,34910,34770,35100,35110,33260,33510,34040,-1260,-730,1070446,305014
20151124,33510,34040,33590,34080,33220,33850,33570,-190,-470,958020,279830
20151125,33850,33570,33770,34980,33700,34620,34470,1050,900,1128628,255662
20151126,34620,34470,34290,36140,34180,35210,35020,740,550,1111640,215440
20151127,35210,35020,35220,35680,34860,35380,35230,360,210,794122,197594
20151130,35380,35230,35180,35380,34380,34850,34880,-380,-350,771586,174024
cu1602,20150216,41410,41410,41350,41350,41350,41350,41350,-60,-60,8,8
20150217,41350,41350,41670,41670,41640,41640,41650,290,300,8,16
20150225,41640,41650,41570,41690,41240,41690,41580,40,-70,98,52
20150226,41690,41580,41700,42260,41700,42240,41960,660,380,32,72
20150227,42240,41960,42560,42560,42300,42440,42440,480,480,28,78
20150302,42440,42440,42620,42950,42490,42950,42720,510,280,28,100
20150303,42950,42720,42700,42810,42260,42290,42480,-430,-240,112,184
20150304,42290,42480,42160,42270,41970,42270,42160,-210,-320,40,194
20150305,42270,42160,41980,42370,41980,42300,42290,140,130,78,212
20150306,42300,42290,42220,42300,42110,42150,42260,-140,-30,314,460
20150309,42150,42260,41730,42130,41550,42090,41820,-170,-440,116,494
20150310,42090,41820,42150,42540,42100,42100,42240,280,420,308,614
20150311,42100,42240,41740,42090,41730,41900,41950,-340,-290,50,620
20150312,41900,41950,41910,42480,41710,42390,42130,440,180,108,712
20150313,42390,42130,42580,43110,42520,42960,42840,830,710,594,1016
20150316,42960,42840,42760,43110,42760,43100,42970,260,130,286,1244
20150317,43100,42970,42970,43240,42860,42890,43020,-80,50,424,1512
20150318,42890,43020,42530,42870,42160,42160,42560,-860,-460,280,1512
20150319,42160,42560,41980,42260,41890,42190,42090,-370,-470,92,1506
20150320,42190,42090,42350,42830,42290,42480,42570,390,480,70,1516
20150323,42480,42570,43110,44250,43080,43890,43890,1320,1320,150,1540
20150324,43890,43890,44030,44410,43860,44020,44100,130,210,98,1540
20150325,44020,44100,43950,43950,43640,43660,43800,-440,-300,94,1554
20150326,43660,43800,43830,43870,43760,43870,43800,70,0,62,1536
20150327,43870,43800,43930,44200,43480,43620,43750,-180,-50,128,1552
20150330,43620,43750,43500,43880,43380,43700,43590,-50,-160,50,1550
20150331,43700,43590,43750,43750,43520,43520,43650,-70,60,20,1558
20150401,43520,43650,43460,43550,43300,43420,43440,-230,-210,26,1562
20150402,43420,43440,43280,43720,43240,43610,43460,170,20,78,1572
20150403,43610,43460,43420,43480,43220,43220,43350,-240,-110,34,1578
20150407,43220,43350,43510,43510,43510,43510,43510,160,160,2,1576
20150408,43510,43510,43610,43700,43370,43480,43500,-30,-10,106,1580
20150409,43480,43500,43230,43300,43090,43280,43210,-220,-290,16,1580
20150410,43280,43210,43310,43490,43150,43460,43350,250,140,30,1570
20150413,43460,43350,43400,43790,43400,43590,43570,240,220,34,1572
20150414,43590,43570,43170,43200,42660,42800,42890,-770,-680,110,1596
20150415,42800,42890,42740,43030,42600,42890,42820,0,-70,50,1614
20150416,42890,42820,42820,43370,42820,43330,43200,510,380,32,1622
20150417,43330,43200,43590,43730,43590,43720,43640,520,440,34,1616
20150420,43720,43640,43600,43890,43600,43750,43800,110,160,60,1658
20150421,43750,43800,43200,43340,43140,43230,43260,-570,-540,96,1654
20150422,43230,43260,43040,43190,42980,43110,43080,-150,-180,76,1634
20150423,43110,43080,43100,43100,42540,42800,42900,-280,-180,350,1814
20150424,42800,42900,43150,43200,43000,43090,43150,190,250,20,1818
20150427,43090,43150,43420,43760,43390,43660,43630,510,480,50,1824
20150428,43660,43630,43740,44020,43510,43590,43670,-40,40,98,1826
20150429,43590,43670,43660,43750,43500,43500,43620,-170,-50,278,1926
20150430,43500,43620,43880,44120,43740,44120,43890,500,270,138,1958
20150504,44120,43890,45020,45430,45020,45400,45310,1510,1420,208,2000
20150505,45400,45310,45720,45720,45360,45470,45530,160,220,142,2074
20150506,45470,45530,45900,46150,45750,45840,45970,310,440,108,2094
20150507,45840,45970,45900,45900,45530,45680,45600,-290,-370,120,2058
20150508,45680,45600,45630,45780,45630,45740,45710,140,110,48,2078
20150511,45740,45710,45810,45810,45490,45580,45710,-130,0,66,2072
20150512,45580,45710,45600,45680,45530,45650,45610,-60,-100,52,2068
20150513,45650,45610,45850,46200,45850,46200,45910,590,300,70,2042
20150514,46200,45910,45810,45840,45730,45840,45810,-70,-100,72,2030
20150515,45840,45810,45990,46010,45710,46010,45910,200,100,38,2056
20150518,46010,45910,45850,46120,45850,46080,45950,170,40,106,2086
20150519,46080,45950,45920,45920,45750,45840,45790,-110,-160,130,2110
20150520,45840,45790,44860,45360,44620,44750,44880,-1040,-910,198,2164
20150521,44750,44880,44860,45070,44690,45070,44910,190,30,40,2162
20150522,45070,44910,45010,45010,45010,45010,45010,100,100,6,2168
20150525,45010,45010,44470,44640,44460,44640,44560,-370,-450,152,2090
20150526,44640,44560,44840,45040,44360,44360,44680,-200,120,96,2088
20150527,44360,44680,44130,44220,44020,44120,44100,-560,-580,72,2128
20150528,44120,44100,44220,44220,43940,44210,44020,110,-80,68,2156
20150529,44210,44020,44010,44150,44010,44140,44110,120,90,14,2156
20150601,44140,44110,43950,43990,43570,43610,43700,-500,-410,144,2196
20150602,43610,43700,43560,43680,43340,43680,43530,-20,-170,144,2222
20150603,43680,43530,43680,43810,43530,43530,43720,0,190,102,2206
20150604,43530,43720,43490,43590,43350,43450,43410,-270,-310,162,2264
20150605,43450,43410,43330,43330,42790,42790,42920,-620,-490,108,2286
20150608,42790,42920,42980,43220,42890,43170,43140,250,220,42,2294
20150609,43170,43140,43130,43320,43130,43320,43260,180,120,118,2338
20150610,43320,43260,43360,43400,43270,43330,43340,70,80,18,2334
20150611,43330,43340,43660,43660,43220,43220,43450,-120,110,42,2348
20150612,43220,43450,42960,42960,42550,42550,42690,-900,-760,122,2346
20150615,42550,42690,42660,42660,42080,42130,42470,-560,-220,102,2404
20150616,42130,42470,42010,42280,42000,42160,42100,-310,-370,210,2422
20150617,42160,42100,41870,41900,41700,41740,41790,-360,-310,200,2526
20150618,41740,41790,41750,42110,41600,42020,41820,230,30,104,2522
20150619,42020,41820,41920,42010,41700,41700,41790,-120,-30,182,2652
20150623,41700,41790,41620,41880,41620,41820,41800,30,10,166,2734
20150624,41820,41800,41710,42050,41710,42050,41910,250,110,114,2770
20150625,42050,41910,42100,42150,41480,41700,41840,-210,-70,144,2846
20150626,41700,41840,41640,42220,41640,42220,41860,380,20,152,2854
20150629,42220,41860,41990,42390,41920,42290,42070,430,210,158,2882
20150630,42290,42070,42190,42370,41800,41850,42010,-220,-60,106,2906
20150701,41850,42010,41660,42010,41500,41840,41790,-170,-220,208,3004
20150702,41840,41790,41740,42070,41710,41960,42000,170,210,84,2962
20150703,41960,42000,42080,42200,41850,42090,42050,90,50,162,2990
20150706,42090,42050,42000,42000,39740,40490,40700,-1560,-1350,1254,3356
20150707,40490,40700,40360,40500,39480,39500,40020,-1200,-680,638,3658
20150708,39500,40020,39480,39480,37610,37950,38200,-2070,-1820,1292,3824
20150709,37950,38200,38660,40400,38660,40140,39820,1940,1620,832,3998
20150710,40140,39820,40660,40830,39700,39700,40330,-120,510,262,4034
20150713,39700,40330,39900,40120,39400,39600,39610,-730,-720,392,4096
20150714,39600,39610,39950,40070,39760,39780,39910,170,300,454,4370
20150715,39780,39910,39700,40110,39600,40100,39950,190,40,766,4308
20150716,40100,39950,40030,40060,39560,40010,39880,60,-70,592,4452
20150717,40010,39880,39850,40030,39750,39930,39870,50,-10,390,4444
20150720,39930,39870,39370,39620,39080,39220,39300,-650,-570,1244,5120
20150721,39220,39300,39150,39600,39150,39530,39470,230,170,682,5152
20150722,39530,39470,39460,39500,38580,38650,39150,-820,-320,1332,5528
20150723,38650,39150,38640,38940,38230,38640,38560,-510,-590,582,5818
20150724,38640,38560,38600,38660,37340,37380,37800,-1180,-760,2318,6696
20150727,37380,37800,37700,38180,37510,37650,37850,-150,50,2194,6952
20150728,37650,37850,37360,37750,37100,37660,37500,-190,-350,1648,7158
20150729,37660,37500,37740,38910,37740,38410,38300,910,800,2482,7560
20150730,38410,38300,38200,38550,38070,38140,38300,-160,0,1336,7498
20150731,38140,38300,37720,38310,37720,37950,38060,-350,-240,2250,8484
20150803,37950,38060,38120,38330,37520,37610,37790,-450,-270,3212,9592
20150804,37610,37790,37570,37920,37340,37820,37560,30,-230,2486,10132
20150805,37820,37560,37990,38030,37540,37770,37750,210,190,838,10116
20150806,37770,37750,37820,37900,37560,37770,37710,20,-40,584,10120
20150807,37770,37710,37510,37730,36930,37490,37370,-220,-340,2808,10998
20150810,37490,37370,37340,37550,37060,37420,37400,50,30,2610,11360
20150811,37420,37400,37470,38950,37410,38620,38390,1220,990,3436,11612
20150812,38620,38390,38010,39150,38010,39000,38560,610,170,1756,11788
20150813,39000,38560,39260,39670,38880,39220,39350,660,790,3240,11480
20150814,39220,39350,39080,39220,38900,38930,39070,-420,-280,838,11328
20150817,38930,39070,39080,39130,38580,38740,38790,-330,-280,1110,11208
20150818,38740,38790,38580,38660,38340,38350,38520,-440,-270,878,11506
20150819,38350,38520,38210,38250,37690,38250,38000,-270,-520,1646,11670
20150820,38250,38000,38010,38310,37870,38160,38130,160,130,1634,11410
20150821,38160,38130,38570,38700,38420,38440,38560,310,430,2292,11450
20150824,38440,38560,38360,38440,37260,37900,37780,-660,-780,3706,12568
20150825,37900,37780,37600,38670,37530,38380,38240,600,460,3098,12920
20150826,38380,38240,39100,39100,38500,38500,38740,260,500,5496,14918
20150827,38500,38740,38340,38650,37940,38600,38360,-140,-380,3954,15918
20150828,38600,38360,38610,39460,38540,39100,39090,740,730,4426,16028
20150831,39100,39090,39090,39380,38850,39070,39170,-20,80,2844,16468
20150901,39070,39170,38740,39340,38740,39030,39100,-140,-70,2514,16396
20150902,39030,39100,38870,39030,38770,38810,38860,-290,-240,1180,16548
20150907,38810,38860,38850,39200,38800,39190,39030,330,170,894,16614
20150908,39190,39030,39270,39350,39040,39330,39220,300,190,1078,16628
20150909,39330,39220,39790,41420,39790,41020,40730,1800,1510,4868,16804
20150910,41020,40730,41120,41150,40600,40980,40800,250,70,2684,17206
20150911,40980,40800,40970,41130,40840,41020,40990,220,190,3784,17820
20150914,41020,40990,40990,41060,40470,40500,40730,-490,-260,4264,18290
20150915,40500,40730,40430,40580,40190,40200,40400,-530,-330,3182,18892
20150916,40200,40400,40290,40830,40290,40830,40560,430,160,6386,19956
20150917,40830,40560,40850,41240,40680,40910,40950,350,390,4868,20018
20150918,40910,40950,40870,41090,40580,40610,40770,-340,-180,6554,20420
20150921,40610,40770,40130,40430,39760,40200,40010,-570,-760,10340,22276
20150922,40200,40010,40250,40320,39730,39790,39970,-220,-40,5762,23600
20150923,39790,39970,39100,39180,38110,38790,38550,-1180,-1420,13018,25704
20150924,38790,38550,38760,39020,38480,38700,38690,150,140,4644,26146
20150925,38700,38690,38480,38920,38340,38740,38630,50,-60,7018,26892
20150928,38740,38630,38620,38780,38150,38160,38470,-470,-160,4532,27674
20150929,38160,38470,37800,37920,37440,37510,37640,-960,-830,9980,31702
20150930,37510,37640,37860,38310,37690,38160,37970,520,330,8952,34250
20151008,38160,37970,38930,39210,38680,38730,38950,760,980,9078,36102
20151009,38730,38950,38740,40090,38460,39870,39450,920,500,14688,39042
20151012,39870,39450,40230,40230,39740,40010,39900,560,450,21560,42422
20151013,40010,39900,40010,40010,39380,39560,39550,-340,-350,8708,45218
20151014,39560,39550,39520,39780,39400,39480,39520,-70,-30,10890,47696
20151015,39480,39520,39580,40030,39580,39820,39880,300,360,9202,48534
20151016,39820,39880,39820,39980,39360,39420,39740,-460,-140,8884,49764
20151019,39420,39740,39420,39620,39130,39240,39330,-500,-410,12672,51832
20151020,39240,39330,39020,39140,38770,39050,38950,-280,-380,16552,56976
20151021,39050,38950,39050,39220,38680,38750,38870,-200,-80,15396,61006
20151022,38750,38870,38720,39270,38580,39150,38950,280,80,16232,63558
20151023,39150,38950,39300,39640,39130,39590,39370,640,420,19254,64798
20151026,39590,39370,39540,39540,38660,38930,38960,-440,-410,21668,67298
20151027,38930,38960,38960,39230,38670,39150,38920,190,-40,17516,71854
20151028,39150,38920,39120,39170,38660,38760,38860,-160,-60,29950,81274
20151029,38760,38860,38650,39140,38450,38860,38880,0,20,25294,86514
20151030,38860,38880,38620,38800,38430,38670,38590,-210,-290,29954,92952
20151102,38670,38590,38500,38640,38250,38430,38400,-160,-190,28600,100284
20151103,38430,38400,38460,38570,38300,38360,38440,-40,40,18782,101738
20151104,38360,38440,38410,38750,38170,38740,38490,300,50,31246,103136
20151105,38740,38490,38600,39030,38120,38150,38520,-340,30,46624,111222
20151106,38150,38520,37880,38190,37730,37960,37900,-560,-620,54998,117590
20151109,37960,37900,37840,38020,37510,37550,37760,-350,-140,50686,124746
20151110,37550,37760,37600,37810,37000,37510,37370,-250,-390,109366,141786
20151111,37510,37370,37410,37500,37010,37020,37270,-350,-100,87448,148674
20151112,37020,37270,37150,37410,37110,37230,37250,-40,-20,81678,151588
20151113,37230,37250,36850,36850,36120,36180,36410,-1070,-840,165012,174786
20151116,36180,36410,36380,36430,35920,35970,36200,-440,-210,124562,180188
20151117,35970,36200,36050,36130,34440,34960,35140,-1240,-1060,289892,195604
20151118,34960,35140,35260,35350,34390,34830,34850,-310,-290,227704,214448
20151119,34830,34850,34800,34990,34180,34720,34620,-130,-230,218114,217742
20151120,34720,34620,34590,35140,34360,34850,34720,230,100,276042,232002
20151123,34850,34720,35170,35170,33200,33410,33950,-1310,-770,361698,273868
20151124,33410,33950,33530,34020,33150,33780,33530,-170,-420,325438,277000
20151125,33780,33530,33680,34950,33650,34580,34420,1050,890,481410,263136
20151126,34580,34420,34200,36090,34150,35140,35020,720,600,568624,247138
20151127,35140,35020,35150,35640,34810,35350,35200,330,180,402510,249442
20151130,35350,35200,35100,35340,34310,34740,34800,-460,-400,517620,297004
cu1603,20150317,42970,42970,42990,43320,42810,42810,43060,-160,90,12,6
20150318,42810,43060,42830,42890,42200,42200,42690,-860,-370,654,442
20150319,42200,42690,42130,42320,41800,42200,42240,-490,-450,426,776
20150320,42200,42240,42880,42890,42530,42660,42660,420,420,54,820
20150323,42660,42660,42990,44150,42990,43900,43890,1240,1230,130,862
20150324,43900,43890,44090,44600,43960,44040,44270,150,380,206,976
20150325,44040,44270,44020,44060,43710,43850,43870,-420,-400,126,998
20150326,43850,43870,43850,44040,43780,43860,43830,-10,-40,64,1016
20150327,43860,43830,43940,43950,43500,43700,43690,-130,-140,38,1010
20150330,43700,43690,43670,43910,43370,43850,43580,160,-110,88,1038
20150331,43850,43580,43970,43970,43510,43510,43680,-70,100,48,1054
20150401,43510,43680,43390,43630,43340,43490,43510,-190,-170,78,1072
20150402,43490,43510,43360,43720,43260,43700,43520,190,10,56,1088
20150403,43700,43520,43480,43530,43230,43330,43390,-190,-130,116,1092
20150407,43330,43390,43590,43590,43510,43520,43530,130,140,18,1098
20150408,43520,43530,43660,43720,43380,43480,43530,-50,0,102,1124
20150409,43480,43530,43340,43340,43250,43300,43290,-230,-240,20,1124
20150410,43300,43290,43330,43550,43320,43410,43410,120,120,102,1166
20150413,43410,43410,43430,43800,43430,43480,43630,70,220,22,1160
20150414,43480,43630,43620,43620,42600,42850,43120,-780,-510,108,1184
20150415,42850,43120,42650,42950,42550,42940,42800,-180,-320,34,1182
20150416,42940,42800,42490,43720,42480,43310,43090,510,290,108,1214
20150417,43310,43090,43640,43810,43550,43630,43640,540,550,144,1248
20150420,43630,43640,43500,43890,43500,43770,43790,130,150,160,1250
20150421,43770,43790,43370,43440,43150,43320,43300,-470,-490,188,1258
20150422,43320,43300,43150,43220,43030,43220,43160,-80,-140,44,1264
20150423,43220,43160,43170,43170,42550,42880,42970,-280,-190,292,1466
20150424,42880,42970,43110,43310,43080,43190,43140,220,170,84,1460
20150427,43190,43140,43480,43880,43430,43690,43630,550,490,72,1468
20150428,43690,43630,43510,44040,43490,43580,43710,-50,80,134,1432
20150429,43580,43710,43490,43790,43490,43610,43660,-100,-50,56,1426
20150430,43610,43660,43900,44070,43850,44070,43960,410,300,48,1416
20150504,44070,43960,45010,45510,45010,45510,45290,1550,1330,82,1416
20150505,45510,45290,45580,45580,45440,45530,45510,240,220,24,1408
20150506,45530,45510,45810,46160,45800,46060,45890,550,380,84,1392
20150507,46060,45890,45920,45990,45600,45750,45710,-140,-180,64,1394
20150508,45750,45710,45820,45820,45680,45800,45760,90,50,34,1390
20150511,45800,45760,45620,45770,45540,45640,45600,-120,-160,14,1388
20150512,45640,45600,45570,45770,45520,45770,45640,170,40,36,1400
20150513,45770,45640,45970,46200,45830,46200,46010,560,370,64,1426
20150514,46200,46010,46170,46170,45800,45930,45910,-80,-100,64,1436
20150515,45930,45910,46040,46040,45750,46000,45850,90,-60,18,1440
20150518,46000,45850,45820,46060,45820,46050,45930,200,80,38,1440
20150519,46050,45930,46000,46000,45760,45880,45860,-50,-70,58,1452
20150520,45880,45860,45360,45360,44750,44750,44990,-1110,-870,62,1466
20150521,44750,44990,44870,45100,44830,45100,45010,110,20,116,1464
20150522,45100,45010,45160,45210,45020,45080,45110,70,100,56,1458
20150525,45080,45110,44560,44660,44460,44590,44560,-520,-550,126,1466
20150526,44590,44560,44700,45020,44450,44450,44730,-110,170,80,1494
20150527,44450,44730,44070,44260,44070,44230,44120,-500,-610,232,1526
20150528,44230,44120,44110,44270,43950,44270,44070,150,-50,114,1534
20150529,44270,44070,44130,44250,43980,44250,44170,180,100,52,1520
20150601,44250,44170,44110,44110,43620,43710,43780,-460,-390,40,1520
20150602,43710,43780,43670,43810,43540,43730,43630,-50,-150,194,1636
20150603,43730,43630,43760,43850,43590,43590,43740,-40,110,28,1642
20150604,43590,43740,43490,43550,43420,43480,43430,-260,-310,156,1744
20150605,43480,43430,43460,43460,42890,42950,43080,-480,-350,64,1752
20150608,42950,43080,43260,43260,43160,43220,43210,140,130,68,1758
20150609,43220,43210,43170,43400,43170,43310,43280,100,70,190,1806
20150610,43310,43280,43390,43500,43290,43350,43360,70,80,60,1820
20150611,43350,43360,43640,43710,43400,43400,43570,40,210,82,1820
20150612,43400,43570,42970,42980,42530,42530,42710,-1040,-860,136,1834
20150615,42530,42710,42620,42620,42140,42250,42390,-460,-320,46,1808
20150616,42250,42390,42070,42250,42010,42200,42140,-190,-250,170,1914
20150617,42200,42140,41890,41920,41700,41920,41830,-220,-310,92,1942
20150618,41920,41830,41860,42130,41700,42100,41930,270,100,162,1896
20150619,42100,41930,42070,42070,41780,41800,41880,-130,-50,56,1902
20150623,41800,41880,41720,41940,41720,41850,41860,-30,-20,176,1892
20150624,41850,41860,42090,42090,41830,42020,41950,160,90,196,1888
20150625,42020,41950,42220,42220,41400,41540,41610,-410,-340,32,1888
20150626,41540,41610,41720,42410,41650,42210,41890,600,280,94,1864
20150629,42210,41890,41930,42440,41930,42370,42120,480,230,288,1894
20150630,42370,42120,42250,42250,41820,41820,41980,-300,-140,122,1886
20150701,41820,41980,41720,42050,41430,41980,41870,0,-110,124,1894
20150702,41980,41870,41760,42050,41760,42050,42010,180,140,72,1862
20150703,42050,42010,42050,42200,41900,42100,42110,90,100,248,1926
20150706,42100,42110,41760,41810,39860,40490,40760,-1620,-1350,372,2110
20150707,40490,40760,40420,40490,39470,39470,40040,-1290,-720,458,2346
20150708,39470,40040,38760,39960,37630,37760,38240,-2280,-1800,850,2364
20150709,37760,38240,38480,40350,38480,40160,39910,1920,1670,382,2500
20150710,40160,39910,40960,40970,39970,39970,40360,60,450,302,2568
20150713,39970,40360,40050,40050,39420,39460,39660,-900,-700,306,2672
20150714,39460,39660,39840,40030,39750,39750,39870,90,210,124,2690
20150715,39750,39870,39640,40100,39610,40100,39910,230,40,346,2778
20150716,40100,39910,40050,40080,39620,40060,39900,150,-10,306,2896
20150717,40060,39900,39840,40000,39770,39940,39850,40,-50,118,2938
20150720,39940,39850,39490,39600,39030,39210,39300,-640,-550,144,2890
20150721,39210,39300,39130,39620,39130,39480,39450,180,150,120,2946
20150722,39480,39450,39410,39420,38580,38690,38870,-760,-580,222,2980
20150723,38690,38870,38500,38930,38250,38660,38530,-210,-340,230,3104
20150724,38660,38530,38580,38640,37340,37420,37710,-1110,-820,798,3528
20150727,37420,37710,37750,38170,37580,37610,37870,-100,160,538,3798
20150728,37610,37870,37290,37730,37200,37650,37580,-220,-290,514,3984
20150729,37650,37580,37800,38920,37800,38400,38390,820,810,536,4070
20150730,38400,38390,38270,38540,38080,38110,38300,-280,-90,454,4162
20150731,38110,38300,37610,38250,37610,37940,38030,-360,-270,618,4642
20150803,37940,38030,38110,38300,37530,37610,37770,-420,-260,932,4950
20150804,37610,37770,37600,37850,37370,37810,37590,40,-180,770,5282
20150805,37810,37590,38050,38050,37580,37750,37800,160,210,176,5306
20150806,37750,37800,37780,37880,37580,37780,37780,-20,-20,200,5428
20150807,37780,37780,37610,37690,36950,37500,37410,-280,-370,594,5698
20150810,37500,37410,37340,37550,37050,37360,37390,-50,-20,1386,6300
20150811,37360,37390,37350,38940,37350,38620,38420,1230,1030,2650,6596
20150812,38620,38420,38010,39100,38010,38960,38510,540,90,950,6646
20150813,38960,38510,39370,39650,38910,39190,39200,680,690,758,6834
20150814,39190,39200,39070,39200,38950,38960,39040,-240,-160,282,6882
20150817,38960,39040,39020,39120,38580,38700,38750,-340,-290,676,7070
20150818,38700,38750,38560,38600,38330,38330,38530,-420,-220,626,7214
20150819,38330,38530,38230,38230,37700,38200,37960,-330,-570,1054,7244
20150820,38200,37960,38000,38270,37900,38070,38040,110,80,776,7262
20150821,38070,38040,38600,38650,38400,38410,38470,370,430,428,7356
20150824,38410,38470,38220,38300,37250,37890,37770,-580,-700,1054,7718
20150825,37890,37770,37650,38640,37490,38310,37890,540,120,1116,7924
20150826,38310,37890,38990,39050,38490,38490,38730,600,840,1450,8358
20150827,38490,38730,38320,38650,37950,38590,38440,-140,-290,2302,9710
20150828,38590,38440,38550,39450,38550,39090,39050,650,610,3428,10766
20150831,39090,39050,39020,39360,38850,39060,39130,10,80,630,10806
20150901,39060,39130,38880,39300,38760,38980,39130,-150,0,1546,10900
20150902,38980,39130,38870,38990,38780,38840,38850,-290,-280,376,10974
20150907,38840,38850,38800,39160,38800,39160,39040,310,190,488,11122
20150908,39160,39040,39260,39310,39040,39310,39210,270,170,308,11180
20150909,39310,39210,39680,41420,39680,41020,40760,1810,1550,1612,11576
20150910,41020,40760,41140,41140,40600,40930,40810,170,50,1314,11744
20150911,40930,40810,40910,41100,40840,41030,40990,220,180,1716,12376
20150914,41030,40990,40720,41050,40500,40500,40730,-490,-260,806,12464
20150915,40500,40730,40450,40520,40200,40210,40390,-520,-340,716,12606
20150916,40210,40390,40390,40790,40310,40790,40510,400,120,680,12554
20150917,40790,40510,40760,41200,40690,40880,40910,370,400,872,12620
20150918,40880,40910,40660,41080,40600,40600,40770,-310,-140,2684,14556
20150921,40600,40770,40340,40430,39760,40150,40010,-620,-760,3068,15270
20150922,40150,40010,40220,40300,39710,39710,40050,-300,40,2054,15446
20150923,39710,40050,39140,39150,38110,38770,38520,-1280,-1530,5124,16946
20150924,38770,38520,38730,38980,38480,38670,38660,150,140,872,17336
20150925,38670,38660,38670,38930,38340,38700,38690,40,30,2172,17972
20150928,38700,38690,38690,38720,38080,38400,38440,-290,-250,700,18246
20150929,38400,38440,37650,37870,37420,37530,37600,-910,-840,3176,20170
20150930,37530,37600,37830,38250,37660,38110,37950,510,350,2824,20522
20151008,38110,37950,38920,39160,38620,38650,38900,700,950,1732,19946
20151009,38650,38900,38630,40000,38390,39780,39390,880,490,3378,19778
20151012,39780,39390,40200,40200,39680,39980,39850,590,460,10378,20260
20151013,39980,39850,39980,39980,39310,39540,39490,-310,-360,1924,20720
20151014,39540,39490,39450,39700,39340,39690,39500,200,10,1530,21238
20151015,39690,39500,39620,39980,39520,39740,39850,240,350,1574,21376
20151016,39740,39850,39750,39920,39300,39360,39630,-490,-220,2026,22212
20151019,39360,39630,39380,39560,39030,39380,39270,-250,-360,4066,23290
20151020,39380,39270,38950,39080,38720,38990,38900,-280,-370,4418,24418
20151021,38990,38900,38990,39140,38630,38700,38790,-200,-110,3882,25440
20151022,38700,38790,38690,39190,38520,39050,38870,260,80,5636,26852
20151023,39050,38870,39270,39550,39060,39510,39310,640,440,6334,28630
20151026,39510,39310,39400,39460,38590,38860,38880,-450,-430,7454,29756
20151027,38860,38880,38910,39140,38600,39090,38850,210,-30,4738,29638
20151028,39090,38850,39000,39080,38600,38650,38800,-200,-50,3438,30090
20151029,38650,38800,38570,39060,38360,38810,38800,10,0,6728,31992
20151030,38810,38800,38580,38730,38360,38630,38510,-170,-290,6800,33134
20151102,38630,38510,38450,38560,38180,38370,38320,-140,-190,8318,34680
20151103,38370,38320,38370,38490,38210,38310,38380,-10,60,4956,36516
20151104,38310,38380,38350,38700,38110,38700,38410,320,30,6506,38010
20151105,38700,38410,38540,38950,38050,38050,38410,-360,0,11436,39678
20151106,38050,38410,37870,38080,37650,37890,37820,-520,-590,15470,42876
20151109,37890,37820,37780,37910,37440,37500,37680,-320,-140,13918,47254
20151110,37500,37680,37570,37720,36950,37450,37270,-230,-410,17768,51530
20151111,37450,37270,37280,37430,36960,36970,37200,-300,-70,14650,54774
20151112,36970,37200,37080,37310,37060,37180,37190,-20,-10,10564,56872
20151113,37180,37190,36770,36770,36100,36180,36340,-1010,-850,27978,63918
20151116,36180,36340,36360,36380,35910,35950,36160,-390,-180,20238,67464
20151117,35950,36160,36080,36090,34410,34930,35080,-1230,-1080,59736,77910
20151118,34930,35080,35280,35340,34370,34830,34780,-250,-300,48158,81818
20151119,34830,34780,34710,34930,34150,34660,34560,-120,-220,55236,88554
20151120,34660,34560,34550,35070,34320,34780,34690,220,130,48114,91278
20151123,34780,34690,34890,35050,33160,33390,33900,-1300,-790,91902,106882
20151124,33390,33900,33490,33990,33110,33740,33500,-160,-400,109966,111460
20151125,33740,33500,33660,34880,33620,34550,34410,1050,910,146480,117068
20151126,34550,34410,34060,36040,34060,35080,35030,670,620,163954,123260
20151127,35080,35030,35080,35600,34770,35300,35160,270,130,120350,129212
20151130,35300,35160,35060,35290,34250,34670,34750,-490,-410,120760,136502
cu1604,20150416,42800,42800,42840,43440,42840,43400,43300,600,500,10,6
20150417,43400,43300,43800,43800,43790,43790,43790,490,490,28,26
20150420,43790,43790,43890,43890,43800,43810,43850,20,60,78,102
20150421,43810,43850,43350,43500,43310,43310,43410,-540,-440,48,126
20150422,43310,43410,43190,43250,43120,43190,43200,-220,-210,28,134
20150423,43190,43200,43200,43200,42680,42910,43020,-290,-180,242,312
20150424,42910,43020,43150,43290,43000,43150,43130,130,110,42,296
20150427,43150,43130,43360,43790,43360,43750,43660,620,530,20,302
20150428,43750,43660,43780,43980,43530,43540,43700,-120,40,100,332
20150429,43540,43700,43710,43850,43530,43560,43710,-140,10,70,356
20150430,43560,43710,43720,44100,43720,44090,43960,380,250,128,350
20150504,44090,43960,45190,45660,45170,45660,45330,1700,1370,24,364
20150505,45660,45330,45640,45640,45420,45580,45510,250,180,94,416
20150506,45580,45510,45680,46220,45680,46100,45970,590,460,172,530
20150507,46100,45970,45940,45940,45690,45750,45770,-220,-200,36,540
20150508,45750,45770,,,,45770,45770,0,0,0,540
20150511,45770,45770,45560,45730,45560,45730,45620,-40,-150,46,546
20150512,45730,45620,45680,45730,45680,45690,45700,70,80,6,550
20150513,45690,45700,45900,46230,45870,46140,45990,440,290,32,568
20150514,46140,45990,46180,46180,45820,45940,45850,-50,-140,96,632
20150515,45940,45850,45900,46050,45750,46050,45970,200,120,30,654
20150518,46050,45970,45990,46090,45880,46030,45940,60,-30,40,660
20150519,46030,45940,45890,45900,45790,45900,45840,-40,-100,110,724
20150520,45900,45840,45400,45400,44710,44740,44920,-1100,-920,68,700
20150521,44740,44920,45000,45160,45000,45080,45080,160,160,70,680
20150522,45080,45080,45140,45180,45100,45150,45130,70,50,34,666
20150525,45150,45130,44680,44680,44580,44580,44630,-550,-500,44,680
20150526,44580,44630,44850,44850,44490,44490,44650,-140,20,18,684
20150527,44490,44650,43970,44280,43970,44180,44130,-470,-520,52,682
20150528,44180,44130,44170,44170,44030,44110,44130,-20,0,30,686
20150529,44110,44130,44160,44160,44160,44160,44160,30,30,2,684
20150601,44160,44160,44040,44060,43620,43700,43820,-460,-340,210,804
20150602,43700,43820,43760,43830,43440,43760,43600,-60,-220,162,846
20150603,43760,43600,43830,43880,43600,43600,43790,0,190,96,858
20150604,43600,43790,43510,43660,43410,43610,43520,-180,-270,152,972
20150605,43610,43520,43380,43410,42880,42900,43050,-620,-470,48,974
20150608,42900,43050,42910,43280,42910,43230,43120,180,70,26,972
20150609,43230,43120,43250,43440,43250,43350,43380,230,260,72,1018
20150610,43350,43380,43410,43460,43370,43380,43410,0,30,40,1022
20150611,43380,43410,43660,43750,43410,43410,43560,0,150,44,1056
20150612,43410,43560,43080,43080,42580,42580,42740,-980,-820,88,1064
20150615,42580,42740,42660,42710,42250,42250,42500,-490,-240,84,1058
20150616,42250,42500,42230,42370,42110,42240,42180,-260,-320,174,1114
20150617,42240,42180,41970,42000,41770,41770,41860,-410,-320,168,1108
20150618,41770,41860,41650,42210,41650,42120,42120,260,260,62,1128
20150619,42120,42120,42030,42030,41850,41880,41880,-240,-240,96,1192
20150623,41880,41880,41720,41970,41720,41970,41890,90,10,66,1174
20150624,41970,41890,42060,42140,41900,42140,41970,250,80,150,1192
20150625,42140,41970,42210,42240,41470,41770,41830,-200,-140,76,1212
20150626,41770,41830,41780,42410,41780,42230,42050,400,220,64,1210
20150629,42230,42050,42090,42480,42030,42480,42150,430,100,118,1244
20150630,42480,42150,42260,42260,41970,41970,42040,-180,-110,214,1330
20150701,41970,42040,41870,42060,41750,41750,41870,-290,-170,70,1336
20150702,41750,41870,41750,42070,41720,42040,41970,170,100,90,1316
20150703,42040,41970,42070,42190,41880,42140,42080,170,110,214,1274
20150706,42140,42080,41820,41820,40000,40490,40820,-1590,-1260,246,1372
20150707,40490,40820,40380,40500,39500,39530,40120,-1290,-700,232,1452
20150708,39530,40120,39090,39100,37710,38100,38170,-2020,-1950,570,1626
20150709,38100,38170,38780,40400,38780,40230,39940,2060,1770,346,1756
20150710,40230,39940,40450,40870,39990,40120,40400,180,460,332,1870
20150713,40120,40400,40070,40100,39450,39610,39620,-790,-780,634,2232
20150714,39610,39620,39970,40100,39750,39760,39850,140,230,152,2236
20150715,39760,39850,39650,40110,39650,40050,39950,200,100,272,2328
20150716,40050,39950,40040,40040,39650,39990,39870,40,-80,252,2442
20150717,39990,39870,39780,39980,39780,39850,39860,-20,-10,98,2430
20150720,39850,39860,39500,39650,39000,39170,39370,-690,-490,140,2420
20150721,39170,39370,39330,39550,39330,39520,39470,150,100,92,2454
20150722,39520,39470,39380,39380,38660,38700,38870,-770,-600,108,2532
20150723,38700,38870,38800,38860,38260,38860,38620,-10,-250,92,2536
20150724,38860,38620,38500,38500,37530,37550,37760,-1070,-860,332,2736
20150727,37550,37760,37760,38070,37630,37750,37880,-10,120,142,2824
20150728,37750,37880,37400,37710,37400,37560,37600,-320,-280,160,2828
20150729,37560,37600,38250,38950,38250,38510,38580,910,980,94,2842
20150730,38510,38580,38180,38600,38100,38110,38220,-470,-360,146,2852
20150731,38110,38220,37970,38220,37950,38000,38090,-220,-130,432,3192
20150803,38000,38090,38140,38320,37540,37540,37700,-550,-390,346,3368
20150804,37540,37700,37590,37950,37420,37840,37620,140,-80,394,3540
20150805,37840,37620,37990,37990,37610,37800,37840,180,220,192,3598
20150806,37800,37840,37650,37880,37630,37780,37780,-60,-60,194,3692
20150807,37780,37780,37550,37550,37000,37530,37400,-250,-380,646,3960
20150810,37530,37400,37360,37500,37160,37260,37400,-140,0,1122,4416
20150811,37260,37400,37430,38850,37350,38500,38160,1100,760,872,4306
20150812,38500,38160,38080,39050,38040,38980,38450,820,290,600,4218
20150813,38980,38450,39500,39530,38890,39160,39300,710,850,236,4164
20150814,39160,39300,39140,39150,38930,38940,39040,-360,-260,172,4222
20150817,38940,39040,39070,39160,38590,38680,38760,-360,-280,264,4318
20150818,38680,38760,38590,38600,38340,38340,38480,-420,-280,202,4428
20150819,38340,38480,38100,38200,37740,38200,37980,-280,-500,322,4520
20150820,38200,37980,38150,38240,37880,38060,37960,80,-20,300,4532
20150821,38060,37960,38570,38570,38400,38410,38440,450,480,98,4520
20150824,38410,38440,38170,38220,37260,37860,37780,-580,-660,360,4592
20150825,37860,37780,37600,38510,37560,38290,38040,510,260,512,4618
20150826,38290,38040,39030,39040,38500,38500,38770,460,730,288,4618
20150827,38500,38770,38200,38590,37940,38370,38400,-400,-370,164,4672
20150828,38370,38400,38530,39370,38530,38950,39070,550,670,518,4684
20150831,38950,39070,39030,39330,38900,39080,39140,10,70,334,4780
20150901,39080,39140,38920,39300,38850,39000,39040,-140,-100,416,4984
20150902,39000,39040,38870,38880,38750,38810,38810,-230,-230,150,5042
20150907,38810,38810,39070,39150,39000,39150,39070,340,260,34,5046
20150908,39150,39070,39160,39260,39050,39240,39190,170,120,30,5050
20150909,39240,39190,39890,41270,39850,40970,40650,1780,1460,572,5100
20150910,40970,40650,40970,41020,40610,40950,40810,300,160,100,5114
20150911,40950,40810,40980,41080,40900,40990,40990,180,180,144,5168
20150914,40990,40990,40770,40980,40520,40530,40620,-460,-370,196,5176
20150915,40530,40620,40450,41050,40220,40220,40400,-400,-220,474,5342
20150916,40220,40400,40350,40800,40350,40800,40540,400,140,214,5370
20150917,40800,40540,40800,41170,40770,40940,40940,400,400,232,5378
20150918,40940,40940,41000,41040,40600,40610,40720,-330,-220,850,5918
20150921,40610,40720,40380,40380,39760,40140,40030,-580,-690,1916,6592
20150922,40140,40030,40210,40270,39720,39750,39990,-280,-40,1196,7150
20150923,39750,39990,39100,39100,38100,38740,38490,-1250,-1500,1160,7036
20150924,38740,38490,38640,38950,38470,38650,38670,160,180,324,7080
20150925,38650,38670,38390,38890,38350,38650,38720,-20,50,1162,7742
20150928,38650,38720,38620,38720,38100,38110,38440,-610,-280,310,7738
20150929,38110,38440,37640,37850,37400,37510,37570,-930,-870,2244,8502
20150930,37510,37570,37820,38220,37490,38060,37900,490,330,1888,8868
20151008,38060,37900,39040,39050,38600,38600,38860,700,960,674,8786
20151009,38600,38860,38590,39900,38350,39790,39130,930,270,834,8656
20151012,39790,39130,39950,39990,39660,39940,39810,810,680,1780,9362
20151013,39940,39810,39840,39840,39280,39470,39470,-340,-340,600,9504
20151014,39470,39470,39450,39630,39320,39360,39430,-110,-40,438,9588
20151015,39360,39430,39460,39910,39460,39820,39760,390,330,586,9782
20151016,39820,39760,39760,39870,39340,39340,39650,-420,-110,258,9864
20151019,39340,39650,39450,39500,39100,39160,39230,-490,-420,642,10150
20151020,39160,39230,38810,39020,38700,38920,38830,-310,-400,414,10356
20151021,38920,38830,38910,39080,38600,38620,38720,-210,-110,414,10440
20151022,38620,38720,38650,39140,38500,39010,38980,290,260,1414,11312
20151023,39010,38980,39260,39510,39100,39460,39340,480,360,1924,12436
20151026,39460,39340,39400,39400,38600,38820,38880,-520,-460,1272,12750
20151027,38820,38880,38840,39090,38550,39010,38800,130,-80,2326,13842
20151028,39010,38800,38990,39000,38560,38620,38740,-180,-60,1182,14000
20151029,38620,38740,38540,39000,38320,38750,38760,10,20,1116,13980
20151030,38750,38760,38600,38620,38320,38580,38420,-180,-340,1764,14208
20151102,38580,38420,38500,38520,38130,38270,38230,-150,-190,1752,15056
20151103,38270,38230,38270,38440,38180,38260,38320,30,90,906,15398
20151104,38260,38320,38290,38650,38070,38650,38390,330,70,678,15414
20151105,38650,38390,38500,38870,37990,37990,38440,-400,50,2848,16550
20151106,37990,38440,37740,38000,37580,37800,37760,-640,-680,4834,17994
20151109,37800,37760,37690,37840,37410,37430,37590,-330,-170,2188,18578
20151110,37430,37590,37490,37660,36910,37380,37260,-210,-330,3878,19046
20151111,37380,37260,37180,37390,36920,36920,37150,-340,-110,5694,20674
20151112,36920,37150,37020,37250,37000,37140,37120,-10,-30,4344,21890
20151113,37140,37120,36700,36700,36080,36150,36310,-970,-810,7014,24262
20151116,36150,36310,36330,36350,35860,35910,36140,-400,-170,8180,27016
20151117,35910,36140,36060,36060,34410,34910,35110,-1230,-1030,15506,30968
20151118,34910,35110,35490,35490,34330,34830,34690,-280,-420,14802,35784
20151119,34830,34690,34690,34870,34120,34600,34530,-90,-160,15290,38192
20151120,34600,34530,34500,35040,34300,34720,34700,190,170,10852,40226
20151123,34720,34700,34940,34940,33150,33300,33750,-1400,-950,20220,44058
20151124,33300,33750,33420,33950,33080,33700,33470,-50,-280,19258,45960
20151125,33700,33470,33630,34840,33620,34540,34410,1070,940,20744,46904
20151126,34540,34410,34130,36010,34100,35080,34980,670,570,26724,46020
20151127,35080,34980,35170,35550,34750,35250,35140,270,160,26106,49418
20151130,35250,35140,35030,35250,34210,34660,34680,-480,-460,30460,54356
cu1605,20150518,45970,45970,46100,46100,46100,46100,46100,130,130,2,2
20150519,46100,46100,45850,46040,45800,45820,45830,-280,-270,176,170
20150520,45820,45830,45180,45180,44370,44790,44900,-1040,-930,120,254
20150521,44790,44900,44750,45130,44750,45100,45090,200,190,86,302
20150522,45100,45090,45200,45290,45050,45130,45130,40,40,86,310
20150525,45130,45130,44600,44740,44430,44640,44640,-490,-490,100,342
20150526,44640,44640,44770,44860,44490,44490,44680,-150,40,46,332
20150527,44490,44680,44380,44380,44070,44370,44230,-310,-450,108,388
20150528,44370,44230,44080,44260,44050,44090,44120,-140,-110,82,420
20150529,44090,44120,44000,44320,44000,44300,44260,180,140,82,454
20150601,44300,44260,44070,44080,43680,43700,43830,-560,-430,102,502
20150602,43700,43830,43630,43760,43440,43760,43610,-70,-220,82,518
20150603,43760,43610,43840,43890,43700,43700,43780,90,170,22,520
20150604,43700,43780,43600,43610,43450,43530,43580,-250,-200,132,622
20150605,43530,43580,43410,43450,42890,42890,43150,-690,-430,132,628
20150608,42890,43150,42960,43310,42910,43240,43140,90,-10,72,632
20150609,43240,43140,43240,43450,43240,43450,43370,310,230,96,684
20150610,43450,43370,43480,43540,43400,43450,43480,80,110,58,694
20150611,43450,43480,43800,43800,43250,43250,43640,-230,160,108,738
20150612,43250,43640,43110,43110,42580,42580,42780,-1060,-860,146,812
20150615,42580,42780,42730,42820,42180,42200,42500,-580,-280,60,830
20150616,42200,42500,42150,42430,42150,42150,42250,-350,-250,178,858
20150617,42150,42250,42000,42040,41800,41800,41860,-450,-390,210,984
20150618,41800,41860,41750,42230,41750,42140,42010,280,150,64,996
20150619,42140,42010,42020,42030,41820,41820,41880,-190,-130,74,950
20150623,41820,41880,41600,41970,41520,41960,41870,80,-10,82,982
20150624,41960,41870,42080,42220,41950,42220,42070,350,200,34,974
20150625,42220,42070,42220,42280,41510,41800,41900,-270,-170,56,980
20150626,41800,41900,41790,42300,41740,42300,42000,400,100,106,974
20150629,42300,42000,42090,42500,42060,42430,42160,430,160,62,986
20150630,42430,42160,42260,42280,41900,41900,42050,-260,-110,92,1014
20150701,41900,42050,41950,42120,41800,42040,41930,-10,-120,144,1042
20150702,42040,41930,41820,42160,41750,42070,41970,140,40,54,1044
20150703,42070,41970,42140,42210,41920,42170,42060,200,90,170,1050
20150706,42170,42060,41930,41930,40000,40460,40910,-1600,-1150,250,1122
20150707,40460,40910,40280,40440,39530,39530,40040,-1380,-870,248,1176
20150708,39530,40040,38750,39230,37630,38150,38440,-1890,-1600,800,1370
20150709,38150,38440,38390,40450,38390,40160,39810,1720,1370,276,1434
20150710,40160,39810,40760,40870,40000,40040,40420,230,610,116,1452
20150713,40040,40420,40190,40230,39410,39640,39610,-780,-810,684,1726
20150714,39640,39610,39970,40040,39780,39790,39890,180,280,86,1740
20150715,39790,39890,39700,40100,39650,40080,39890,190,0,288,1790
20150716,40080,39890,40050,40050,39600,40040,39930,150,40,346,1922
20150717,40040,39930,39880,39980,39750,39890,39890,-40,-40,90,1918
20150720,39890,39890,39500,39680,39150,39240,39330,-650,-560,104,1950
20150721,39240,39330,39160,39600,39160,39540,39470,210,140,116,1956
20150722,39540,39470,39430,39590,38620,38730,39220,-740,-250,148,1964
20150723,38730,39220,38770,38890,38330,38890,38580,-330,-640,146,2024
20150724,38890,38580,38680,38720,37500,37510,37870,-1070,-710,448,2138
20150727,37510,37870,37700,38060,37700,37700,37930,-170,60,218,2156
20150728,37700,37930,37270,37800,37270,37680,37660,-250,-270,256,2214
20150729,37680,37660,37870,38880,37820,38470,38380,810,720,180,2216
20150730,38470,38380,38170,38500,38100,38150,38210,-230,-170,172,2288
20150731,38150,38210,37920,38210,37920,38140,38060,-70,-150,296,2528
20150803,38140,38060,38180,38320,37600,37630,37730,-430,-330,310,2674
20150804,37630,37730,37500,37970,37430,37910,37650,180,-80,470,2898
20150805,37910,37650,38100,38100,37580,37770,37910,120,260,216,2900
20150806,37770,37910,37630,37900,37600,37790,37780,-120,-130,140,2960
20150807,37790,37780,37610,37730,37050,37520,37370,-260,-410,778,3342
20150810,37520,37370,37400,37540,37190,37340,37410,-30,40,956,3664
20150811,37340,37410,37460,38850,37380,38570,38200,1160,790,956,3458
20150812,38570,38200,37890,39100,37890,38900,38440,700,240,624,3450
20150813,38900,38440,39160,39650,38870,39170,39250,730,810,392,3376
20150814,39170,39250,39130,39200,38950,38950,39070,-300,-180,72,3376
20150817,38950,39070,39050,39100,38580,38700,38770,-370,-300,252,3408
20150818,38700,38770,38500,38680,38340,38340,38510,-430,-260,242,3530
20150819,38340,38510,38200,38200,37770,38160,37990,-350,-520,360,3642
20150820,38160,37990,38090,38210,37860,38070,38000,80,10,518,3872
20150821,38070,38000,38650,38650,38300,38330,38440,330,440,604,3992
20150824,38330,38440,38270,38350,37230,37800,37690,-640,-750,1204,4294
20150825,37800,37690,37660,38560,37460,38300,38280,610,590,674,4266
20150826,38300,38280,38750,39030,38500,38500,38730,220,450,512,4340
20150827,38500,38730,38360,38640,38000,38480,38280,-250,-450,312,4396
20150828,38480,38280,38510,39300,38510,38970,39070,690,790,382,4384
20150831,38970,39070,39050,39320,38860,39080,39140,10,70,190,4398
20150901,39080,39140,38760,39280,38740,39000,39070,-140,-70,382,4534
20150902,39000,39070,38900,38970,38780,38810,38830,-260,-240,272,4638
20150907,38810,38830,38790,39130,38790,39130,38990,300,160,120,4652
20150908,39130,38990,39200,39260,39040,39240,39180,250,190,82,4660
20150909,39240,39180,39850,41310,39580,40990,40640,1810,1460,812,4680
20150910,40990,40640,40950,41010,40580,40850,40750,210,110,152,4658
20150911,40850,40750,40890,41090,40880,41000,40960,250,210,358,4750
20150914,41000,40960,40680,41000,40450,40450,40740,-510,-220,186,4780
20150915,40450,40740,40500,40560,40230,40240,40410,-500,-330,388,4918
20150916,40240,40410,40380,40760,40330,40760,40500,350,90,206,4954
20150917,40760,40500,40770,41230,40680,40960,40930,460,430,288,4996
20150918,40960,40930,41000,41050,40610,40610,40740,-320,-190,134,5014
20150921,40610,40740,40400,40400,39800,40150,40000,-590,-740,284,5084
20150922,40150,40000,40160,40300,39700,39720,39970,-280,-30,312,5224
20150923,39720,39970,39160,39160,38100,38730,38490,-1240,-1480,762,5370
20150924,38730,38490,38690,38960,38490,38700,38660,210,170,154,5410
20150925,38700,38660,38350,38900,38350,38620,38690,-40,30,662,5782
20150928,38620,38690,38530,38720,38030,38030,38400,-660,-290,390,5950
20150929,38030,38400,37530,37810,37410,37450,37550,-950,-850,1362,6690
20150930,37450,37550,37800,38150,37660,38040,37910,490,360,774,7070
20151008,38040,37910,38960,39070,38560,38570,38810,660,900,310,7064
20151009,38570,38810,38510,39890,38350,39580,39290,770,480,900,7112
20151012,39580,39290,39910,39930,39590,39900,39740,610,450,1882,7254
20151013,39900,39740,39750,39750,39220,39420,39410,-320,-330,506,7338
20151014,39420,39410,39430,39590,39280,39300,39360,-110,-50,474,7398
20151015,39300,39360,39410,39870,39410,39720,39720,360,360,246,7372
20151016,39720,39720,39710,39830,39280,39280,39590,-440,-130,512,7546
20151019,39280,39590,39400,39480,39060,39130,39230,-460,-360,344,7544
20151020,39130,39230,38950,38990,38660,38880,38810,-350,-420,590,7750
20151021,38880,38810,38880,39070,38550,38590,38740,-220,-70,514,7934
20151022,38590,38740,38590,39060,38480,38990,38960,250,220,932,8364
20151023,38990,38960,39120,39450,39000,39400,39260,440,300,1168,8964
20151026,39400,39260,39360,39360,38550,38730,38760,-530,-500,1298,8848
20151027,38730,38760,38780,39100,38520,38970,38740,210,-20,2628,9384
20151028,38970,38740,38940,38970,38530,38650,38730,-90,-10,624,9320
20151029,38650,38730,38500,38940,38360,38720,38740,-10,10,832,9612
20151030,38720,38740,38550,38600,38290,38530,38420,-210,-320,830,9842
20151102,38530,38420,38360,38450,38060,38220,38210,-200,-210,1078,10238
20151103,38220,38210,38220,38400,38130,38200,38220,-10,10,576,10478
20151104,38200,38220,38240,38580,38000,38580,38270,360,50,830,10640
20151105,38580,38270,38430,38820,37940,37940,38380,-330,110,1124,10938
20151106,37940,38380,37760,37930,37520,37730,37710,-650,-670,2618,12244
20151109,37730,37710,37640,37760,37350,37550,37570,-160,-140,736,12480
20151110,37550,37570,37500,37610,36870,37360,37200,-210,-370,4682,13522
20151111,37360,37200,37100,37350,36900,36900,37130,-300,-70,4256,14460
20151112,36900,37130,37000,37220,36960,37150,37070,20,-60,3546,15222
20151113,37150,37070,36960,36960,36070,36180,36290,-890,-780,5014,17216
20151116,36180,36290,36330,36350,35880,35920,36130,-370,-160,5504,19054
20151117,35920,36130,36030,36060,34420,34920,35080,-1210,-1050,8876,22366
20151118,34920,35080,35240,35330,34350,34770,34700,-310,-380,11794,25728
20151119,34770,34700,34650,34850,34130,34600,34520,-100,-180,10132,28150
20151120,34600,34520,34510,35000,34280,34750,34670,230,150,5702,28528
20151123,34750,34670,34840,34910,33150,33350,33660,-1320,-1010,14204,33516
20151124,33350,33660,33470,33950,33060,33750,33440,90,-220,16758,37694
20151125,33750,33440,33620,34860,33600,34490,34330,1050,890,13516,35940
20151126,34490,34330,34020,36000,34020,35040,35030,710,700,18482,34678
20151127,35040,35030,35160,35530,34730,35240,35080,210,50,9158,35622
20151130,35240,35080,35060,35250,34210,34610,34670,-470,-410,15808,37766
cu1606,20150616,42500,42500,42230,42320,42160,42230,42250,-270,-250,36,32
20150617,42230,42250,44760,44760,41960,41970,42530,-280,280,52,64
20150618,41970,42530,41950,42400,41830,42080,42010,-450,-520,174,202
20150619,42080,42010,41910,42100,41870,41900,41950,-110,-60,48,230
20150623,41900,41950,41900,42080,41850,42020,42010,70,60,174,382
20150624,42020,42010,41990,42300,41990,42200,42090,190,80,108,426
20150625,42200,42090,42240,42790,41810,41810,42280,-280,190,48,442
20150626,41810,42280,41980,42060,41900,42030,41980,-250,-300,44,452
20150629,42030,41980,42180,42440,41740,42440,42200,460,220,34,464
20150630,42440,42200,42180,42180,42010,42010,42080,-190,-120,6,464
20150701,42010,42080,41600,42140,41510,41830,41870,-250,-210,58,498
20150702,41830,41870,42100,42110,42010,42060,42060,190,190,38,512
20150703,42060,42060,42140,42210,41930,42210,42080,150,20,120,592
20150706,42210,42080,41950,41950,40050,40540,40830,-1540,-1250,118,616
20150707,40540,40830,40060,40500,39580,39580,40070,-1250,-760,216,682
20150708,39580,40070,38760,39430,37660,38050,38420,-2020,-1650,334,762
20150709,38050,38420,38720,40460,38720,40400,39770,1980,1350,194,746
20150710,40400,39770,40790,40790,40050,40120,40340,350,570,324,928
20150713,40120,40340,40110,40140,39480,39720,39600,-620,-740,774,1426
20150714,39720,39600,40050,40050,39770,39770,40010,170,410,56,1464
20150715,39770,40010,39720,40160,39650,40150,39950,140,-60,290,1598
20150716,40150,39950,40080,40100,39600,40070,39920,120,-30,348,1696
20150717,40070,39920,39900,40010,39780,39910,39880,-10,-40,124,1720
20150720,39910,39880,39560,39650,39020,39270,39400,-610,-480,126,1754
20150721,39270,39400,39250,39560,39250,39560,39470,160,70,104,1806
20150722,39560,39470,39460,39460,38690,38810,39150,-660,-320,76,1838
20150723,38810,39150,38580,39020,38310,38850,38680,-300,-470,164,1930
20150724,38850,38680,38690,38690,37500,37500,37890,-1180,-790,324,2058
20150727,37500,37890,37750,38180,37700,37970,37970,80,80,224,2134
20150728,37970,37970,37380,37730,37290,37670,37640,-300,-330,132,2202
20150729,37670,37640,38240,38700,38240,38460,38430,820,790,212,2212
20150730,38460,38430,38370,38370,38110,38160,38260,-270,-170,52,2200
20150731,38160,38260,37910,38200,37910,38040,38170,-220,-90,256,2374
20150803,38040,38170,37870,37990,37600,37660,37690,-510,-480,252,2546
20150804,37660,37690,37530,37920,37490,37870,37600,180,-90,390,2778
20150805,37870,37600,38030,38130,37560,37830,37900,230,300,200,2828
20150806,37830,37900,37760,37890,37580,37790,37760,-110,-140,94,2846
20150807,37790,37760,37550,37600,37000,37500,37430,-260,-330,530,3138
20150810,37500,37430,37400,37520,37110,37340,37430,-90,0,798,3444
20150811,37340,37430,37460,38800,37420,38510,38210,1080,780,676,3412
20150812,38510,38210,38190,39000,38020,39000,38500,790,290,272,3424
20150813,39000,38500,39570,39570,38870,39110,39240,610,740,166,3422
20150814,39110,39240,39160,39200,38920,38920,39080,-320,-160,120,3458
20150817,38920,39080,38720,39150,38590,38730,38780,-350,-300,304,3552
20150818,38730,38780,38650,38650,38390,38410,38480,-370,-300,154,3512
20150819,38410,38480,38250,38250,37750,38210,38010,-270,-470,230,3578
20150820,38210,38010,38080,38250,37860,38090,37990,80,-20,368,3640
20150821,38090,37990,38440,38650,38330,38330,38410,340,420,174,3574
20150824,38330,38410,38110,38340,37320,37620,37760,-790,-650,316,3604
20150825,37620,37760,37620,38490,37470,38050,38050,290,290,152,3592
20150826,38050,38050,38880,38940,38520,38520,38680,470,630,210,3536
20150827,38520,38680,38360,38610,37940,38560,38380,-120,-300,116,3538
20150828,38560,38380,38680,39410,38640,39090,39040,710,660,132,3504
20150831,39090,39040,39230,39290,38960,39140,39200,100,160,96,3504
20150901,39140,39200,38950,39300,38800,39030,39040,-170,-160,116,3514
20150902,39030,39040,38820,39000,38780,38820,38860,-220,-180,96,3518
20150907,38820,38860,38910,39140,38910,39050,39020,190,160,66,3530
20150908,39050,39020,39180,39260,39060,39200,39180,180,160,62,3542
20150909,39200,39180,39910,41400,39900,40980,40680,1800,1500,272,3508
20150910,40980,40680,40950,40970,40660,40960,40800,280,120,164,3558
20150911,40960,40800,41020,41060,40930,41060,41000,260,200,48,3542
20150914,41060,41000,40820,41000,40510,40510,40720,-490,-280,60,3560
20150915,40510,40720,40470,40530,40310,40310,40450,-410,-270,194,3626
20150916,40310,40450,40410,40780,40330,40780,40570,330,120,122,3602
20150917,40780,40570,40780,41210,40740,40910,40910,340,340,96,3634
20150918,40910,40910,40980,40990,40650,40670,40730,-240,-180,62,3660
20150921,40670,40730,40280,40280,39840,40160,40050,-570,-680,262,3618
20150922,40160,40050,40220,40310,39720,39720,39980,-330,-70,254,3654
20150923,39720,39980,39050,39050,38180,38780,38590,-1200,-1390,384,3792
20150924,38780,38590,38840,38950,38600,38710,38720,120,130,84,3810
20150925,38710,38720,38440,38860,38380,38660,38740,-60,20,424,3928
20150928,38660,38740,38690,38710,38190,38190,38480,-550,-260,104,3906
20150929,38190,38480,37500,37850,37440,37640,37560,-840,-920,360,4076
20150930,37640,37560,37880,38060,37710,38060,37930,500,370,512,4168
20151008,38060,37930,39000,39000,38560,38630,38790,700,860,136,4120
20151009,38630,38790,38610,39810,38400,39700,39050,910,260,340,4142
20151012,39700,39050,40010,40010,39600,39830,39750,780,700,206,4166
20151013,39830,39750,39700,39700,39230,39440,39390,-310,-360,224,4196
20151014,39440,39390,39350,39590,39230,39320,39350,-70,-40,438,4214
20151015,39320,39350,39630,39820,39630,39760,39740,410,390,112,4194
20151016,39760,39740,39680,39760,39300,39300,39570,-440,-170,78,4196
20151019,39300,39570,39250,39420,38950,39080,39120,-490,-450,124,4126
20151020,39080,39120,38500,38960,38500,38880,38770,-240,-350,102,4168
20151021,38880,38770,38860,39040,38530,38600,38790,-170,20,262,4226
20151022,38600,38790,38500,39080,38410,39010,38790,220,0,282,4220
20151023,39010,38790,39110,39410,39000,39400,39200,610,410,256,4210
20151026,39400,39200,39110,39110,38600,38740,38760,-460,-440,294,4298
20151027,38740,38760,38790,39020,38520,38960,38790,200,30,440,4488
20151028,38960,38790,38870,38960,38500,38600,38690,-190,-100,224,4600
20151029,38600,38690,38520,38920,38300,38720,38710,30,20,1082,5146
20151030,38720,38710,38720,38720,38300,38470,38430,-240,-280,526,5272
20151102,38470,38430,38340,38460,38070,38180,38170,-250,-260,520,5308
20151103,38180,38170,38220,38350,38090,38150,38240,-20,70,452,5290
20151104,38150,38240,38180,38540,37980,38540,38200,300,-40,362,5236
20151105,38540,38200,38380,38800,37950,37950,38200,-250,0,406,5370
20151106,37950,38200,37730,37910,37540,37770,37690,-430,-510,1492,5974
20151109,37770,37690,37550,37740,37350,37350,37590,-340,-100,776,6036
20151110,37350,37590,37480,37600,36880,37320,37150,-270,-440,1382,6538
20151111,37320,37150,37220,37320,36900,36900,37090,-250,-60,1066,6952
20151112,36900,37090,37100,37160,36950,37100,37040,10,-50,2028,7768
20151113,37100,37040,36500,36590,36070,36170,36300,-870,-740,1428,8722
20151116,36170,36300,36020,36290,35920,35920,36170,-380,-130,4192,10916
20151117,35920,36170,36020,36020,34460,34920,35090,-1250,-1080,3592,12254
20151118,34920,35090,35220,35370,34380,34810,34730,-280,-360,1812,12702
20151119,34810,34730,34690,34860,34150,34620,34530,-110,-200,2320,13348
20151120,34620,34530,34430,35000,34300,34780,34700,250,170,1474,13594
20151123,34780,34700,35080,35750,33150,33350,33720,-1350,-980,3334,14358
20151124,33350,33720,33290,33940,33070,33750,33480,30,-240,3544,14444
20151125,33750,33480,33760,34810,33640,34500,34320,1020,840,1780,14530
20151126,34500,34320,34060,35960,34060,35090,34990,770,670,2210,14632
20151127,35090,34990,35120,35540,34770,35230,35140,240,150,960,14704
20151130,35230,35140,35070,35210,34260,34640,34650,-500,-490,1740,15076
cu1607,20150716,39950,39950,39700,39700,39700,39700,39700,-250,-250,6,6
20150717,39700,39700,39780,39900,39780,39900,39850,200,150,10,16
20150720,39900,39850,39540,39670,39020,39250,39460,-600,-390,68,70
20150721,39250,39460,39220,39600,39220,39500,39500,40,40,48,112
20150722,39500,39500,39400,39530,38800,38800,39290,-700,-210,126,206
20150723,38800,39290,38400,38820,38300,38820,38480,-470,-810,28,210
20150724,38820,38480,38200,38200,37540,37540,37710,-940,-770,144,336
20150727,37540,37710,37310,38130,37310,37920,37920,210,210,346,560
20150728,37920,37920,37800,37880,37410,37720,37750,-200,-170,136,658
20150729,37720,37750,38370,38850,38340,38510,38560,760,810,182,762
20150730,38510,38560,38270,38460,38090,38110,38210,-450,-350,104,782
20150731,38110,38210,37900,38260,37900,38250,38200,40,-10,186,946
20150803,38250,38200,38340,38340,37600,37620,37800,-580,-400,292,1044
20150804,37620,37800,37560,37950,37500,37950,37720,150,-80,250,1236
20150805,37950,37720,37970,38000,37620,37820,37860,100,140,70,1234
20150806,37820,37860,37820,37880,37780,37800,37800,-60,-60,52,1278
20150807,37800,37800,37680,37740,37130,37430,37430,-370,-370,410,1558
20150810,37430,37430,37380,37530,37170,37440,37430,10,0,620,1946
20150811,37440,37430,37480,38720,37470,38570,38170,1140,740,484,1976
20150812,38570,38170,38000,38980,38000,38980,38380,810,210,150,2026
20150813,38980,38380,39280,39510,38860,39220,39160,840,780,190,2056
20150814,39220,39160,39120,39150,38920,38920,39080,-240,-80,118,2140
20150817,38920,39080,39110,39160,38580,38730,38780,-350,-300,380,2332
20150818,38730,38780,38610,38610,38460,38490,38500,-290,-280,264,2248
20150819,38490,38500,38200,38200,37510,38130,37990,-370,-510,188,2270
20150820,38130,37990,38100,38250,37900,38030,38010,40,20,234,2370
20150821,38030,38010,38450,38450,38380,38400,38400,390,390,22,2354
20150824,38400,38400,38320,38320,37220,37570,37770,-830,-630,244,2266
20150825,37570,37770,37620,38450,37510,38100,38110,330,340,96,2264
20150826,38100,38110,38880,38880,38530,38550,38630,440,520,170,2346
20150827,38550,38630,38220,38590,38030,38580,38430,-50,-200,78,2382
20150828,38580,38430,38660,39270,38660,38970,39020,540,590,80,2410
20150831,38970,39020,39260,39280,38960,39170,39110,150,90,54,2426
20150901,39170,39110,38940,39250,38870,39030,39090,-80,-20,56,2420
20150902,39030,39090,38980,38980,38790,38850,38840,-240,-250,46,2410
20150907,38850,38840,39060,39120,38990,39080,39100,240,260,90,2370
20150908,39080,39100,39180,39180,39050,39050,39120,-50,20,34,2360
20150909,39050,39120,40110,41330,40110,41020,40620,1900,1500,238,2408
20150910,41020,40620,40870,40970,40620,40970,40740,350,120,18,2406
20150911,40970,40740,40930,41060,40930,41060,41000,320,260,174,2556
20150914,41060,41000,40790,41040,40550,40550,40870,-450,-130,58,2554
20150915,40550,40870,40440,40520,40310,40320,40410,-550,-460,54,2562
20150916,40320,40410,40550,40650,40450,40650,40520,240,110,20,2558
20150917,40650,40520,40980,41200,40830,41020,40910,500,390,42,2560
20150918,41020,40910,40710,40710,40660,40670,40670,-240,-240,36,2578
20150921,40670,40670,40440,40440,39830,40150,40060,-520,-610,98,2594
20150922,40150,40060,40330,40370,39780,39780,40020,-280,-40,106,2642
20150923,39780,40020,39130,39130,38130,38760,38580,-1260,-1440,494,2496
20150924,38760,38580,38710,38750,38580,38710,38690,130,110,28,2496
20150925,38710,38690,38450,38890,38450,38750,38770,60,80,124,2500
20150928,38750,38770,38700,38710,38220,38220,38480,-550,-290,54,2512
20150929,38220,38480,37720,37840,37490,37540,37620,-940,-860,136,2492
20150930,37540,37620,37740,38120,37740,38120,37950,500,330,376,2656
20151008,38120,37950,38800,39120,38640,38770,38840,820,890,64,2648
20151009,38770,38840,38360,39880,38360,39690,39000,850,160,256,2686
20151012,39690,39000,39760,39890,39590,39800,39700,800,700,134,2716
20151013,39800,39700,39660,39660,39230,39400,39530,-300,-170,192,2660
20151014,39400,39530,39330,39490,39240,39370,39350,-160,-180,26,2660
20151015,39370,39350,39620,39850,39620,39760,39780,410,430,224,2554
20151016,39760,39780,39710,39800,39390,39390,39560,-390,-220,82,2532
20151019,39390,39560,39450,39450,39080,39150,39150,-410,-410,334,2734
20151020,39150,39150,38920,38970,38700,38860,38870,-290,-280,72,2744
20151021,38860,38870,38980,38980,38560,38600,38680,-270,-190,62,2776
20151022,38600,38680,38500,39030,38490,38980,38830,300,150,68,2786
20151023,38980,38830,39090,39400,39020,39250,39120,420,290,84,2764
20151026,39250,39120,39070,39070,38720,38720,38820,-400,-300,26,2768
20151027,38720,38820,38780,38980,38500,38980,38770,160,-50,74,2802
20151028,38980,38770,38890,38890,38540,38540,38650,-230,-120,22,2806
20151029,38540,38650,38710,38890,38630,38690,38690,40,40,92,2818
20151030,38690,38690,38430,38430,38290,38430,38360,-260,-330,112,2800
20151102,38430,38360,38220,38230,38060,38140,38140,-220,-220,110,2806
20151103,38140,38140,38120,38290,38060,38140,38250,0,110,120,2868
20151104,38140,38250,38000,38480,38000,38480,38360,230,110,108,2902
20151105,38480,38360,38560,38560,38000,38000,38210,-360,-150,82,2934
20151106,38000,38210,37640,37860,37510,37730,37660,-480,-550,196,3038
20151109,37730,37660,37680,37730,37400,37420,37570,-240,-90,160,3072
20151110,37420,37570,37260,37490,36890,37370,37060,-200,-510,370,3164
20151111,37370,37060,37180,37200,36980,36990,37030,-70,-30,294,3328
20151112,36990,37030,37060,37150,36910,37150,37040,120,10,150,3348
20151113,37150,37040,36300,36550,36090,36120,36320,-920,-720,886,3862
20151116,36120,36320,36210,36240,36000,36000,36160,-320,-160,642,3926
20151117,36000,36160,35890,35890,34490,34940,35040,-1220,-1120,1048,4410
20151118,34940,35040,35290,35350,34410,34840,34820,-200,-220,870,4596
20151119,34840,34820,34650,34870,34150,34660,34580,-160,-240,682,4760
20151120,34660,34580,34450,35000,34350,34820,34770,240,190,578,5016
20151123,34820,34770,34770,34820,33300,33440,33590,-1330,-1180,788,5436
20151124,33440,33590,33460,34010,33110,34010,33490,420,-100,1034,5820
20151125,34010,33490,33850,34820,33730,34550,34330,1060,840,388,5940
20151126,34550,34330,34210,36220,34180,35120,35120,790,790,522,6066
20151127,35120,35120,35260,35550,34840,35100,35170,-20,50,236,6136
20151130,35100,35170,35190,35190,34310,34850,34690,-320,-480,562,6372
cu1608,20150818,38780,38780,38520,38550,38400,38400,38510,-380,-270,66,44
20150819,38400,38510,37480,38330,37480,38130,38060,-380,-450,126,80
20150820,38130,38060,37990,38170,37540,38080,37970,20,-90,30,90
20150821,38080,37970,38410,38410,38410,38410,38410,440,440,2,90
20150824,38410,38410,38290,38290,37270,37750,37670,-660,-740,398,354
20150825,37750,37670,37520,38450,37300,38290,37920,620,250,24,350
20150826,38290,37920,39400,39400,38500,38600,38770,680,850,124,372
20150827,38600,38770,38600,38600,38040,38400,38300,-370,-470,80,380
20150828,38400,38300,38700,39300,38700,38960,39090,660,790,46,400
20150831,38960,39090,39230,39230,38950,39170,39070,80,-20,52,406
20150901,39170,39070,38890,39270,38790,39050,39060,-20,-10,34,418
20150902,39050,39060,38970,38970,38800,38850,38860,-210,-200,34,420
20150907,38850,38860,38780,39140,38780,39080,39010,220,150,72,454
20150908,39080,39010,39180,39270,39050,39080,39180,70,170,78,466
20150909,39080,39180,39860,41380,39860,40990,40800,1810,1620,266,478
20150910,40990,40800,40940,40980,40630,40980,40740,180,-60,134,562
20150911,40980,40740,40940,41080,40890,41050,41030,310,290,204,630
20150914,41050,41030,40750,41070,40500,40500,40800,-530,-230,150,674
20150915,40500,40800,40480,40520,40300,40300,40360,-500,-440,156,598
20150916,40300,40360,40520,40850,40410,40810,40540,450,180,50,608
20150917,40810,40540,41000,41160,40840,40860,40970,320,430,98,582
20150918,40860,40970,40980,40980,40620,40690,40690,-280,-280,38,596
20150921,40690,40690,40350,40350,39820,40180,39950,-510,-740,108,622
20150922,40180,39950,40180,40180,39750,39750,39970,-200,20,160,698
20150923,39750,39970,39130,39130,38200,38790,38510,-1180,-1460,206,710
20150924,38790,38510,39000,39000,38580,38710,38720,200,210,230,744
20150925,38710,38720,38460,38820,38460,38770,38760,50,40,90,742
20150928,38770,38760,38730,38730,38200,38200,38530,-560,-230,70,764
20150929,38200,38530,37770,37840,37500,37570,37670,-960,-860,282,814
20150930,37570,37670,37780,38280,37780,38280,37970,610,300,202,914
20151008,38280,37970,38920,38940,38560,38560,38820,590,850,66,916
20151009,38560,38820,38430,39800,38430,39720,38980,900,160,178,1032
20151012,39720,38980,39740,39890,39570,39810,39760,830,780,138,1010
20151013,39810,39760,39740,39740,39220,39370,39490,-390,-270,52,1032
20151014,39370,39490,39230,39380,39230,39290,39300,-200,-190,92,1048
20151015,39290,39300,39470,39840,39430,39750,39640,450,340,96,1040
20151016,39750,39640,39680,39680,39380,39380,39530,-260,-110,44,1020
20151019,39380,39530,39340,39450,39030,39160,39220,-370,-310,66,1012
20151020,39160,39220,38800,38850,38700,38700,38770,-520,-450,12,1012
20151021,38700,38770,38900,38980,38550,38630,38800,-140,30,48,1012
20151022,38630,38800,38490,38880,38490,38810,38680,10,-120,14,1016
20151023,38810,38680,39140,39350,39120,39350,39210,670,530,32,1024
20151026,39350,39210,39150,39150,38710,38750,38790,-460,-420,42,1040
20151027,38750,38790,38680,39000,38550,38960,38800,170,10,124,1088
20151028,38960,38800,38680,38680,38680,38680,38680,-120,-120,2,1090
20151029,38680,38680,38500,38830,38500,38640,38730,-40,50,254,1202
20151030,38640,38730,38440,38470,38290,38470,38390,-260,-340,56,1206
20151102,38470,38390,38340,38340,38000,38180,38100,-210,-290,144,1284
20151103,38180,38100,38240,38260,38080,38110,38180,10,80,36,1274
20151104,38110,38180,38160,38450,37940,38450,38230,270,50,70,1250
20151105,38450,38230,38500,38600,37950,37950,38160,-280,-70,42,1252
20151106,37950,38160,37610,37720,37470,37690,37660,-470,-500,312,1320
20151109,37690,37660,37440,37590,37320,37320,37500,-340,-160,90,1328
20151110,37320,37500,37200,37500,36860,37300,37060,-200,-440,116,1390
20151111,37300,37060,36950,37200,36930,36960,37060,-100,0,56,1406
20151112,36960,37060,37000,37100,36910,37060,37020,0,-40,106,1444
20151113,37060,37020,36190,36540,36100,36110,36290,-910,-730,356,1660
20151116,36110,36290,36210,36220,36000,36000,36120,-290,-170,166,1756
20151117,36000,36120,35820,35820,34500,35020,35050,-1100,-1070,1152,2212
20151118,35020,35050,35200,35260,34450,34880,34840,-170,-210,362,2282
20151119,34880,34840,34670,34930,34240,34550,34590,-290,-250,266,2342
20151120,34550,34590,34470,34970,34370,34790,34780,200,190,258,2422
20151123,34790,34780,34910,34910,33280,33540,33710,-1240,-1070,430,2600
20151124,33540,33710,33450,34020,33190,33860,33640,150,-70,250,2684
20151125,33860,33640,33730,34850,33730,34590,34470,950,830,230,2696
20151126,34590,34470,34250,35970,34250,35080,35490,610,1020,576,2530
20151127,35080,35490,34900,35570,34770,35160,35110,-330,-380,272,2492
20151130,35160,35110,35180,35220,34300,34660,34690,-450,-420,460,2652
cu1609,20150916,40360,40360,40430,40860,40430,40860,40530,500,170,14,8
20150917,40860,40530,41550,41560,40880,40980,41080,450,550,88,38
20150918,40980,41080,41070,41070,40680,40680,40860,-400,-220,8,40
20150921,40680,40860,39880,39920,39880,39920,39900,-940,-960,6,40
20150922,39920,39900,40490,40490,39810,39810,39950,-90,50,46,74
20150923,39810,39950,39810,39810,38370,38580,38640,-1370,-1310,74,124
20150924,38580,38640,38870,38900,38780,38780,38830,140,190,20,130
20150925,38780,38830,38590,38850,38590,38740,38750,-90,-80,42,136
20150928,38740,38750,38530,38530,38510,38510,38520,-240,-230,8,140
20150929,38510,38520,37700,37700,37520,37600,37600,-920,-920,30,156
20150930,37600,37600,37840,37840,37840,37840,37840,240,240,2,158
20151008,37840,37840,39010,39010,38640,38640,38840,800,1000,28,176
20151009,38640,38840,38550,39800,38450,39640,39120,800,280,330,360
20151012,39640,39120,39750,39860,39590,39860,39750,740,630,178,460
20151013,39860,39750,39740,39740,39210,39380,39420,-370,-330,118,516
20151014,39380,39420,39390,39390,39240,39300,39290,-120,-130,174,614
20151015,39300,39290,39440,39820,39420,39720,39700,430,410,74,646
20151016,39720,39700,39700,39740,39450,39470,39560,-230,-140,64,676
20151019,39470,39560,39080,39170,39080,39130,39110,-430,-450,56,642
20151020,39130,39110,38860,38970,38700,38700,38810,-410,-300,22,646
20151021,38700,38810,38990,39030,38570,38630,38720,-180,-90,20,652
20151022,38630,38720,38480,38900,38480,38900,38670,180,-50,6,652
20151023,38900,38670,39310,39380,38980,39380,39130,710,460,46,672
20151026,39380,39130,39220,39220,38570,38880,38840,-250,-290,102,704
20151027,38880,38840,38780,38980,38500,38960,38800,120,-40,236,796
20151028,38960,38800,38660,38720,38630,38630,38650,-170,-150,30,798
20151029,38630,38650,38350,38930,38350,38740,38640,90,-10,98,840
20151030,38740,38640,38460,38470,38290,38420,38390,-220,-250,144,816
20151102,38420,38390,38300,38310,38000,38090,38070,-300,-320,164,866
20151103,38090,38070,37980,38250,37980,38080,38160,10,90,264,930
20151104,38080,38160,38090,38430,37930,38430,38220,270,60,40,934
20151105,38430,38220,38490,38700,37900,37900,38390,-320,170,90,934
20151106,37900,38390,37700,37800,37450,37700,37610,-690,-780,404,988
20151109,37700,37610,37500,37550,37280,37280,37460,-330,-150,142,1036
20151110,37280,37460,37400,37400,36830,37300,37110,-160,-350,142,1078
20151111,37300,37110,37190,37280,36850,36850,37040,-260,-70,186,1160
20151112,36850,37040,36980,37080,36950,37070,37030,30,-10,108,1184
20151113,37070,37030,36300,36450,36070,36150,36240,-880,-790,234,1316
20151116,36150,36240,36170,36290,36000,36000,36110,-240,-130,276,1344
20151117,36000,36110,35900,35940,34500,35010,35020,-1100,-1090,636,1634
20151118,35010,35020,35210,35320,34440,34910,35040,-110,20,362,1636
20151119,34910,35040,34620,34950,34200,34610,34600,-430,-440,288,1704
20151120,34610,34600,34520,35260,34360,34850,34790,250,190,392,1690
20151123,34850,34790,34820,34910,33250,33420,33770,-1370,-1020,380,1830
20151124,33420,33770,33440,34080,33160,33880,33610,110,-160,386,1930
20151125,33880,33610,33800,34930,33750,34600,34160,990,550,306,1960
20151126,34600,34160,34270,36080,34270,35150,35180,990,1020,306,1922
20151127,35150,35180,35100,35840,34880,35280,35350,100,170,292,1874
20151130,35280,35350,35110,35190,34370,34790,34740,-560,-610,298,1972
cu1610,20151016,39700,39700,39800,39800,39310,39310,39670,-390,-30,74,62
20151019,39310,39670,39400,39400,39090,39090,39160,-580,-510,16,70
20151020,39090,39160,38620,39200,38570,38830,38810,-330,-350,46,78
20151021,38830,38810,38740,38740,38560,38600,38610,-210,-200,36,104
20151022,38600,38610,38420,39040,38420,39040,38800,430,190,34,118
20151023,39040,38800,39360,39400,39010,39360,39150,560,350,40,138
20151026,39360,39150,38730,38790,38680,38750,38730,-400,-420,80,188
20151027,38750,38730,38700,39000,38490,38960,38820,230,90,74,236
20151028,38960,38820,38750,38770,38480,38530,38640,-290,-180,108,312
20151029,38530,38640,37880,38900,37880,38620,38630,-20,-10,228,480
20151030,38620,38630,38490,38540,38220,38390,38340,-240,-290,266,638
20151102,38390,38340,38270,38310,37970,38060,38040,-280,-300,126,702
20151103,38060,38040,38120,38180,37990,38050,38130,10,90,112,762
20151104,38050,38130,38100,38370,37850,38370,38050,240,-80,118,786
20151105,38370,38050,38410,38740,37950,38000,38250,-50,200,168,800
20151106,38000,38250,37650,37760,37380,37650,37580,-600,-670,490,878
20151109,37650,37580,37640,37660,37240,37240,37460,-340,-120,176,938
20151110,37240,37460,37390,37390,36800,37280,37060,-180,-400,422,1150
20151111,37280,37060,37220,37220,36800,36800,37040,-260,-20,260,1252
20151112,36800,37040,36800,37080,36800,37050,37000,10,-40,88,1272
20151113,37050,37000,36260,36550,36030,36110,36200,-890,-800,610,1520
20151116,36110,36200,36200,36250,35870,35870,36100,-330,-100,400,1532
20151117,35870,36100,36000,36000,34460,34970,34950,-1130,-1150,846,1692
20151118,34970,34950,35310,35340,34460,34900,34910,-50,-40,432,1786
20151119,34900,34910,34760,34950,34140,34690,34620,-220,-290,384,1854
20151120,34690,34620,34540,35000,34370,34810,34690,190,70,332,1912
20151123,34810,34690,34900,34910,33260,33580,33720,-1110,-970,398,2068
20151124,33580,33720,33650,34040,33260,33890,33590,170,-130,946,2174
20151125,33890,33590,33740,35080,33740,34660,34770,1070,1180,1088,2578
20151126,34660,34770,34300,36060,34280,35100,35260,330,490,540,2626
20151127,35100,35260,35330,35610,34890,35320,35220,60,-40,372,2546
20151130,35320,35220,35200,35240,34370,34690,34720,-530,-500,422,2648
cu1611,20151117,36100,36100,35300,35380,34120,34850,34890,-1250,-1210,474,380
20151118,34850,34890,35280,35290,34500,34910,34800,20,-90,356,626
20151119,34910,34800,34630,34920,34180,34670,34640,-130,-160,352,824
20151120,34670,34640,34490,35020,34440,34820,34660,180,20,130,894
20151123,34820,34660,34910,34910,33040,33560,33650,-1100,-1010,302,1058
20151124,33560,33650,33530,34290,33020,34070,33620,420,-30,504,1306
20151125,34070,33620,33770,34910,33760,34600,34460,980,840,316,1352
20151126,34600,34460,34260,36020,34260,35180,34830,720,370,150,1326
20151127,35180,34830,35380,35620,34930,35210,35270,380,440,250,1484
20151130,35210,35270,34960,35150,34520,34930,34710,-340,-560,318,1534
fu1503,20150105,2979,2979,2979,2979,2979,2979,2979,0,0,2,24
20150106,2979,2979,,,,2979,2979,0,0,0,24
20150107,2979,2979,,,,2979,2979,0,0,0,24
20150108,2979,2979,,,,2979,2979,0,0,0,24
20150109,2979,2979,,,,2979,2979,0,0,0,24
20150112,2979,2979,,,,2979,2979,0,0,0,24
20150113,2979,2979,,,,2979,2979,0,0,0,24
20150114,2979,2979,,,,2979,2979,0,0,0,24
20150115,2979,2979,3000,3000,2833,2980,2937,1,-42,6,24
20150116,2980,2937,,,,2937,2937,0,0,0,24
20150119,2937,2937,2790,3035,2790,2978,2934,41,-3,6,24
20150120,2978,2934,,,,2934,2934,0,0,0,24
20150121,2934,2934,2788,2949,2788,2798,2871,-136,-63,8,30
20150122,2798,2871,2727,3014,2727,2952,2904,81,33,64,30
20150123,2952,2904,2780,3046,2780,2851,2930,-53,26,8,28
20150126,2851,2930,2792,2796,2792,2796,2794,-134,-136,4,26
20150127,2796,2794,2869,2869,2869,2869,2869,75,75,2,24
20150128,2869,2869,,,,2869,2869,0,0,0,24
20150129,2869,2869,,,,2869,2869,0,0,0,24
20150130,2869,2869,,,,2869,2869,0,0,0,24
20150202,2869,2869,2800,2960,2725,2960,2828,91,-41,6,18
20150203,2960,2828,,,,2828,2828,0,0,0,18
20150204,2828,2828,,,,2828,2828,0,0,0,18
20150205,2828,2828,,,,2828,2828,0,0,0,18
20150206,2828,2828,,,,2828,2828,0,0,0,18
20150209,2828,2828,,,,2828,2828,0,0,0,18
20150210,2828,2828,,,,2828,2828,0,0,0,18
20150211,2828,2828,2969,2969,2969,2969,2969,141,141,4,14
20150212,2969,2969,2969,2969,2969,2969,2969,0,0,2,12
20150213,2969,2969,2969,3117,2969,3117,3043,148,74,4,10
20150216,3117,3043,3195,3195,3195,3195,3195,152,152,4,6
20150217,3195,3195,3418,3418,3418,3418,3418,223,223,8,0
20150225,3418,3418,,,,3418,3418,0,0,0,0
20150226,3418,3418,,,,3418,3418,0,0,0,0
20150227,3418,3418,,,,3418,3418,0,0,0,0
fu1504,20150105,3159,3159,,,,3159,3159,0,0,0,4
20150106,3159,3159,,,,3159,3159,0,0,0,4
20150107,3159,3159,,,,3159,3159,0,0,0,4
20150108,3159,3159,,,,3159,3159,0,0,0,4
20150109,3159,3159,,,,3159,3159,0,0,0,4
20150112,3159,3159,,,,3159,3159,0,0,0,4
20150113,3159,3159,,,,3159,3159,0,0,0,4
20150114,3159,3159,3001,3304,3001,3299,3106,140,-53,28,8
20150115,3299,3106,2950,3000,2950,3000,2975,-106,-131,4,6
20150116,3000,2975,2990,2990,2990,2990,2990,15,15,2,4
20150119,2990,2990,,,,2990,2990,0,0,0,4
20150120,2990,2990,,,,2990,2990,0,0,0,4
20150121,2990,2990,,,,2990,2990,0,0,0,4
20150122,2990,2990,3138,3138,3138,3138,3138,148,148,2,6
20150123,3138,3138,,,,3138,3138,0,0,0,6
20150126,3138,3138,,,,3138,3138,0,0,0,6
20150127,3138,3138,,,,3138,3138,0,0,0,6
20150128,3138,3138,,,,3138,3138,0,0,0,6
20150129,3138,3138,,,,3138,3138,0,0,0,6
20150130,3138,3138,,,,3138,3138,0,0,0,6
20150202,3138,3138,3099,3099,3099,3099,3099,-39,-39,2,4
20150203,3099,3099,,,,3099,3099,0,0,0,4
20150204,3099,3099,,,,3099,3099,0,0,0,4
20150205,3099,3099,,,,3099,3099,0,0,0,4
20150206,3099,3099,,,,3099,3099,0,0,0,4
20150209,3099,3099,,,,3099,3099,0,0,0,4
20150210,3099,3099,,,,3099,3099,0,0,0,4
20150211,3099,3099,2949,3099,2949,3099,3016,0,-83,6,2
20150212,3099,3016,,,,3016,3016,0,0,0,2
20150213,3016,3016,,,,3016,3016,0,0,0,2
20150216,3016,3016,,,,3016,3016,0,0,0,2
20150217,3016,3016,,,,3016,3016,0,0,0,2
20150225,3016,3016,,,,3016,3016,0,0,0,2
20150226,3016,3016,,,,3016,3016,0,0,0,2
20150227,3016,3016,,,,3016,3016,0,0,0,2
20150302,3016,3016,2900,2900,2900,2900,2900,-116,-116,2,2
20150303,2900,2900,,,,2900,2900,0,0,0,2
20150304,2900,2900,,,,3045,3045,145,145,0,2
20150305,3045,3045,2900,2900,2900,2900,2900,-145,-145,2,2
20150306,2900,2900,,,,3045,3045,145,145,0,2
20150309,3045,3045,2892,2893,2892,2893,2892,-152,-153,4,0
20150310,2893,2892,,,,2892,2892,0,0,0,0
20150311,2892,2892,,,,2892,2892,0,0,0,0
20150312,2892,2892,,,,2892,2892,0,0,0,0
20150313,2892,2892,,,,2892,2892,0,0,0,0
20150316,2892,2892,,,,2892,2892,0,0,0,0
20150317,2892,2892,,,,2892,2892,0,0,0,0
20150318,2892,2892,,,,2892,2892,0,0,0,0
20150319,2892,2892,,,,2892,2892,0,0,0,0
20150320,2892,2892,,,,2892,2892,0,0,0,0
20150323,2892,2892,,,,2892,2892,0,0,0,0
20150324,2892,2892,,,,2892,2892,0,0,0,0
20150325,2892,2892,,,,2892,2892,0,0,0,0
20150326,2892,2892,,,,2892,2892,0,0,0,0
20150327,2892,2892,,,,2892,2892,0,0,0,0
20150330,2892,2892,,,,2892,2892,0,0,0,0
20150331,2892,2892,,,,2892,2892,0,0,0,0
fu1505,20150105,3094,3094,,,,3094,3094,0,0,0,10
20150106,3094,3094,,,,3094,3094,0,0,0,10
20150107,3094,3094,,,,3094,3094,0,0,0,10
20150108,3094,3094,,,,3094,3094,0,0,0,10
20150109,3094,3094,,,,3094,3094,0,0,0,10
20150112,3094,3094,2939,3247,2939,3094,3087,0,-7,20,10
20150113,3094,3087,,,,3087,3087,0,0,0,10
20150114,3087,3087,,,,3087,3087,0,0,0,10
20150115,3087,3087,,,,3087,3087,0,0,0,10
20150116,3087,3087,,,,3087,3087,0,0,0,10
20150119,3087,3087,3000,3237,3000,3237,3040,150,-47,12,10
20150120,3237,3040,,,,3040,3040,0,0,0,10
20150121,3040,3040,,,,3040,3040,0,0,0,10
20150122,3040,3040,3192,3192,3192,3192,3192,152,152,4,10
20150123,3192,3192,,,,3192,3192,0,0,0,10
20150126,3192,3192,,,,3192,3192,0,0,0,10
20150127,3192,3192,,,,3192,3192,0,0,0,10
20150128,3192,3192,,,,3192,3192,0,0,0,10
20150129,3192,3192,,,,3192,3192,0,0,0,10
20150130,3192,3192,3041,3041,3040,3040,3040,-152,-152,10,2
20150202,3040,3040,3192,3192,3189,3192,3191,152,151,8,10
20150203,3192,3191,,,,3191,3191,0,0,0,10
20150204,3191,3191,,,,3191,3191,0,0,0,10
20150205,3191,3191,3350,3350,3042,3042,3144,-149,-47,6,12
20150206,3042,3144,2992,3298,2992,3298,3145,154,1,4,12
20150209,3298,3145,,,,3145,3145,0,0,0,12
20150210,3145,3145,3011,3011,3011,3011,3011,-134,-134,2,10
20150211,3011,3011,,,,2930,2930,-81,-81,0,10
20150212,2930,2930,,,,3076,3076,146,146,0,10
20150213,3076,3076,,,,3151,3151,75,75,0,10
20150216,3151,3151,,,,3151,3151,0,0,0,10
20150217,3151,3151,3103,3300,3103,3300,3152,149,1,8,4
20150225,3300,3152,3260,3260,3260,3260,3260,108,108,2,4
20150226,3260,3260,3300,3300,3201,3201,3250,-59,-10,4,0
20150227,3201,3250,,,,3250,3250,0,0,0,0
20150302,3250,3250,,,,3250,3250,0,0,0,0
20150303,3250,3250,,,,3250,3250,0,0,0,0
20150304,3250,3250,,,,3250,3250,0,0,0,0
20150305,3250,3250,,,,3095,3095,-155,-155,0,0
20150306,3095,3095,,,,3249,3249,154,154,0,0
20150309,3249,3249,,,,3086,3086,-163,-163,0,0
20150310,3086,3086,,,,3086,3086,0,0,0,0
20150311,3086,3086,,,,3086,3086,0,0,0,0
20150312,3086,3086,,,,3086,3086,0,0,0,0
20150313,3086,3086,,,,3086,3086,0,0,0,0
20150316,3086,3086,,,,3086,3086,0,0,0,0
20150317,3086,3086,,,,3086,3086,0,0,0,0
20150318,3086,3086,,,,3086,3086,0,0,0,0
20150319,3086,3086,,,,3086,3086,0,0,0,0
20150320,3086,3086,,,,3086,3086,0,0,0,0
20150323,3086,3086,,,,3086,3086,0,0,0,0
20150324,3086,3086,,,,3086,3086,0,0,0,0
20150325,3086,3086,,,,3086,3086,0,0,0,0
20150326,3086,3086,,,,3086,3086,0,0,0,0
20150327,3086,3086,,,,3086,3086,0,0,0,0
20150330,3086,3086,,,,3086,3086,0,0,0,0
20150331,3086,3086,,,,3086,3086,0,0,0,0
20150401,3086,3086,,,,3086,3086,0,0,0,0
20150402,3086,3086,,,,3086,3086,0,0,0,0
20150403,3086,3086,,,,3086,3086,0,0,0,0
20150407,3086,3086,,,,3086,3086,0,0,0,0
20150408,3086,3086,,,,3086,3086,0,0,0,0
20150409,3086,3086,,,,3086,3086,0,0,0,0
20150410,3086,3086,,,,3086,3086,0,0,0,0
20150413,3086,3086,,,,3086,3086,0,0,0,0
20150414,3086,3086,,,,3086,3086,0,0,0,0
20150415,3086,3086,,,,3086,3086,0,0,0,0
20150416,3086,3086,,,,3086,3086,0,0,0,0
20150417,3086,3086,,,,3086,3086,0,0,0,0
20150420,3086,3086,,,,3086,3086,0,0,0,0
20150421,3086,3086,,,,3086,3086,0,0,0,0
20150422,3086,3086,,,,3086,3086,0,0,0,0
20150423,3086,3086,,,,3086,3086,0,0,0,0
20150424,3086,3086,,,,3086,3086,0,0,0,0
20150427,3086,3086,,,,3086,3086,0,0,0,0
20150428,3086,3086,,,,3086,3086,0,0,0,0
20150429,3086,3086,,,,3086,3086,0,0,0,0
20150430,3086,3086,,,,3086,3086,0,0,0,0
fu1506,20150105,3131,3131,3276,3276,3138,3138,3201,7,70,10,6
20150106,3138,3201,3265,3360,3169,3221,3228,20,27,48,10
20150107,3221,3228,3169,3237,3169,3237,3191,9,-37,6,12
20150108,3237,3191,,,,3191,3191,0,0,0,12
20150109,3191,3191,,,,3191,3191,0,0,0,12
20150112,3191,3191,,,,3191,3191,0,0,0,12
20150113,3191,3191,,,,3191,3191,0,0,0,12
20150114,3191,3191,,,,3191,3191,0,0,0,12
20150115,3191,3191,3161,3161,3161,3161,3161,-30,-30,2,12
20150116,3161,3161,,,,3163,3163,2,2,0,12
20150119,3163,3163,3319,3319,3166,3166,3278,3,115,8,14
20150120,3166,3278,,,,3278,3278,0,0,0,14
20150121,3278,3278,,,,3278,3278,0,0,0,14
20150122,3278,3278,,,,3278,3278,0,0,0,14
20150123,3278,3278,,,,3278,3278,0,0,0,14
20150126,3278,3278,,,,3278,3278,0,0,0,14
20150127,3278,3278,,,,3261,3261,-17,-17,0,14
20150128,3261,3261,,,,3261,3261,0,0,0,14
20150129,3261,3261,3168,3168,3168,3168,3168,-93,-93,2,14
20150130,3168,3168,,,,3170,3170,2,2,0,14
20150202,3170,3170,,,,3181,3181,11,11,0,14
20150203,3181,3181,3188,3315,3186,3293,3245,112,64,8,20
20150204,3293,3245,3086,3309,3086,3200,3258,-45,13,14,20
20150205,3200,3258,3101,3370,3101,3333,3279,75,21,38,22
20150206,3333,3279,3155,3348,3155,3270,3266,-9,-13,14,20
20150209,3270,3266,3120,3347,3120,3328,3246,62,-20,18,18
20150210,3328,3246,3151,3183,3151,3183,3167,-63,-79,4,16
20150211,3183,3167,3020,3293,3020,3212,3234,45,67,26,18
20150212,3212,3234,3206,3324,3206,3242,3252,8,18,10,14
20150213,3242,3252,3162,3388,3162,3376,3317,124,65,40,26
20150216,3376,3317,3330,3340,3330,3340,3335,23,18,4,26
20150217,3340,3335,3120,3460,3120,3460,3350,125,15,14,30
20150225,3460,3350,3351,3351,3251,3347,3314,-3,-36,22,30
20150226,3347,3314,3350,3459,3348,3400,3404,86,90,14,34
20150227,3400,3404,3321,3396,3321,3395,3370,-9,-34,6,32
20150302,3395,3370,3449,3498,3395,3497,3452,127,82,14,36
20150303,3497,3452,3407,3599,3407,3569,3541,117,89,40,42
20150304,3569,3541,3414,3621,3414,3581,3544,40,3,28,28
20150305,3581,3544,3540,3718,3540,3706,3646,162,102,68,38
20150306,3706,3646,3647,3828,3647,3828,3799,182,153,32,38
20150309,3828,3799,3865,3988,3865,3988,3982,189,183,46,64
20150310,3988,3982,3876,4089,3836,3836,3883,-146,-99,16,60
20150311,3836,3883,3991,3991,3690,3864,3784,-19,-99,40,70
20150312,3864,3784,3783,3842,3610,3610,3692,-174,-92,32,76
20150313,3610,3692,3513,3515,3507,3507,3509,-185,-183,16,72
20150316,3507,3509,3506,3506,3228,3268,3254,-241,-255,68,82
20150317,3268,3254,3096,3398,3096,3196,3190,-58,-64,130,102
20150318,3196,3190,3150,3233,3150,3181,3193,-9,3,56,112
20150319,3181,3193,3280,3308,3202,3280,3262,87,69,144,136
20150320,3280,3262,3281,3281,3221,3221,3256,-41,-6,18,134
20150323,3221,3256,3266,3356,3202,3290,3287,34,31,144,166
20150324,3290,3287,3322,3322,3216,3265,3253,-22,-34,78,162
20150325,3265,3253,3217,3280,3217,3266,3248,13,-5,36,168
20150326,3266,3248,3296,3408,3263,3370,3343,122,95,156,182
20150327,3370,3343,3343,3344,3250,3313,3302,-30,-41,40,178
20150330,3313,3302,3310,3310,3200,3215,3239,-87,-63,26,176
20150331,3215,3239,3310,3310,3203,3230,3243,-9,4,16,174
20150401,3230,3243,3200,3279,3180,3203,3220,-40,-23,24,180
20150402,3203,3220,3250,3310,3234,3244,3263,24,43,44,188
20150403,3244,3263,3221,3235,3182,3235,3212,-28,-51,10,188
20150407,3235,3212,3127,3337,3126,3306,3271,94,59,128,198
20150408,3306,3271,3297,3345,3297,3310,3328,39,57,76,206
20150409,3310,3328,3251,3308,3251,3275,3283,-53,-45,30,198
20150410,3275,3283,3276,3281,3213,3258,3256,-25,-27,38,194
20150413,3258,3256,3272,3317,3272,3281,3283,25,27,24,188
20150414,3281,3283,3281,3281,3234,3277,3269,-6,-14,10,188
20150415,3277,3269,3280,3280,3226,3279,3264,10,-5,18,192
20150416,3279,3264,3312,3312,3260,3288,3299,24,35,50,190
20150417,3288,3299,3313,3380,3313,3359,3354,60,55,90,204
20150420,3359,3354,3367,3376,3317,3349,3341,-5,-13,70,194
20150421,3349,3341,3321,3357,3321,3343,3343,2,2,48,180
20150422,3343,3343,3327,3350,3326,3333,3339,-10,-4,32,178
20150423,3333,3339,3337,3352,3331,3346,3342,7,3,56,170
20150424,3346,3342,3346,3375,3344,3352,3355,10,13,50,168
20150427,3352,3355,3357,3387,3357,3382,3376,27,21,24,176
20150428,3382,3376,3389,3506,3389,3423,3456,47,80,50,176
20150429,3423,3456,3421,3444,3367,3422,3423,-34,-33,44,174
20150430,3422,3423,3425,3525,3425,3431,3465,8,42,56,170
20150504,3431,3465,3465,3582,3464,3582,3529,117,64,62,182
20150505,3582,3529,3626,3705,3626,3640,3665,111,136,114,174
20150506,3640,3665,3770,3770,3675,3726,3736,61,71,54,178
20150507,3726,3736,3649,3649,3549,3549,3572,-187,-164,52,172
20150508,3549,3572,3290,3360,3288,3288,3318,-284,-254,140,174
20150511,3288,3318,3325,3468,3291,3412,3400,94,82,150,172
20150512,3412,3400,3401,3569,3282,3290,3344,-110,-56,146,170
20150513,3290,3344,3419,3479,3302,3369,3380,25,36,160,172
20150514,3369,3380,3337,3349,3285,3349,3320,-31,-60,64,168
20150515,3349,3320,3303,3312,3201,3210,3245,-110,-75,52,164
20150518,3210,3245,3135,3247,3131,3247,3197,2,-48,68,162
20150519,3247,3197,3054,3157,3054,3157,3113,-40,-84,68,162
20150520,3157,3113,3045,3095,3000,3017,3037,-96,-76,88,172
20150521,3017,3037,2971,3035,2971,3002,3008,-35,-29,100,164
20150522,3002,3008,2902,3004,2857,2857,2873,-151,-135,114,130
20150525,2857,2873,2899,2900,2750,2849,2797,-24,-76,92,78
20150526,2849,2797,2849,2936,2770,2936,2881,139,84,44,78
20150527,2936,2881,3111,3111,3111,3111,3111,230,230,4,74
20150528,3111,3111,3100,3100,3100,3100,3100,-11,-11,74,74
20150529,3100,3100,,,,3100,3100,0,0,0,74
fu1507,20150105,3259,3259,,,,3259,3259,0,0,0,0
20150106,3259,3259,,,,3259,3259,0,0,0,0
20150107,3259,3259,,,,3259,3259,0,0,0,0
20150108,3259,3259,,,,3259,3259,0,0,0,0
20150109,3259,3259,,,,3259,3259,0,0,0,0
20150112,3259,3259,,,,3259,3259,0,0,0,0
20150113,3259,3259,,,,3259,3259,0,0,0,0
20150114,3259,3259,,,,3259,3259,0,0,0,0
20150115,3259,3259,,,,3259,3259,0,0,0,0
20150116,3259,3259,,,,3259,3259,0,0,0,0
20150119,3259,3259,,,,3378,3378,119,119,0,0
20150120,3378,3378,,,,3378,3378,0,0,0,0
20150121,3378,3378,,,,3305,3305,-73,-73,0,0
20150122,3305,3305,,,,3470,3470,165,165,0,0
20150123,3470,3470,,,,3501,3501,31,31,0,0
20150126,3501,3501,,,,3338,3338,-163,-163,0,0
20150127,3338,3338,,,,3427,3427,89,89,0,0
20150128,3427,3427,,,,3427,3427,0,0,0,0
20150129,3427,3427,,,,3329,3329,-98,-98,0,0
20150130,3329,3329,,,,3170,3170,-159,-159,0,0
20150202,3170,3170,,,,3327,3327,157,157,0,0
20150203,3327,3327,3327,3327,3209,3209,3268,-118,-59,4,4
20150204,3209,3268,3209,3209,3208,3208,3208,-60,-60,4,2
20150205,3208,3208,,,,3208,3208,0,0,0,2
20150206,3208,3208,,,,3208,3208,0,0,0,2
20150209,3208,3208,,,,3208,3208,0,0,0,2
20150210,3208,3208,,,,3208,3208,0,0,0,2
20150211,3208,3208,,,,3208,3208,0,0,0,2
20150212,3208,3208,,,,3208,3208,0,0,0,2
20150213,3208,3208,,,,3208,3208,0,0,0,2
20150216,3208,3208,,,,3208,3208,0,0,0,2
20150217,3208,3208,,,,3222,3222,14,14,0,2
20150225,3222,3222,,,,3222,3222,0,0,0,2
20150226,3222,3222,,,,3309,3309,87,87,0,2
20150227,3309,3309,,,,3309,3309,0,0,0,2
20150302,3309,3309,,,,3390,3390,81,81,0,2
20150303,3390,3390,,,,3390,3390,0,0,0,2
20150304,3390,3390,,,,3390,3390,0,0,0,2
20150305,3390,3390,,,,3487,3487,97,97,0,2
20150306,3487,3487,,,,3633,3633,146,146,0,2
20150309,3633,3633,,,,3808,3808,175,175,0,2
20150310,3808,3808,,,,3808,3808,0,0,0,2
20150311,3808,3808,3617,3617,3617,3617,3617,-191,-191,2,2
20150312,3617,3617,,,,3529,3529,-88,-88,0,2
20150313,3529,3529,,,,3480,3480,-49,-49,0,2
20150316,3480,3480,3339,3339,3339,3339,3339,-141,-141,2,2
20150317,3339,3339,,,,3274,3274,-65,-65,0,2
20150318,3274,3274,,,,3274,3274,0,0,0,2
20150319,3274,3274,3111,3111,3111,3111,3111,-163,-163,2,4
20150320,3111,3111,,,,3105,3105,-6,-6,0,4
20150323,3105,3105,,,,3134,3134,29,29,0,4
20150324,3134,3134,3002,3002,3002,3002,3002,-132,-132,2,2
20150325,3002,3002,,,,3152,3152,150,150,0,2
20150326,3152,3152,,,,3244,3244,92,92,0,2
20150327,3244,3244,3406,3406,3162,3162,3324,-82,80,6,6
20150330,3162,3324,,,,3324,3324,0,0,0,6
20150331,3324,3324,,,,3324,3324,0,0,0,6
20150401,3324,3324,,,,3324,3324,0,0,0,6
20150402,3324,3324,,,,3324,3324,0,0,0,6
20150403,3324,3324,,,,3324,3324,0,0,0,6
20150407,3324,3324,,,,3324,3324,0,0,0,6
20150408,3324,3324,3158,3158,3158,3158,3158,-166,-166,2,6
20150409,3158,3158,,,,3115,3115,-43,-43,0,6
20150410,3115,3115,,,,3270,3270,155,155,0,6
20150413,3270,3270,,,,3297,3297,27,27,0,6
20150414,3297,3297,3134,3134,3134,3134,3134,-163,-163,2,6
20150415,3134,3134,,,,3129,3129,-5,-5,0,6
20150416,3129,3129,,,,3285,3285,156,156,0,6
20150417,3285,3285,3157,3427,3157,3173,3263,-112,-22,12,6
20150420,3173,3263,3190,3190,3190,3190,3190,-73,-73,4,6
20150421,3190,3190,3349,3349,3349,3349,3349,159,159,2,4
20150422,3349,3349,3204,3204,3204,3204,3204,-145,-145,2,4
20150423,3204,3204,,,,3207,3207,3,3,0,4
20150424,3207,3207,,,,3219,3219,12,12,0,4
20150427,3219,3219,3061,3379,3061,3379,3252,160,33,6,6
20150428,3379,3252,3259,3259,3259,3259,3259,7,7,2,4
20150429,3259,3259,,,,3228,3228,-31,-31,0,4
20150430,3228,3228,,,,3267,3267,39,39,0,4
20150504,3267,3267,,,,3328,3328,61,61,0,4
20150505,3328,3328,,,,3456,3456,128,128,0,4
20150506,3456,3456,,,,3628,3628,172,172,0,4
20150507,3628,3628,,,,3469,3469,-159,-159,0,4
20150508,3469,3469,,,,3295,3295,-174,-174,0,4
20150511,3295,3295,,,,3377,3377,82,82,0,4
20150512,3377,3377,,,,3321,3321,-56,-56,0,4
20150513,3321,3321,,,,3357,3357,36,36,0,4
20150514,3357,3357,,,,3297,3297,-60,-60,0,4
20150515,3297,3297,,,,3222,3222,-75,-75,0,4
20150518,3222,3222,3341,3341,3341,3341,3341,119,119,4,4
20150519,3341,3341,3249,3249,3249,3249,3249,-92,-92,2,6
20150520,3249,3249,,,,3249,3249,0,0,0,6
20150521,3249,3249,,,,3249,3249,0,0,0,6
20150522,3249,3249,,,,3103,3103,-146,-146,0,6
20150525,3103,3103,,,,3020,3020,-83,-83,0,6
20150526,3020,3020,,,,3110,3110,90,90,0,6
20150527,3110,3110,,,,3265,3265,155,155,0,6
20150528,3265,3265,,,,3265,3265,0,0,0,6
20150529,3265,3265,,,,3265,3265,0,0,0,6
20150601,3265,3265,,,,3265,3265,0,0,0,6
20150602,3265,3265,3264,3264,3264,3264,3264,-1,-1,2,6
20150603,3264,3264,,,,3264,3264,0,0,0,6
20150604,3264,3264,,,,3264,3264,0,0,0,6
20150605,3264,3264,,,,3264,3264,0,0,0,6
20150608,3264,3264,,,,3264,3264,0,0,0,6
20150609,3264,3264,,,,3264,3264,0,0,0,6
20150610,3264,3264,,,,3264,3264,0,0,0,6
20150611,3264,3264,,,,3264,3264,0,0,0,6
20150612,3264,3264,,,,3264,3264,0,0,0,6
20150615,3264,3264,,,,3264,3264,0,0,0,6
20150616,3264,3264,3100,3100,3100,3100,3100,-164,-164,2,4
20150617,3100,3100,,,,3100,3100,0,0,0,4
20150618,3100,3100,2945,2945,2945,2945,2945,-155,-155,2,2
20150619,2945,2945,,,,2945,2945,0,0,0,2
20150623,2945,2945,,,,2945,2945,0,0,0,2
20150624,2945,2945,,,,2945,2945,0,0,0,2
20150625,2945,2945,2797,3091,2797,3090,3001,145,56,8,0
20150626,3090,3001,,,,3001,3001,0,0,0,0
20150629,3001,3001,,,,3001,3001,0,0,0,0
20150630,3001,3001,,,,3001,3001,0,0,0,0
fu1508,20150105,3150,3150,,,,3150,3150,0,0,0,0
20150106,3150,3150,,,,3150,3150,0,0,0,0
20150107,3150,3150,,,,3150,3150,0,0,0,0
20150108,3150,3150,,,,3150,3150,0,0,0,0
20150109,3150,3150,,,,3150,3150,0,0,0,0
20150112,3150,3150,,,,3150,3150,0,0,0,0
20150113,3150,3150,,,,3150,3150,0,0,0,0
20150114,3150,3150,,,,3150,3150,0,0,0,0
20150115,3150,3150,,,,3150,3150,0,0,0,0
20150116,3150,3150,,,,3150,3150,0,0,0,0
20150119,3150,3150,,,,3150,3150,0,0,0,0
20150120,3150,3150,,,,3150,3150,0,0,0,0
20150121,3150,3150,,,,3150,3150,0,0,0,0
20150122,3150,3150,,,,3150,3150,0,0,0,0
20150123,3150,3150,,,,3150,3150,0,0,0,0
20150126,3150,3150,,,,3150,3150,0,0,0,0
20150127,3150,3150,,,,3150,3150,0,0,0,0
20150128,3150,3150,,,,3150,3150,0,0,0,0
20150129,3150,3150,,,,3150,3150,0,0,0,0
20150130,3150,3150,,,,3150,3150,0,0,0,0
20150202,3150,3150,,,,3150,3150,0,0,0,0
20150203,3150,3150,,,,3150,3150,0,0,0,0
20150204,3150,3150,,,,3150,3150,0,0,0,0
20150205,3150,3150,,,,3150,3150,0,0,0,0
20150206,3150,3150,,,,3150,3150,0,0,0,0
20150209,3150,3150,,,,3150,3150,0,0,0,0
20150210,3150,3150,,,,3150,3150,0,0,0,0
20150211,3150,3150,,,,3150,3150,0,0,0,0
20150212,3150,3150,,,,3150,3150,0,0,0,0
20150213,3150,3150,3307,3307,2992,3160,3153,10,3,6,0
20150216,3160,3153,,,,3153,3153,0,0,0,0
20150217,3153,3153,3373,3373,3373,3373,3373,220,220,2,2
20150225,3373,3373,3136,3136,3136,3136,3136,-237,-237,2,0
20150226,3136,3136,,,,3221,3221,85,85,0,0
20150227,3221,3221,,,,3221,3221,0,0,0,0
20150302,3221,3221,,,,3300,3300,79,79,0,0
20150303,3300,3300,,,,3385,3385,85,85,0,0
20150304,3385,3385,,,,3385,3385,0,0,0,0
20150305,3385,3385,,,,3482,3482,97,97,0,0
20150306,3482,3482,3347,3347,3347,3347,3347,-135,-135,2,2
20150309,3347,3347,,,,3508,3508,161,161,0,2
20150310,3508,3508,,,,3421,3421,-87,-87,0,2
20150311,3421,3421,,,,3249,3249,-172,-172,0,2
20150312,3249,3249,,,,3170,3170,-79,-79,0,2
20150313,3170,3170,,,,3013,3013,-157,-157,0,2
20150316,3013,3013,,,,2890,2890,-123,-123,0,2
20150317,2890,2890,,,,3034,3034,144,144,0,2
20150318,3034,3034,,,,3037,3037,3,3,0,2
20150319,3037,3037,,,,2885,2885,-152,-152,0,2
20150320,2885,2885,,,,2880,2880,-5,-5,0,2
20150323,2880,2880,,,,2907,2907,27,27,0,2
20150324,2907,2907,,,,3052,3052,145,145,0,2
20150325,3052,3052,,,,3047,3047,-5,-5,0,2
20150326,3047,3047,,,,3199,3199,152,152,0,2
20150327,3199,3199,,,,3278,3278,79,79,0,2
20150330,3278,3278,,,,3278,3278,0,0,0,2
20150331,3278,3278,,,,3278,3278,0,0,0,2
20150401,3278,3278,,,,3278,3278,0,0,0,2
20150402,3278,3278,,,,3278,3278,0,0,0,2
20150403,3278,3278,,,,3278,3278,0,0,0,2
20150407,3278,3278,,,,3278,3278,0,0,0,2
20150408,3278,3278,,,,3114,3114,-164,-164,0,2
20150409,3114,3114,,,,3071,3071,-43,-43,0,2
20150410,3071,3071,,,,3224,3224,153,153,0,2
20150413,3224,3224,,,,3250,3250,26,26,0,2
20150414,3250,3250,,,,3089,3089,-161,-161,0,2
20150415,3089,3089,,,,3243,3243,154,154,0,2
20150416,3243,3243,,,,3278,3278,35,35,0,2
20150417,3278,3278,,,,3256,3256,-22,-22,0,2
20150420,3256,3256,,,,3183,3183,-73,-73,0,2
20150421,3183,3183,,,,3341,3341,158,158,0,2
20150422,3341,3341,,,,3341,3341,0,0,0,2
20150423,3341,3341,,,,3341,3341,0,0,0,2
20150424,3341,3341,,,,3341,3341,0,0,0,2
20150427,3341,3341,,,,3341,3341,0,0,0,2
20150428,3341,3341,,,,3348,3348,7,7,0,2
20150429,3348,3348,,,,3348,3348,0,0,0,2
20150430,3348,3348,,,,3398,3398,50,50,0,2
20150504,3398,3398,,,,3461,3461,63,63,0,2
20150505,3461,3461,,,,3594,3594,133,133,0,2
20150506,3594,3594,3773,3773,3415,3740,3576,146,-18,10,4
20150507,3740,3576,3423,3423,3423,3423,3423,-153,-153,2,4
20150508,3423,3423,,,,3251,3251,-172,-172,0,4
20150511,3251,3251,,,,3332,3332,81,81,0,4
20150512,3332,3332,,,,3277,3277,-55,-55,0,4
20150513,3277,3277,,,,3312,3312,35,35,0,4
20150514,3312,3312,,,,3253,3253,-59,-59,0,4
20150515,3253,3253,,,,3179,3179,-74,-74,0,4
20150518,3179,3179,3023,3023,3023,3023,3023,-156,-156,2,4
20150519,3023,3023,,,,3174,3174,151,151,0,4
20150520,3174,3174,,,,3097,3097,-77,-77,0,4
20150521,3097,3097,,,,3251,3251,154,154,0,4
20150522,3251,3251,3089,3410,3089,3409,3302,158,51,6,8
20150525,3409,3302,3149,3360,3149,3360,3254,58,-48,4,8
20150526,3360,3254,3102,3412,3102,3323,3304,69,50,14,10
20150527,3323,3304,,,,3304,3304,0,0,0,10
20150528,3304,3304,3150,3150,3150,3150,3150,-154,-154,2,10
20150529,3150,3150,,,,3150,3150,0,0,0,10
20150601,3150,3150,3307,3307,3307,3307,3307,157,157,2,10
20150602,3307,3307,,,,3307,3307,0,0,0,10
20150603,3307,3307,,,,3307,3307,0,0,0,10
20150604,3307,3307,,,,3307,3307,0,0,0,10
20150605,3307,3307,,,,3208,3208,-99,-99,0,10
20150608,3208,3208,3159,3159,3159,3159,3159,-49,-49,2,10
20150609,3159,3159,,,,3159,3159,0,0,0,10
20150610,3159,3159,,,,3159,3159,0,0,0,10
20150611,3159,3159,,,,3159,3159,0,0,0,10
20150612,3159,3159,,,,3159,3159,0,0,0,10
20150615,3159,3159,,,,3159,3159,0,0,0,10
20150616,3159,3159,,,,3159,3159,0,0,0,10
20150617,3159,3159,3011,3011,3011,3011,3011,-148,-148,2,10
20150618,3011,3011,3161,3161,2919,2919,3040,-92,29,4,8
20150619,2919,3040,2888,2888,2888,2888,2888,-152,-152,2,8
20150623,2888,2888,2991,3032,2991,3032,3011,144,123,4,6
20150624,3032,3011,,,,3011,3011,0,0,0,6
20150625,3011,3011,3160,3160,2861,2861,3010,-150,-1,4,6
20150626,2861,3010,,,,3010,3010,0,0,0,6
20150629,3010,3010,,,,3010,3010,0,0,0,6
20150630,3010,3010,,,,3010,3010,0,0,0,6
20150701,3010,3010,,,,3010,3010,0,0,0,6
20150702,3010,3010,,,,3010,3010,0,0,0,6
20150703,3010,3010,,,,3010,3010,0,0,0,6
20150706,3010,3010,,,,3010,3010,0,0,0,6
20150707,3010,3010,,,,3010,3010,0,0,0,6
20150708,3010,3010,3159,3159,3159,3159,3159,149,149,2,6
20150709,3159,3159,,,,3001,3001,-158,-158,0,6
20150710,3001,3001,,,,2850,2850,-151,-151,0,6
20150713,2850,2850,,,,2707,2707,-143,-143,0,6
20150714,2707,2707,,,,2707,2707,0,0,0,6
20150715,2707,2707,2778,2778,2571,2571,2640,-136,-67,6,6
20150716,2571,2640,,,,2640,2640,0,0,0,6
20150717,2640,2640,,,,2508,2508,-132,-132,0,6
20150720,2508,2508,,,,2382,2382,-126,-126,0,6
20150721,2382,2382,,,,2382,2382,0,0,0,6
20150722,2382,2382,2262,2262,2262,2262,2262,-120,-120,2,6
20150723,2262,2262,2081,2436,2081,2083,2200,-179,-62,6,6
20150724,2083,2200,,,,2200,2200,0,0,0,6
20150727,2200,2200,,,,2200,2200,0,0,0,6
20150728,2200,2200,,,,2200,2200,0,0,0,6
20150729,2200,2200,,,,2200,2200,0,0,0,6
20150730,2200,2200,,,,2200,2200,0,0,0,6
20150731,2200,2200,,,,2200,2200,0,0,0,6
fu1509,20150105,3124,3124,,,,3124,3124,0,0,0,4
20150106,3124,3124,3280,3280,2967,3124,3123,0,-1,6,6
20150107,3124,3123,,,,3123,3123,0,0,0,6
20150108,3123,3123,,,,3123,3123,0,0,0,6
20150109,3123,3123,,,,3123,3123,0,0,0,6
20150112,3123,3123,,,,3123,3123,0,0,0,6
20150113,3123,3123,,,,3123,3123,0,0,0,6
20150114,3123,3123,,,,3123,3123,0,0,0,6
20150115,3123,3123,,,,3123,3123,0,0,0,6
20150116,3123,3123,,,,3123,3123,0,0,0,6
20150119,3123,3123,,,,3123,3123,0,0,0,6
20150120,3123,3123,,,,3123,3123,0,0,0,6
20150121,3123,3123,,,,3123,3123,0,0,0,6
20150122,3123,3123,,,,3123,3123,0,0,0,6
20150123,3123,3123,,,,3123,3123,0,0,0,6
20150126,3123,3123,,,,3123,3123,0,0,0,6
20150127,3123,3123,3278,3278,2975,2975,3126,-148,3,4,8
20150128,2975,3126,3282,3282,3282,3282,3282,156,156,2,10
20150129,3282,3282,,,,3188,3188,-94,-94,0,10
20150130,3188,3188,3158,3158,3158,3158,3158,-30,-30,2,8
20150202,3158,3158,3315,3315,3315,3315,3315,157,157,2,10
20150203,3315,3315,,,,3256,3256,-59,-59,0,10
20150204,3256,3256,,,,3256,3256,0,0,0,10
20150205,3256,3256,,,,3256,3256,0,0,0,10
20150206,3256,3256,,,,3243,3243,-13,-13,0,10
20150209,3243,3243,,,,3223,3223,-20,-20,0,10
20150210,3223,3223,,,,3144,3144,-79,-79,0,10
20150211,3144,3144,,,,3144,3144,0,0,0,10
20150212,3144,3144,,,,3144,3144,0,0,0,10
20150213,3144,3144,3301,3301,3300,3300,3300,156,156,4,14
20150216,3300,3300,,,,3300,3300,0,0,0,14
20150217,3300,3300,,,,3300,3300,0,0,0,14
20150225,3300,3300,,,,3300,3300,0,0,0,14
20150226,3300,3300,,,,3300,3300,0,0,0,14
20150227,3300,3300,,,,3267,3267,-33,-33,0,14
20150302,3267,3267,,,,3290,3290,23,23,0,14
20150303,3290,3290,,,,3290,3290,0,0,0,14
20150304,3290,3290,3454,3454,3454,3454,3454,164,164,2,14
20150305,3454,3454,,,,3454,3454,0,0,0,14
20150306,3454,3454,,,,3320,3320,-134,-134,0,14
20150309,3320,3320,3156,3156,3156,3156,3156,-164,-164,2,14
20150310,3156,3156,,,,3313,3313,157,157,0,14
20150311,3313,3313,3150,3150,3150,3150,3150,-163,-163,2,14
20150312,3150,3150,,,,3073,3073,-77,-77,0,14
20150313,3073,3073,,,,3226,3226,153,153,0,14
20150316,3226,3226,3066,3066,3066,3066,3066,-160,-160,2,14
20150317,3066,3066,3219,3219,3219,3219,3219,153,153,6,18
20150318,3219,3219,,,,3219,3219,0,0,0,18
20150319,3219,3219,,,,3219,3219,0,0,0,18
20150320,3219,3219,3349,3350,3349,3350,3349,131,130,8,24
20150323,3350,3349,3350,3380,3343,3380,3357,31,8,6,26
20150324,3380,3357,,,,3357,3357,0,0,0,26
20150325,3357,3357,3221,3336,3221,3336,3278,-21,-79,4,24
20150326,3336,3278,,,,3306,3306,28,28,0,24
20150327,3306,3306,,,,3306,3306,0,0,0,24
20150330,3306,3306,3465,3465,3465,3465,3465,159,159,2,26
20150331,3465,3465,3301,3495,3301,3495,3398,30,-67,4,28
20150401,3495,3398,3290,3290,3290,3290,3290,-108,-108,2,28
20150402,3290,3290,,,,3290,3290,0,0,0,28
20150403,3290,3290,,,,3290,3290,0,0,0,28
20150407,3290,3290,,,,3291,3291,1,1,0,28
20150408,3291,3291,,,,3291,3291,0,0,0,28
20150409,3291,3291,3157,3157,3157,3157,3157,-134,-134,2,28
20150410,3157,3157,3314,3314,3314,3314,3314,157,157,2,30
20150413,3314,3314,3269,3269,3269,3269,3269,-45,-45,2,28
20150414,3269,3269,,,,3107,3107,-162,-162,0,28
20150415,3107,3107,,,,3262,3262,155,155,0,28
20150416,3262,3262,,,,3297,3297,35,35,0,28
20150417,3297,3297,,,,3328,3328,31,31,0,28
20150420,3328,3328,3492,3492,3492,3492,3492,164,164,2,28
20150421,3492,3492,3352,3352,3352,3352,3352,-140,-140,2,28
20150422,3352,3352,,,,3354,3354,2,2,0,28
20150423,3354,3354,,,,3354,3354,0,0,0,28
20150424,3354,3354,,,,3354,3354,0,0,0,28
20150427,3354,3354,,,,3354,3354,0,0,0,28
20150428,3354,3354,,,,3354,3354,0,0,0,28
20150429,3354,3354,,,,3354,3354,0,0,0,28
20150430,3354,3354,3499,3520,3482,3482,3501,128,147,8,32
20150504,3482,3501,3539,3676,3501,3501,3572,0,71,6,30
20150505,3501,3572,,,,3710,3710,138,138,0,30
20150506,3710,3710,3551,3887,3551,3702,3702,-8,-8,10,32
20150507,3702,3702,3645,3646,3525,3525,3581,-177,-121,20,38
20150508,3525,3581,3421,3679,3421,3480,3481,-101,-100,14,46
20150511,3480,3481,3549,3653,3523,3653,3558,172,77,16,48
20150512,3653,3558,3570,3570,3570,3570,3570,12,12,2,48
20150513,3570,3570,3600,3600,3542,3542,3571,-28,1,4,48
20150514,3542,3571,3527,3532,3518,3518,3524,-53,-47,12,44
20150515,3518,3524,,,,3524,3524,0,0,0,44
20150518,3524,3524,3518,3518,3450,3500,3489,-24,-35,18,44
20150519,3500,3489,3473,3517,3408,3473,3469,-16,-20,30,46
20150520,3473,3469,3420,3420,3420,3420,3420,-49,-49,2,46
20150521,3420,3420,,,,3420,3420,0,0,0,46
20150522,3420,3420,3399,3478,3399,3408,3425,-12,5,18,50
20150525,3408,3425,3402,3480,3381,3409,3412,-16,-13,14,50
20150526,3409,3412,3353,3353,3300,3304,3325,-108,-87,38,66
20150527,3304,3325,3332,3333,3332,3333,3332,8,7,4,64
20150528,3333,3332,,,,3332,3332,0,0,0,64
20150529,3332,3332,3312,3312,3312,3312,3312,-20,-20,2,62
20150601,3312,3312,3361,3472,3352,3472,3378,160,66,28,72
20150602,3472,3378,3411,3420,3361,3361,3399,-17,21,18,68
20150603,3361,3399,3390,3391,3390,3391,3390,-8,-9,6,66
20150604,3391,3390,3299,3319,3297,3319,3301,-71,-89,14,64
20150605,3319,3301,3318,3339,3289,3300,3316,-1,15,14,62
20150608,3300,3316,,,,3316,3316,0,0,0,62
20150609,3316,3316,3287,3303,3261,3299,3287,-17,-29,14,60
20150610,3299,3287,3308,3319,3300,3319,3307,32,20,10,62
20150611,3319,3307,,,,3307,3307,0,0,0,62
20150612,3307,3307,,,,3307,3307,0,0,0,62
20150615,3307,3307,3310,3310,3310,3310,3310,3,3,2,62
20150616,3310,3310,3290,3354,3157,3354,3274,44,-36,10,64
20150617,3354,3274,3283,3296,3258,3258,3279,-16,5,6,64
20150618,3258,3279,3246,3251,3123,3232,3197,-47,-82,16,68
20150619,3232,3197,3222,3222,3222,3222,3222,25,25,2,68
20150623,3222,3222,3125,3211,3061,3161,3133,-61,-89,22,70
20150624,3161,3133,3249,3249,3110,3110,3147,-23,14,16,70
20150625,3110,3147,3150,3150,2993,2995,3056,-152,-91,20,74
20150626,2995,3056,3047,3047,2903,2910,2946,-146,-110,38,70
20150629,2910,2946,,,,2910,2910,-36,-36,0,70
20150630,2910,2910,,,,2910,2910,0,0,0,70
20150701,2910,2910,2813,2856,2770,2838,2813,-72,-97,24,72
20150702,2838,2813,2790,2790,2790,2790,2790,-23,-23,2,70
20150703,2790,2790,2816,2816,2660,2715,2730,-75,-60,18,72
20150706,2715,2730,2621,2621,2621,2621,2621,-109,-109,2,72
20150707,2621,2621,2736,2736,2519,2519,2627,-102,6,4,72
20150708,2519,2627,2519,2519,2519,2519,2519,-108,-108,4,70
20150709,2519,2519,2519,2643,2396,2589,2494,70,-25,92,82
20150710,2589,2494,2499,2587,2475,2522,2524,28,30,30,78
20150713,2522,2524,2426,2522,2426,2522,2489,-2,-35,6,76
20150714,2522,2489,2377,2497,2377,2492,2453,3,-36,26,80
20150715,2492,2453,,,,2453,2453,0,0,0,80
20150716,2453,2453,2520,2521,2431,2480,2490,27,37,16,74
20150717,2480,2490,2500,2535,2500,2535,2517,45,27,4,76
20150720,2535,2517,2413,2499,2413,2415,2440,-102,-77,14,76
20150721,2415,2440,2367,2467,2367,2429,2393,-11,-47,26,74
20150722,2429,2393,2363,2457,2312,2359,2351,-34,-42,34,72
20150723,2359,2351,2287,2338,2287,2338,2311,-13,-40,16,74
20150724,2338,2311,2275,2305,2240,2262,2259,-49,-52,44,74
20150727,2262,2259,2222,2299,2222,2287,2242,28,-17,26,72
20150728,2287,2242,2189,2275,2189,2252,2245,10,3,14,70
20150729,2252,2245,2245,2287,2245,2287,2259,42,14,6,70
20150730,2287,2259,2223,2278,2220,2220,2241,-39,-18,14,70
20150731,2220,2241,2205,2205,2187,2205,2197,-36,-44,14,74
20150803,2205,2197,2104,2189,2104,2120,2130,-77,-67,24,74
20150804,2120,2130,2131,2145,2053,2145,2097,15,-33,38,74
20150805,2145,2097,2091,2149,2091,2098,2111,1,14,38,72
20150806,2098,2111,2099,2137,2011,2098,2091,-13,-20,26,68
20150807,2098,2091,2148,2148,2096,2143,2137,52,46,18,68
20150810,2143,2137,2084,2230,2084,2222,2150,85,13,48,76
20150811,2222,2150,2155,2241,2155,2215,2199,65,49,32,76
20150812,2215,2199,2289,2289,2173,2240,2230,41,31,50,74
20150813,2240,2230,2239,2239,2239,2239,2239,9,9,2,74
20150814,2239,2239,2228,2259,2191,2191,2239,-48,0,20,74
20150817,2191,2239,2129,2199,2129,2199,2154,-40,-85,16,70
20150818,2199,2154,2199,2199,2059,2059,2113,-95,-41,36,70
20150819,2059,2113,2067,2156,2031,2039,2064,-74,-49,48,70
20150820,2039,2064,2058,2076,2012,2040,2041,-24,-23,16,68
20150821,2040,2041,1996,2043,1996,2019,2007,-22,-34,16,68
20150824,2019,2007,2008,2008,1906,1906,1919,-101,-88,16,68
20150825,1906,1919,1765,1951,1765,1765,1826,-154,-93,78,44
20150826,1765,1826,1752,1858,1734,1758,1759,-68,-67,106,38
20150827,1758,1759,,,,1759,1759,0,0,0,38
20150828,1759,1759,,,,1759,1759,0,0,0,38
20150831,1759,1759,1671,1846,1671,1846,1758,87,-1,4,36
fu1510,20150105,3123,3123,,,,3123,3123,0,0,0,6
20150106,3123,3123,,,,3123,3123,0,0,0,6
20150107,3123,3123,,,,3123,3123,0,0,0,6
20150108,3123,3123,,,,3123,3123,0,0,0,6
20150109,3123,3123,,,,3123,3123,0,0,0,6
20150112,3123,3123,,,,3123,3123,0,0,0,6
20150113,3123,3123,,,,3123,3123,0,0,0,6
20150114,3123,3123,,,,3123,3123,0,0,0,6
20150115,3123,3123,,,,3123,3123,0,0,0,6
20150116,3123,3123,,,,3123,3123,0,0,0,6
20150119,3123,3123,,,,3123,3123,0,0,0,6
20150120,3123,3123,,,,3123,3123,0,0,0,6
20150121,3123,3123,,,,3123,3123,0,0,0,6
20150122,3123,3123,,,,3123,3123,0,0,0,6
20150123,3123,3123,3277,3277,3277,3277,3277,154,154,2,8
20150126,3277,3277,,,,3277,3277,0,0,0,8
20150127,3277,3277,,,,3277,3277,0,0,0,8
20150128,3277,3277,,,,3276,3276,-1,-1,0,8
20150129,3276,3276,,,,3182,3182,-94,-94,0,8
20150130,3182,3182,,,,3152,3152,-30,-30,0,8
20150202,3152,3152,,,,3152,3152,0,0,0,8
20150203,3152,3152,,,,3152,3152,0,0,0,8
20150204,3152,3152,,,,3152,3152,0,0,0,8
20150205,3152,3152,,,,3152,3152,0,0,0,8
20150206,3152,3152,,,,3139,3139,-13,-13,0,8
20150209,3139,3139,,,,3139,3139,0,0,0,8
20150210,3139,3139,,,,3139,3139,0,0,0,8
20150211,3139,3139,,,,3139,3139,0,0,0,8
20150212,3139,3139,,,,3139,3139,0,0,0,8
20150213,3139,3139,,,,3295,3295,156,156,0,8
20150216,3295,3295,,,,3295,3295,0,0,0,8
20150217,3295,3295,,,,3295,3295,0,0,0,8
20150225,3295,3295,,,,3295,3295,0,0,0,8
20150226,3295,3295,3288,3288,3288,3288,3288,-7,-7,2,8
20150227,3288,3288,,,,3255,3255,-33,-33,0,8
20150302,3255,3255,,,,3255,3255,0,0,0,8
20150303,3255,3255,3345,3345,3345,3345,3345,90,90,2,8
20150304,3345,3345,,,,3450,3450,105,105,0,8
20150305,3450,3450,,,,3550,3550,100,100,0,8
20150306,3550,3550,,,,3550,3550,0,0,0,8
20150309,3550,3550,3374,3374,3374,3374,3374,-176,-176,2,8
20150310,3374,3374,3382,3382,3382,3382,3382,8,8,2,6
20150311,3382,3382,,,,3382,3382,0,0,0,6
20150312,3382,3382,3301,3364,3223,3364,3276,-18,-106,14,10
20150313,3364,3276,,,,3114,3114,-162,-162,0,10
20150316,3114,3114,,,,2959,2959,-155,-155,0,10
20150317,2959,2959,3001,3001,3001,3001,3001,42,42,4,6
20150318,3001,3001,,,,3004,3004,3,3,0,6
20150319,3004,3004,,,,2854,2854,-150,-150,0,6
20150320,2854,2854,,,,2996,2996,142,142,0,6
20150323,2996,2996,,,,3145,3145,149,149,0,6
20150324,3145,3145,,,,3012,3012,-133,-133,0,6
20150325,3012,3012,,,,3162,3162,150,150,0,6
20150326,3162,3162,,,,3254,3254,92,92,0,6
20150327,3254,3254,3095,3095,3095,3095,3095,-159,-159,2,4
20150330,3095,3095,,,,3243,3243,148,148,0,4
20150331,3243,3243,,,,3180,3180,-63,-63,0,4
20150401,3180,3180,,,,3078,3078,-102,-102,0,4
20150402,3078,3078,3231,3231,3231,3231,3231,153,153,2,2
20150403,3231,3231,,,,3231,3231,0,0,0,2
20150407,3231,3231,,,,3291,3291,60,60,0,2
20150408,3291,3291,,,,3126,3126,-165,-165,0,2
20150409,3126,3126,,,,2998,2998,-128,-128,0,2
20150410,2998,2998,,,,3147,3147,149,149,0,2
20150413,3147,3147,,,,3104,3104,-43,-43,0,2
20150414,3104,3104,,,,2950,2950,-154,-154,0,2
20150415,2950,2950,,,,3097,3097,147,147,0,2
20150416,3097,3097,,,,3251,3251,154,154,0,2
20150417,3251,3251,,,,3301,3301,50,50,0,2
20150420,3301,3301,3289,3289,3289,3289,3289,-12,-12,2,2
20150421,3289,3289,,,,3301,3301,12,12,0,2
20150422,3301,3301,,,,3303,3303,2,2,0,2
20150423,3303,3303,,,,3304,3304,1,1,0,2
20150424,3304,3304,3141,3468,3141,3468,3304,164,0,4,4
20150427,3468,3304,3302,3302,3302,3302,3302,-2,-2,2,2
20150428,3302,3302,,,,3302,3302,0,0,0,2
20150429,3302,3302,,,,3310,3310,8,8,0,2
20150430,3310,3310,3475,3475,3289,3289,3382,-21,72,4,4
20150504,3289,3382,3551,3551,3551,3551,3551,169,169,2,6
20150505,3551,3551,3376,3727,3376,3493,3532,-58,-19,6,8
20150506,3493,3532,3389,3708,3389,3708,3547,176,15,6,8
20150507,3708,3547,3384,3384,3384,3384,3384,-163,-163,2,8
20150508,3384,3384,,,,3289,3289,-95,-95,0,8
20150511,3289,3289,,,,3362,3362,73,73,0,8
20150512,3362,3362,,,,3373,3373,11,11,0,8
20150513,3373,3373,,,,3373,3373,0,0,0,8
20150514,3373,3373,3367,3367,3367,3367,3367,-6,-6,2,6
20150515,3367,3367,3199,3199,3199,3199,3199,-168,-168,2,6
20150518,3199,3199,,,,3358,3358,159,159,0,6
20150519,3358,3358,,,,3339,3339,-19,-19,0,6
20150520,3339,3339,,,,3339,3339,0,0,0,6
20150521,3339,3339,,,,3339,3339,0,0,0,6
20150522,3339,3339,,,,3339,3339,0,0,0,6
20150525,3339,3339,,,,3339,3339,0,0,0,6
20150526,3339,3339,3173,3173,3173,3173,3173,-166,-166,2,6
20150527,3173,3173,,,,3223,3223,50,50,0,6
20150528,3223,3223,,,,3072,3072,-151,-151,0,6
20150529,3072,3072,,,,3225,3225,153,153,0,6
20150601,3225,3225,,,,3289,3289,64,64,0,6
20150602,3289,3289,3131,3131,3131,3131,3131,-158,-158,2,6
20150603,3131,3131,,,,3287,3287,156,156,0,6
20150604,3287,3287,,,,3287,3287,0,0,0,6
20150605,3287,3287,,,,3287,3287,0,0,0,6
20150608,3287,3287,,,,3287,3287,0,0,0,6
20150609,3287,3287,3289,3349,3123,3123,3253,-164,-34,6,4
20150610,3123,3253,3092,3092,3092,3092,3092,-161,-161,2,4
20150611,3092,3092,,,,3092,3092,0,0,0,4
20150612,3092,3092,,,,3092,3092,0,0,0,4
20150615,3092,3092,,,,3094,3094,2,2,0,4
20150616,3094,3094,2945,2945,2945,2945,2945,-149,-149,2,4
20150617,2945,2945,3092,3092,3092,3092,3092,147,147,2,2
20150618,3092,3092,,,,3014,3014,-78,-78,0,2
20150619,3014,3014,,,,3037,3037,23,23,0,2
20150623,3037,3037,,,,2953,2953,-84,-84,0,2
20150624,2953,2953,,,,2966,2966,13,13,0,2
20150625,2966,2966,,,,2880,2880,-86,-86,0,2
20150626,2880,2880,,,,2776,2776,-104,-104,0,2
20150629,2776,2776,,,,2776,2776,0,0,0,2
20150630,2776,2776,,,,2776,2776,0,0,0,2
20150701,2776,2776,,,,2684,2684,-92,-92,0,2
20150702,2684,2684,,,,2662,2662,-22,-22,0,2
20150703,2662,2662,,,,2605,2605,-57,-57,0,2
20150706,2605,2605,,,,2500,2500,-105,-105,0,2
20150707,2500,2500,,,,2506,2506,6,6,0,2
20150708,2506,2506,,,,2402,2402,-104,-104,0,2
20150709,2402,2402,,,,2378,2378,-24,-24,0,2
20150710,2378,2378,,,,2406,2406,28,28,0,2
20150713,2406,2406,,,,2372,2372,-34,-34,0,2
20150714,2372,2372,,,,2337,2337,-35,-35,0,2
20150715,2337,2337,2220,2220,2220,2220,2220,-117,-117,4,4
20150716,2220,2220,,,,2331,2331,111,111,0,4
20150717,2331,2331,,,,2356,2356,25,25,0,4
20150720,2356,2356,2473,2473,2469,2469,2471,113,115,6,2
20150721,2469,2471,2481,2592,2347,2592,2502,121,31,8,2
20150722,2592,2502,,,,2502,2502,0,0,0,2
20150723,2502,2502,,,,2502,2502,0,0,0,2
20150724,2502,2502,2376,2626,2376,2376,2459,-126,-43,6,2
20150727,2376,2459,,,,2441,2441,-18,-18,0,2
20150728,2441,2441,,,,2444,2444,3,3,0,2
20150729,2444,2444,,,,2459,2459,15,15,0,2
20150730,2459,2459,,,,2440,2440,-19,-19,0,2
20150731,2440,2440,,,,2392,2392,-48,-48,0,2
20150803,2392,2392,,,,2319,2319,-73,-73,0,2
20150804,2319,2319,,,,2203,2203,-116,-116,0,2
20150805,2203,2203,2092,2312,2092,2312,2202,109,-1,4,2
20150806,2312,2202,,,,2202,2202,0,0,0,2
20150807,2202,2202,,,,2202,2202,0,0,0,2
20150810,2202,2202,,,,2202,2202,0,0,0,2
20150811,2202,2202,,,,2252,2252,50,50,0,2
20150812,2252,2252,,,,2252,2252,0,0,0,2
20150813,2252,2252,,,,2252,2252,0,0,0,2
20150814,2252,2252,,,,2252,2252,0,0,0,2
20150817,2252,2252,,,,2252,2252,0,0,0,2
20150818,2252,2252,,,,2209,2209,-43,-43,0,2
20150819,2209,2209,,,,2158,2158,-51,-51,0,2
20150820,2158,2158,,,,2134,2134,-24,-24,0,2
20150821,2134,2134,,,,2134,2134,0,0,0,2
20150824,2134,2134,,,,2040,2040,-94,-94,0,2
20150825,2040,2040,2109,2141,1938,1938,2003,-102,-37,18,10
20150826,1938,2003,,,,1917,1917,-86,-86,0,10
20150827,1917,1917,,,,1858,1858,-59,-59,0,10
20150828,1858,1858,1938,1948,1783,1893,1862,35,4,26,10
20150831,1893,1862,1857,1955,1857,1903,1918,41,56,30,12
20150901,1903,1918,1988,2013,1961,2010,1992,92,74,68,24
20150902,2010,1992,1901,2061,1901,1996,1975,4,-17,46,26
20150907,1996,1975,1903,2041,1903,2026,1987,51,12,40,32
20150908,2026,1987,2083,2083,1979,2061,2055,74,68,94,32
20150909,2061,2055,2117,2149,2077,2135,2117,80,62,80,34
20150910,2135,2117,2121,2198,2121,2198,2169,81,52,24,26
20150911,2198,2169,2171,2173,2171,2173,2172,4,3,6,20
20150914,2173,2172,2115,2115,2069,2098,2098,-74,-74,20,22
20150915,2098,2098,2198,2199,2126,2135,2158,37,60,10,20
20150916,2135,2158,2070,2100,2070,2100,2085,-58,-73,4,18
20150917,2100,2085,,,,2101,2101,16,16,0,18
20150918,2101,2101,,,,2120,2120,19,19,0,18
20150921,2120,2120,2121,2130,2121,2130,2125,10,5,8,16
20150922,2130,2125,2140,2228,2140,2200,2196,75,71,44,16
20150923,2200,2196,2200,2278,2200,2204,2225,8,29,18,14
20150924,2204,2225,2115,2288,2115,2257,2209,32,-16,16,14
20150925,2257,2209,2319,2319,2190,2190,2276,-19,67,6,16
20150928,2190,2276,2389,2389,2389,2389,2389,113,113,2,16
20150929,2389,2389,2508,2508,2508,2508,2508,119,119,2,16
20150930,2508,2508,,,,2508,2508,0,0,0,16
fu1511,20150105,3230,3230,,,,3230,3230,0,0,0,2
20150106,3230,3230,,,,3230,3230,0,0,0,2
20150107,3230,3230,,,,3230,3230,0,0,0,2
20150108,3230,3230,,,,3230,3230,0,0,0,2
20150109,3230,3230,,,,3230,3230,0,0,0,2
20150112,3230,3230,,,,3230,3230,0,0,0,2
20150113,3230,3230,,,,3230,3230,0,0,0,2
20150114,3230,3230,,,,3230,3230,0,0,0,2
20150115,3230,3230,,,,3230,3230,0,0,0,2
20150116,3230,3230,,,,3230,3230,0,0,0,2
20150119,3230,3230,,,,3230,3230,0,0,0,2
20150120,3230,3230,,,,3230,3230,0,0,0,2
20150121,3230,3230,,,,3230,3230,0,0,0,2
20150122,3230,3230,,,,3230,3230,0,0,0,2
20150123,3230,3230,,,,3230,3230,0,0,0,2
20150126,3230,3230,,,,3230,3230,0,0,0,2
20150127,3230,3230,,,,3230,3230,0,0,0,2
20150128,3230,3230,,,,3230,3230,0,0,0,2
20150129,3230,3230,,,,3230,3230,0,0,0,2
20150130,3230,3230,,,,3230,3230,0,0,0,2
20150202,3230,3230,,,,3390,3390,160,160,0,2
20150203,3390,3390,3559,3559,3399,3399,3479,9,89,4,2
20150204,3399,3479,,,,3415,3415,-64,-64,0,2
20150205,3415,3415,,,,3437,3437,22,22,0,2
20150206,3437,3437,,,,3423,3423,-14,-14,0,2
20150209,3423,3423,,,,3402,3402,-21,-21,0,2
20150210,3402,3402,,,,3319,3319,-83,-83,0,2
20150211,3319,3319,,,,3389,3389,70,70,0,2
20150212,3389,3389,,,,3408,3408,19,19,0,2
20150213,3408,3408,,,,3577,3577,169,169,0,2
20150216,3577,3577,,,,3596,3596,19,19,0,2
20150217,3596,3596,,,,3846,3846,250,250,0,2
20150225,3846,3846,,,,3576,3576,-270,-270,0,2
20150226,3576,3576,3397,3397,3397,3397,3397,-179,-179,2,2
20150227,3397,3397,,,,3363,3363,-34,-34,0,2
20150302,3363,3363,,,,3363,3363,0,0,0,2
20150303,3363,3363,,,,3363,3363,0,0,0,2
20150304,3363,3363,,,,3363,3363,0,0,0,2
20150305,3363,3363,,,,3460,3460,97,97,0,2
20150306,3460,3460,,,,3325,3325,-135,-135,0,2
20150309,3325,3325,,,,3160,3160,-165,-165,0,2
20150310,3160,3160,,,,3167,3167,7,7,0,2
20150311,3167,3167,,,,3011,3011,-156,-156,0,2
20150312,3011,3011,,,,3161,3161,150,150,0,2
20150313,3161,3161,,,,3004,3004,-157,-157,0,2
20150316,3004,3004,,,,2855,2855,-149,-149,0,2
20150317,2855,2855,2855,2855,2855,2855,2855,0,0,2,0
20150318,2855,2855,,,,2997,2997,142,142,0,0
20150319,2997,2997,,,,2847,2847,-150,-150,0,0
20150320,2847,2847,,,,2962,2962,115,115,0,0
20150323,2962,2962,,,,3110,3110,148,148,0,0
20150324,3110,3110,,,,2979,2979,-131,-131,0,0
20150325,2979,2979,,,,3127,3127,148,148,0,0
20150326,3127,3127,,,,3218,3218,91,91,0,0
20150327,3218,3218,,,,3060,3060,-158,-158,0,0
20150330,3060,3060,,,,3207,3207,147,147,0,0
20150331,3207,3207,,,,3144,3144,-63,-63,0,0
20150401,3144,3144,2986,2986,2986,2986,2986,-158,-158,2,2
20150402,2986,2986,,,,3135,3135,149,149,0,2
20150403,3135,3135,,,,3291,3291,156,156,0,2
20150407,3291,3291,3455,3455,3445,3445,3450,154,159,4,2
20150408,3445,3450,,,,3277,3277,-173,-173,0,2
20150409,3277,3277,3284,3284,3284,3284,3284,7,7,2,0
20150410,3284,3284,,,,3284,3284,0,0,0,0
20150413,3284,3284,,,,3284,3284,0,0,0,0
20150414,3284,3284,,,,3284,3284,0,0,0,0
20150415,3284,3284,,,,3284,3284,0,0,0,0
20150416,3284,3284,,,,3284,3284,0,0,0,0
20150417,3284,3284,,,,3284,3284,0,0,0,0
20150420,3284,3284,,,,3284,3284,0,0,0,0
20150421,3284,3284,,,,3284,3284,0,0,0,0
20150422,3284,3284,,,,3284,3284,0,0,0,0
20150423,3284,3284,,,,3284,3284,0,0,0,0
20150424,3284,3284,,,,3284,3284,0,0,0,0
20150427,3284,3284,,,,3284,3284,0,0,0,0
20150428,3284,3284,,,,3291,3291,7,7,0,0
20150429,3291,3291,,,,3260,3260,-31,-31,0,0
20150430,3260,3260,,,,3330,3330,70,70,0,0
20150504,3330,3330,,,,3496,3496,166,166,0,0
20150505,3496,3496,,,,3477,3477,-19,-19,0,0
20150506,3477,3477,,,,3492,3492,15,15,0,0
20150507,3492,3492,,,,3331,3331,-161,-161,0,0
20150508,3331,3331,,,,3238,3238,-93,-93,0,0
20150511,3238,3238,,,,3310,3310,72,72,0,0
20150512,3310,3310,,,,3321,3321,11,11,0,0
20150513,3321,3321,,,,3321,3321,0,0,0,0
20150514,3321,3321,,,,3315,3315,-6,-6,0,0
20150515,3315,3315,,,,3149,3149,-166,-166,0,0
20150518,3149,3149,,,,3118,3118,-31,-31,0,0
20150519,3118,3118,3199,3199,3199,3199,3199,81,81,2,2
20150520,3199,3199,,,,3358,3358,159,159,0,2
20150521,3358,3358,3458,3458,3458,3458,3458,100,100,2,0
20150522,3458,3458,,,,3458,3458,0,0,0,0
20150525,3458,3458,,,,3444,3444,-14,-14,0,0
20150526,3444,3444,,,,3272,3272,-172,-172,0,0
20150527,3272,3272,3108,3435,3108,3435,3271,163,-1,4,0
20150528,3435,3271,,,,3271,3271,0,0,0,0
20150529,3271,3271,,,,3271,3271,0,0,0,0
20150601,3271,3271,,,,3271,3271,0,0,0,0
20150602,3271,3271,,,,3113,3113,-158,-158,0,0
20150603,3113,3113,,,,3268,3268,155,155,0,0
20150604,3268,3268,,,,3182,3182,-86,-86,0,0
20150605,3182,3182,,,,3196,3196,14,14,0,0
20150608,3196,3196,,,,3147,3147,-49,-49,0,0
20150609,3147,3147,,,,3115,3115,-32,-32,0,0
20150610,3115,3115,,,,2960,2960,-155,-155,0,0
20150611,2960,2960,,,,3108,3108,148,148,0,0
20150612,3108,3108,,,,3108,3108,0,0,0,0
20150615,3108,3108,,,,3110,3110,2,2,0,0
20150616,3110,3110,,,,2960,2960,-150,-150,0,0
20150617,2960,2960,,,,3108,3108,148,148,0,0
20150618,3108,3108,,,,3030,3030,-78,-78,0,0
20150619,3030,3030,,,,3053,3053,23,23,0,0
20150623,3053,3053,,,,2969,2969,-84,-84,0,0
20150624,2969,2969,,,,2982,2982,13,13,0,0
20150625,2982,2982,,,,2896,2896,-86,-86,0,0
20150626,2896,2896,,,,2792,2792,-104,-104,0,0
20150629,2792,2792,,,,2792,2792,0,0,0,0
20150630,2792,2792,,,,2792,2792,0,0,0,0
20150701,2792,2792,,,,2699,2699,-93,-93,0,0
20150702,2699,2699,,,,2676,2676,-23,-23,0,0
20150703,2676,2676,,,,2618,2618,-58,-58,0,0
20150706,2618,2618,,,,2513,2513,-105,-105,0,0
20150707,2513,2513,,,,2519,2519,6,6,0,0
20150708,2519,2519,,,,2415,2415,-104,-104,0,0
20150709,2415,2415,,,,2391,2391,-24,-24,0,0
20150710,2391,2391,,,,2419,2419,28,28,0,0
20150713,2419,2419,,,,2385,2385,-34,-34,0,0
20150714,2385,2385,,,,2350,2350,-35,-35,0,0
20150715,2350,2350,,,,2232,2232,-118,-118,0,0
20150716,2232,2232,,,,2266,2266,34,34,0,0
20150717,2266,2266,,,,2291,2291,25,25,0,0
20150720,2291,2291,,,,2403,2403,112,112,0,0
20150721,2403,2403,,,,2433,2433,30,30,0,0
20150722,2433,2433,,,,2391,2391,-42,-42,0,0
20150723,2391,2391,,,,2350,2350,-41,-41,0,0
20150724,2350,2350,2232,2467,2232,2467,2349,117,-1,4,0
20150727,2467,2349,,,,2332,2332,-17,-17,0,0
20150728,2332,2332,,,,2335,2335,3,3,0,0
20150729,2335,2335,,,,2349,2349,14,14,0,0
20150730,2349,2349,,,,2331,2331,-18,-18,0,0
20150731,2331,2331,,,,2285,2285,-46,-46,0,0
20150803,2285,2285,,,,2215,2215,-70,-70,0,0
20150804,2215,2215,,,,2181,2181,-34,-34,0,0
20150805,2181,2181,,,,2180,2180,-1,-1,0,0
20150806,2180,2180,,,,2160,2160,-20,-20,0,0
20150807,2160,2160,,,,2208,2208,48,48,0,0
20150810,2208,2208,,,,2222,2222,14,14,0,0
20150811,2222,2222,,,,2273,2273,51,51,0,0
20150812,2273,2273,,,,2305,2305,32,32,0,0
20150813,2305,2305,,,,2305,2305,0,0,0,0
20150814,2305,2305,,,,2305,2305,0,0,0,0
20150817,2305,2305,,,,2218,2218,-87,-87,0,0
20150818,2218,2218,,,,2176,2176,-42,-42,0,0
20150819,2176,2176,,,,2126,2126,-50,-50,0,0
20150820,2126,2126,,,,2102,2102,-24,-24,0,0
20150821,2102,2102,,,,2067,2067,-35,-35,0,0
20150824,2067,2067,,,,1976,1976,-91,-91,0,0
20150825,1976,1976,,,,1940,1940,-36,-36,0,0
20150826,1940,1940,,,,1940,1940,0,0,0,0
20150827,1940,1940,,,,1940,1940,0,0,0,0
20150828,1940,1940,,,,1940,1940,0,0,0,0
20150831,1940,1940,,,,1940,1940,0,0,0,0
20150901,1940,1940,,,,2015,2015,75,75,0,0
20150902,2015,2015,,,,2015,2015,0,0,0,0
20150907,2015,2015,,,,2015,2015,0,0,0,0
20150908,2015,2015,,,,2084,2084,69,69,0,0
20150909,2084,2084,,,,2084,2084,0,0,0,0
20150910,2084,2084,,,,2135,2135,51,51,0,0
20150911,2135,2135,,,,2138,2138,3,3,0,0
20150914,2138,2138,,,,2065,2065,-73,-73,0,0
20150915,2065,2065,,,,2124,2124,59,59,0,0
20150916,2124,2124,,,,2124,2124,0,0,0,0
20150917,2124,2124,,,,2124,2124,0,0,0,0
20150918,2124,2124,,,,2124,2124,0,0,0,0
20150921,2124,2124,,,,2129,2129,5,5,0,0
20150922,2129,2129,,,,2200,2200,71,71,0,0
20150923,2200,2200,,,,2200,2200,0,0,0,0
20150924,2200,2200,,,,2200,2200,0,0,0,0
20150925,2200,2200,,,,2200,2200,0,0,0,0
20150928,2200,2200,,,,2200,2200,0,0,0,0
20150929,2200,2200,,,,2309,2309,109,109,0,0
20150930,2309,2309,,,,2309,2309,0,0,0,0
20151008,2309,2309,,,,2309,2309,0,0,0,0
20151009,2309,2309,,,,2309,2309,0,0,0,0
20151012,2309,2309,,,,2309,2309,0,0,0,0
20151013,2309,2309,,,,2309,2309,0,0,0,0
20151014,2309,2309,,,,2309,2309,0,0,0,0
20151015,2309,2309,,,,2309,2309,0,0,0,0
20151016,2309,2309,,,,2309,2309,0,0,0,0
20151019,2309,2309,,,,2309,2309,0,0,0,0
20151020,2309,2309,,,,2309,2309,0,0,0,0
20151021,2309,2309,,,,2309,2309,0,0,0,0
20151022,2309,2309,,,,2309,2309,0,0,0,0
20151023,2309,2309,,,,2309,2309,0,0,0,0
20151026,2309,2309,,,,2309,2309,0,0,0,0
20151027,2309,2309,,,,2309,2309,0,0,0,0
20151028,2309,2309,,,,2309,2309,0,0,0,0
20151029,2309,2309,,,,2309,2309,0,0,0,0
20151030,2309,2309,,,,2309,2309,0,0,0,0
fu1512,20150105,3177,3177,,,,3177,3177,0,0,0,0
20150106,3177,3177,,,,3177,3177,0,0,0,0
20150107,3177,3177,,,,3177,3177,0,0,0,0
20150108,3177,3177,,,,3177,3177,0,0,0,0
20150109,3177,3177,,,,3177,3177,0,0,0,0
20150112,3177,3177,,,,3177,3177,0,0,0,0
20150113,3177,3177,,,,3177,3177,0,0,0,0
20150114,3177,3177,,,,3177,3177,0,0,0,0
20150115,3177,3177,,,,3177,3177,0,0,0,0
20150116,3177,3177,,,,3177,3177,0,0,0,0
20150119,3177,3177,,,,3177,3177,0,0,0,0
20150120,3177,3177,,,,3177,3177,0,0,0,0
20150121,3177,3177,,,,3177,3177,0,0,0,0
20150122,3177,3177,,,,3177,3177,0,0,0,0
20150123,3177,3177,,,,3177,3177,0,0,0,0
20150126,3177,3177,,,,3177,3177,0,0,0,0
20150127,3177,3177,,,,3177,3177,0,0,0,0
20150128,3177,3177,,,,3177,3177,0,0,0,0
20150129,3177,3177,,,,3177,3177,0,0,0,0
20150130,3177,3177,,,,3177,3177,0,0,0,0
20150202,3177,3177,,,,3177,3177,0,0,0,0
20150203,3177,3177,,,,3177,3177,0,0,0,0
20150204,3177,3177,,,,3177,3177,0,0,0,0
20150205,3177,3177,,,,3177,3177,0,0,0,0
20150206,3177,3177,,,,3177,3177,0,0,0,0
20150209,3177,3177,,,,3177,3177,0,0,0,0
20150210,3177,3177,,,,3177,3177,0,0,0,0
20150211,3177,3177,,,,3177,3177,0,0,0,0
20150212,3177,3177,,,,3177,3177,0,0,0,0
20150213,3177,3177,,,,3177,3177,0,0,0,0
20150216,3177,3177,3335,3335,3335,3335,3335,158,158,4,4
20150217,3335,3335,,,,3335,3335,0,0,0,4
20150225,3335,3335,,,,3101,3101,-234,-234,0,4
20150226,3101,3101,,,,2945,2945,-156,-156,0,4
20150227,2945,2945,,,,3092,3092,147,147,0,4
20150302,3092,3092,,,,3246,3246,154,154,0,4
20150303,3246,3246,,,,3335,3335,89,89,0,4
20150304,3335,3335,3501,3501,3501,3501,3501,166,166,2,6
20150305,3501,3501,,,,3501,3501,0,0,0,6
20150306,3501,3501,,,,3365,3365,-136,-136,0,6
20150309,3365,3365,,,,3198,3198,-167,-167,0,6
20150310,3198,3198,,,,3205,3205,7,7,0,6
20150311,3205,3205,,,,3047,3047,-158,-158,0,6
20150312,3047,3047,3047,3047,3047,3047,3047,0,0,2,4
20150313,3047,3047,,,,3199,3199,152,152,0,4
20150316,3199,3199,3041,3041,3041,3041,3041,-158,-158,2,4
20150317,3041,3041,,,,3041,3041,0,0,0,4
20150318,3041,3041,,,,3044,3044,3,3,0,4
20150319,3044,3044,,,,2892,2892,-152,-152,0,4
20150320,2892,2892,,,,3036,3036,144,144,0,4
20150323,3036,3036,,,,3187,3187,151,151,0,4
20150324,3187,3187,,,,3052,3052,-135,-135,0,4
20150325,3052,3052,,,,3204,3204,152,152,0,4
20150326,3204,3204,3364,3364,3067,3113,3181,-91,-23,6,6
20150327,3113,3181,,,,3025,3025,-156,-156,0,6
20150330,3025,3025,,,,3176,3176,151,151,0,6
20150331,3176,3176,,,,3334,3334,158,158,0,6
20150401,3334,3334,,,,3167,3167,-167,-167,0,6
20150402,3167,3167,,,,3325,3325,158,158,0,6
20150403,3325,3325,,,,3325,3325,0,0,0,6
20150407,3325,3325,,,,3325,3325,0,0,0,6
20150408,3325,3325,,,,3158,3158,-167,-167,0,6
20150409,3158,3158,,,,3315,3315,157,157,0,6
20150410,3315,3315,,,,3315,3315,0,0,0,6
20150413,3315,3315,,,,3269,3269,-46,-46,0,6
20150414,3269,3269,,,,3107,3107,-162,-162,0,6
20150415,3107,3107,,,,3262,3262,155,155,0,6
20150416,3262,3262,,,,3297,3297,35,35,0,6
20150417,3297,3297,,,,3312,3312,15,15,0,6
20150420,3312,3312,,,,3312,3312,0,0,0,6
20150421,3312,3312,,,,3312,3312,0,0,0,6
20150422,3312,3312,,,,3312,3312,0,0,0,6
20150423,3312,3312,,,,3312,3312,0,0,0,6
20150424,3312,3312,,,,3320,3320,8,8,0,6
20150427,3320,3320,3486,3486,3323,3323,3404,3,84,4,6
20150428,3323,3404,,,,3404,3404,0,0,0,6
20150429,3404,3404,3233,3233,3233,3233,3233,-171,-171,2,6
20150430,3233,3233,,,,3394,3394,161,161,0,6
20150504,3394,3394,,,,3563,3563,169,169,0,6
20150505,3563,3563,3391,3740,3391,3740,3572,177,9,8,10
20150506,3740,3572,3740,3740,3740,3740,3740,168,168,2,10
20150507,3740,3740,3664,3664,3555,3650,3623,-90,-117,6,12
20150508,3650,3623,3443,3517,3443,3517,3483,-106,-140,6,12
20150511,3517,3483,3657,3657,3502,3502,3579,19,96,4,12
20150512,3502,3579,3400,3400,3400,3400,3400,-179,-179,2,10
20150513,3400,3400,,,,3400,3400,0,0,0,10
20150514,3400,3400,,,,3393,3393,-7,-7,0,10
20150515,3393,3393,,,,3223,3223,-170,-170,0,10
20150518,3223,3223,,,,3384,3384,161,161,0,10
20150519,3384,3384,,,,3471,3471,87,87,0,10
20150520,3471,3471,,,,3421,3421,-50,-50,0,10
20150521,3421,3421,,,,3421,3421,0,0,0,10
20150522,3421,3421,,,,3421,3421,0,0,0,10
20150525,3421,3421,,,,3421,3421,0,0,0,10
20150526,3421,3421,3250,3250,3250,3250,3250,-171,-171,2,10
20150527,3250,3250,,,,3291,3291,41,41,0,10
20150528,3291,3291,,,,3316,3316,25,25,0,10
20150529,3316,3316,,,,3316,3316,0,0,0,10
20150601,3316,3316,,,,3316,3316,0,0,0,10
20150602,3316,3316,,,,3361,3361,45,45,0,10
20150603,3361,3361,,,,3361,3361,0,0,0,10
20150604,3361,3361,,,,3361,3361,0,0,0,10
20150605,3361,3361,,,,3361,3361,0,0,0,10
20150608,3361,3361,,,,3361,3361,0,0,0,10
20150609,3361,3361,,,,3361,3361,0,0,0,10
20150610,3361,3361,,,,3194,3194,-167,-167,0,10
20150611,3194,3194,,,,3306,3306,112,112,0,10
20150612,3306,3306,,,,3306,3306,0,0,0,10
20150615,3306,3306,,,,3306,3306,0,0,0,10
20150616,3306,3306,,,,3306,3306,0,0,0,10
20150617,3306,3306,,,,3306,3306,0,0,0,10
20150618,3306,3306,3251,3251,3251,3251,3251,-55,-55,2,8
20150619,3251,3251,3102,3102,3102,3102,3102,-149,-149,2,8
20150623,3102,3102,,,,3016,3016,-86,-86,0,8
20150624,3016,3016,,,,3030,3030,14,14,0,8
20150625,3030,3030,,,,2942,2942,-88,-88,0,8
20150626,2942,2942,,,,2836,2836,-106,-106,0,8
20150629,2836,2836,,,,2836,2836,0,0,0,8
20150630,2836,2836,2809,2809,2809,2809,2809,-27,-27,2,8
20150701,2809,2809,2896,2896,2895,2895,2895,86,86,4,4
20150702,2895,2895,,,,2871,2871,-24,-24,0,4
20150703,2871,2871,,,,2871,2871,0,0,0,4
20150706,2871,2871,,,,2871,2871,0,0,0,4
20150707,2871,2871,,,,2871,2871,0,0,0,4
20150708,2871,2871,,,,2752,2752,-119,-119,0,4
20150709,2752,2752,,,,2725,2725,-27,-27,0,4
20150710,2725,2725,,,,2757,2757,32,32,0,4
20150713,2757,2757,,,,2719,2719,-38,-38,0,4
20150714,2719,2719,,,,2679,2679,-40,-40,0,4
20150715,2679,2679,,,,2545,2545,-134,-134,0,4
20150716,2545,2545,,,,2584,2584,39,39,0,4
20150717,2584,2584,,,,2612,2612,28,28,0,4
20150720,2612,2612,,,,2740,2740,128,128,0,4
20150721,2740,2740,,,,2740,2740,0,0,0,4
20150722,2740,2740,,,,2692,2692,-48,-48,0,4
20150723,2692,2692,,,,2692,2692,0,0,0,4
20150724,2692,2692,,,,2691,2691,-1,-1,0,4
20150727,2691,2691,,,,2671,2671,-20,-20,0,4
20150728,2671,2671,2803,2803,2539,2539,2627,-132,-44,6,4
20150729,2539,2627,,,,2643,2643,16,16,0,4
20150730,2643,2643,,,,2622,2622,-21,-21,0,4
20150731,2622,2622,,,,2571,2571,-51,-51,0,4
20150803,2571,2571,,,,2493,2493,-78,-78,0,4
20150804,2493,2493,,,,2454,2454,-39,-39,0,4
20150805,2454,2454,,,,2452,2452,-2,-2,0,4
20150806,2452,2452,,,,2429,2429,-23,-23,0,4
20150807,2429,2429,,,,2483,2483,54,54,0,4
20150810,2483,2483,,,,2498,2498,15,15,0,4
20150811,2498,2498,,,,2555,2555,57,57,0,4
20150812,2555,2555,,,,2591,2591,36,36,0,4
20150813,2591,2591,,,,2601,2601,10,10,0,4
20150814,2601,2601,2557,2557,2470,2470,2513,-131,-88,4,4
20150817,2470,2513,,,,2418,2418,-95,-95,0,4
20150818,2418,2418,,,,2372,2372,-46,-46,0,4
20150819,2372,2372,,,,2317,2317,-55,-55,0,4
20150820,2317,2317,,,,2291,2291,-26,-26,0,4
20150821,2291,2291,,,,2253,2253,-38,-38,0,4
20150824,2253,2253,,,,2154,2154,-99,-99,0,4
20150825,2154,2154,,,,2115,2115,-39,-39,0,4
20150826,2115,2115,,,,2038,2038,-77,-77,0,4
20150827,2038,2038,,,,2038,2038,0,0,0,4
20150828,2038,2038,,,,2042,2042,4,4,0,4
20150831,2042,2042,,,,2103,2103,61,61,0,4
20150901,2103,2103,,,,2185,2185,82,82,0,4
20150902,2185,2185,,,,2166,2166,-19,-19,0,4
20150907,2166,2166,,,,2179,2179,13,13,0,4
20150908,2179,2179,,,,2254,2254,75,75,0,4
20150909,2254,2254,,,,2322,2322,68,68,0,4
20150910,2322,2322,,,,2379,2379,57,57,0,4
20150911,2379,2379,,,,2366,2366,-13,-13,0,4
20150914,2366,2366,,,,2285,2285,-81,-81,0,4
20150915,2285,2285,,,,2351,2351,66,66,0,4
20150916,2351,2351,,,,2271,2271,-80,-80,0,4
20150917,2271,2271,,,,2271,2271,0,0,0,4
20150918,2271,2271,,,,2271,2271,0,0,0,4
20150921,2271,2271,,,,2276,2276,5,5,0,4
20150922,2276,2276,,,,2276,2276,0,0,0,4
20150923,2276,2276,,,,2276,2276,0,0,0,4
20150924,2276,2276,,,,2276,2276,0,0,0,4
20150925,2276,2276,,,,2276,2276,0,0,0,4
20150928,2276,2276,2389,2389,2389,2389,2389,113,113,2,4
20150929,2389,2389,2506,2506,2317,2317,2411,-72,22,4,4
20150930,2317,2411,2260,2333,2260,2333,2296,-78,-115,4,2
20151008,2333,2296,2456,2456,2455,2455,2455,159,159,4,6
20151009,2455,2455,2340,2518,2340,2518,2447,63,-8,6,6
20151012,2518,2447,2388,2388,2388,2388,2388,-59,-59,2,4
20151013,2388,2388,,,,2388,2388,0,0,0,4
20151014,2388,2388,2280,2280,2280,2280,2280,-108,-108,2,4
20151015,2280,2280,,,,2280,2280,0,0,0,4
20151016,2280,2280,,,,2394,2394,114,114,0,4
20151019,2394,2394,,,,2394,2394,0,0,0,4
20151020,2394,2394,,,,2394,2394,0,0,0,4
20151021,2394,2394,,,,2394,2394,0,0,0,4
20151022,2394,2394,2280,2280,2280,2280,2280,-114,-114,2,4
20151023,2280,2280,,,,2280,2280,0,0,0,4
20151026,2280,2280,2387,2394,2387,2394,2390,114,110,4,2
20151027,2394,2390,,,,2390,2390,0,0,0,2
20151028,2390,2390,2294,2491,2294,2486,2439,96,49,8,4
20151029,2486,2439,2320,2320,2320,2320,2320,-119,-119,2,2
20151030,2320,2320,2215,2215,2215,2215,2215,-105,-105,2,2
20151102,2215,2215,,,,2215,2215,0,0,0,2
20151103,2215,2215,,,,2215,2215,0,0,0,2
20151104,2215,2215,,,,2215,2215,0,0,0,2
20151105,2215,2215,,,,2215,2215,0,0,0,2
20151106,2215,2215,,,,2215,2215,0,0,0,2
20151109,2215,2215,2120,2325,2120,2325,2222,110,7,4,2
20151110,2325,2222,,,,2222,2222,0,0,0,2
20151111,2222,2222,,,,2222,2222,0,0,0,2
20151112,2222,2222,,,,2333,2333,111,111,0,2
20151113,2333,2333,2220,2220,2220,2220,2220,-113,-113,2,2
20151116,2220,2220,,,,2331,2331,111,111,0,2
20151117,2331,2331,,,,2331,2331,0,0,0,2
20151118,2331,2331,,,,2331,2331,0,0,0,2
20151119,2331,2331,,,,2331,2331,0,0,0,2
20151120,2331,2331,2214,2447,2214,2447,2272,116,-59,8,0
20151123,2447,2272,,,,2272,2272,0,0,0,0
20151124,2272,2272,,,,2272,2272,0,0,0,0
20151125,2272,2272,,,,2272,2272,0,0,0,0
20151126,2272,2272,,,,2272,2272,0,0,0,0
20151127,2272,2272,,,,2272,2272,0,0,0,0
20151130,2272,2272,,,,2272,2272,0,0,0,0
fu1601,20150105,3177,3177,,,,3177,3177,0,0,0,0
20150106,3177,3177,,,,3177,3177,0,0,0,0
20150107,3177,3177,,,,3177,3177,0,0,0,0
20150108,3177,3177,3494,3494,2957,2957,3225,-220,48,12,0
20150109,2957,3225,,,,3225,3225,0,0,0,0
20150112,3225,3225,,,,3225,3225,0,0,0,0
20150113,3225,3225,,,,3225,3225,0,0,0,0
20150114,3225,3225,,,,3225,3225,0,0,0,0
20150115,3225,3225,,,,3225,3225,0,0,0,0
20150116,3225,3225,,,,3225,3225,0,0,0,0
20150119,3225,3225,,,,3225,3225,0,0,0,0
20150120,3225,3225,,,,3225,3225,0,0,0,0
20150121,3225,3225,,,,3225,3225,0,0,0,0
20150122,3225,3225,,,,3225,3225,0,0,0,0
20150123,3225,3225,,,,3225,3225,0,0,0,0
20150126,3225,3225,,,,3225,3225,0,0,0,0
20150127,3225,3225,,,,3225,3225,0,0,0,0
20150128,3225,3225,,,,3225,3225,0,0,0,0
20150129,3225,3225,,,,3225,3225,0,0,0,0
20150130,3225,3225,3063,3291,3063,3291,3177,66,-48,4,2
20150202,3291,3177,,,,3177,3177,0,0,0,2
20150203,3177,3177,3018,3325,3018,3325,3171,148,-6,4,4
20150204,3325,3171,3177,3177,3177,3177,3177,6,6,4,0
20150205,3177,3177,,,,3177,3177,0,0,0,0
20150206,3177,3177,,,,3177,3177,0,0,0,0
20150209,3177,3177,,,,3177,3177,0,0,0,0
20150210,3177,3177,,,,3177,3177,0,0,0,0
20150211,3177,3177,,,,3177,3177,0,0,0,0
20150212,3177,3177,,,,3177,3177,0,0,0,0
20150213,3177,3177,,,,3177,3177,0,0,0,0
20150216,3177,3177,,,,3177,3177,0,0,0,0
20150217,3177,3177,,,,3398,3398,221,221,0,0
20150225,3398,3398,3599,3599,3161,3350,3374,-48,-24,10,0
20150226,3350,3374,,,,3205,3205,-169,-169,0,0
20150227,3205,3205,,,,3173,3173,-32,-32,0,0
20150302,3173,3173,,,,3250,3250,77,77,0,0
20150303,3250,3250,,,,3339,3339,89,89,0,0
20150304,3339,3339,,,,3339,3339,0,0,0,0
20150305,3339,3339,,,,3435,3435,96,96,0,0
20150306,3435,3435,,,,3301,3301,-134,-134,0,0
20150309,3301,3301,,,,3137,3137,-164,-164,0,0
20150310,3137,3137,,,,3144,3144,7,7,0,0
20150311,3144,3144,,,,2989,2989,-155,-155,0,0
20150312,2989,2989,,,,2989,2989,0,0,0,0
20150313,2989,2989,,,,2841,2841,-148,-148,0,0
20150316,2841,2841,,,,2700,2700,-141,-141,0,0
20150317,2700,2700,,,,2700,2700,0,0,0,0
20150318,2700,2700,,,,2835,2835,135,135,0,0
20150319,2835,2835,,,,2693,2693,-142,-142,0,0
20150320,2693,2693,,,,2801,2801,108,108,0,0
20150323,2801,2801,,,,2808,2808,7,7,0,0
20150324,2808,2808,2948,2948,2948,2948,2948,140,140,2,2
20150325,2948,2948,,,,2879,2879,-69,-69,0,2
20150326,2879,2879,,,,3022,3022,143,143,0,2
20150327,3022,3022,,,,3173,3173,151,151,0,2
20150330,3173,3173,3331,3331,3331,3331,3331,158,158,2,0
20150331,3331,3331,,,,3331,3331,0,0,0,0
20150401,3331,3331,,,,3331,3331,0,0,0,0
20150402,3331,3331,,,,3331,3331,0,0,0,0
20150403,3331,3331,,,,3331,3331,0,0,0,0
20150407,3331,3331,,,,3331,3331,0,0,0,0
20150408,3331,3331,,,,3164,3164,-167,-167,0,0
20150409,3164,3164,,,,3170,3170,6,6,0,0
20150410,3170,3170,,,,3327,3327,157,157,0,0
20150413,3327,3327,,,,3327,3327,0,0,0,0
20150414,3327,3327,,,,3327,3327,0,0,0,0
20150415,3327,3327,,,,3327,3327,0,0,0,0
20150416,3327,3327,,,,3327,3327,0,0,0,0
20150417,3327,3327,,,,3327,3327,0,0,0,0
20150420,3327,3327,,,,3327,3327,0,0,0,0
20150421,3327,3327,,,,3327,3327,0,0,0,0
20150422,3327,3327,,,,3327,3327,0,0,0,0
20150423,3327,3327,,,,3327,3327,0,0,0,0
20150424,3327,3327,,,,3327,3327,0,0,0,0
20150427,3327,3327,,,,3327,3327,0,0,0,0
20150428,3327,3327,,,,3327,3327,0,0,0,0
20150429,3327,3327,,,,3327,3327,0,0,0,0
20150430,3327,3327,,,,3399,3399,72,72,0,0
20150504,3399,3399,3568,3568,3568,3568,3568,169,169,2,2
20150505,3568,3568,,,,3577,3577,9,9,0,2
20150506,3577,3577,3400,3400,3400,3400,3400,-177,-177,2,4
20150507,3400,3400,,,,3293,3293,-107,-107,0,4
20150508,3293,3293,3293,3293,3293,3293,3293,0,0,2,2
20150511,3293,3293,,,,3384,3384,91,91,0,2
20150512,3384,3384,,,,3214,3214,-170,-170,0,2
20150513,3214,3214,,,,3214,3214,0,0,0,2
20150514,3214,3214,,,,3208,3208,-6,-6,0,2
20150515,3208,3208,,,,3047,3047,-161,-161,0,2
20150518,3047,3047,,,,3017,3017,-30,-30,0,2
20150519,3017,3017,,,,3167,3167,150,150,0,2
20150520,3167,3167,,,,3122,3122,-45,-45,0,2
20150521,3122,3122,,,,3214,3214,92,92,0,2
20150522,3214,3214,,,,3218,3218,4,4,0,2
20150525,3218,3218,,,,3205,3205,-13,-13,0,2
20150526,3205,3205,,,,3044,3044,-161,-161,0,2
20150527,3044,3044,,,,3043,3043,-1,-1,0,2
20150528,3043,3043,,,,3195,3195,152,152,0,2
20150529,3195,3195,,,,3175,3175,-20,-20,0,2
20150601,3175,3175,,,,3238,3238,63,63,0,2
20150602,3238,3238,,,,3082,3082,-156,-156,0,2
20150603,3082,3082,,,,3236,3236,154,154,0,2
20150604,3236,3236,,,,3151,3151,-85,-85,0,2
20150605,3151,3151,,,,3165,3165,14,14,0,2
20150608,3165,3165,,,,3116,3116,-49,-49,0,2
20150609,3116,3116,,,,3084,3084,-32,-32,0,2
20150610,3084,3084,,,,2931,2931,-153,-153,0,2
20150611,2931,2931,,,,3077,3077,146,146,0,2
20150612,3077,3077,,,,3077,3077,0,0,0,2
20150615,3077,3077,,,,3079,3079,2,2,0,2
20150616,3079,3079,,,,2930,2930,-149,-149,0,2
20150617,2930,2930,,,,3076,3076,146,146,0,2
20150618,3076,3076,,,,3024,3024,-52,-52,0,2
20150619,3024,3024,,,,2885,2885,-139,-139,0,2
20150623,2885,2885,,,,2805,2805,-80,-80,0,2
20150624,2805,2805,,,,2945,2945,140,140,0,2
20150625,2945,2945,,,,2860,2860,-85,-85,0,2
20150626,2860,2860,,,,2757,2757,-103,-103,0,2
20150629,2757,2757,,,,2757,2757,0,0,0,2
20150630,2757,2757,,,,2730,2730,-27,-27,0,2
20150701,2730,2730,,,,2814,2814,84,84,0,2
20150702,2814,2814,2900,2900,2900,2900,2900,86,86,2,0
20150703,2900,2900,,,,2837,2837,-63,-63,0,0
20150706,2837,2837,,,,2723,2723,-114,-114,0,0
20150707,2723,2723,2586,2586,2586,2586,2586,-137,-137,2,2
20150708,2586,2586,,,,2479,2479,-107,-107,0,2
20150709,2479,2479,,,,2454,2454,-25,-25,0,2
20150710,2454,2454,2574,2574,2574,2574,2574,120,120,2,4
20150713,2574,2574,,,,2538,2538,-36,-36,0,4
20150714,2538,2538,,,,2501,2501,-37,-37,0,4
20150715,2501,2501,,,,2375,2375,-126,-126,0,4
20150716,2375,2375,,,,2411,2411,36,36,0,4
20150717,2411,2411,,,,2437,2437,26,26,0,4
20150720,2437,2437,2345,2345,2345,2345,2345,-92,-92,2,6
20150721,2345,2345,,,,2375,2375,30,30,0,6
20150722,2375,2375,,,,2334,2334,-41,-41,0,6
20150723,2334,2334,,,,2450,2450,116,116,0,6
20150724,2450,2450,2572,2572,2572,2572,2572,122,122,4,2
20150727,2572,2572,2450,2700,2450,2607,2601,35,29,12,2
20150728,2607,2601,,,,2558,2558,-43,-43,0,2
20150729,2558,2558,,,,2573,2573,15,15,0,2
20150730,2573,2573,,,,2553,2553,-20,-20,0,2
20150731,2553,2553,,,,2503,2503,-50,-50,0,2
20150803,2503,2503,,,,2427,2427,-76,-76,0,2
20150804,2427,2427,,,,2389,2389,-38,-38,0,2
20150805,2389,2389,,,,2387,2387,-2,-2,0,2
20150806,2387,2387,,,,2365,2365,-22,-22,0,2
20150807,2365,2365,,,,2417,2417,52,52,0,2
20150810,2417,2417,,,,2432,2432,15,15,0,2
20150811,2432,2432,,,,2487,2487,55,55,0,2
20150812,2487,2487,,,,2522,2522,35,35,0,2
20150813,2522,2522,,,,2532,2532,10,10,0,2
20150814,2532,2532,,,,2446,2446,-86,-86,0,2
20150817,2446,2446,,,,2353,2353,-93,-93,0,2
20150818,2353,2353,,,,2309,2309,-44,-44,0,2
20150819,2309,2309,,,,2256,2256,-53,-53,0,2
20150820,2256,2256,,,,2231,2231,-25,-25,0,2
20150821,2231,2231,,,,2194,2194,-37,-37,0,2
20150824,2194,2194,,,,2098,2098,-96,-96,0,2
20150825,2098,2098,,,,2060,2060,-38,-38,0,2
20150826,2060,2060,,,,1985,1985,-75,-75,0,2
20150827,1985,1985,,,,1985,1985,0,0,0,2
20150828,1985,1985,,,,1989,1989,4,4,0,2
20150831,1989,1989,,,,2048,2048,59,59,0,2
20150901,2048,2048,,,,2127,2127,79,79,0,2
20150902,2127,2127,,,,2108,2108,-19,-19,0,2
20150907,2108,2108,1984,1984,1983,1983,1983,-125,-125,12,14
20150908,1983,1983,2081,2081,2020,2072,2053,89,70,22,12
20150909,2072,2053,2112,2112,2112,2112,2112,59,59,2,14
20150910,2112,2112,2160,2217,2160,2217,2204,105,92,20,12
20150911,2217,2204,2230,2240,2230,2230,2232,26,28,12,6
20150914,2230,2232,2230,2230,2229,2229,2229,-3,-3,4,4
20150915,2229,2229,,,,2229,2229,0,0,0,4
20150916,2229,2229,,,,2229,2229,0,0,0,4
20150917,2229,2229,2202,2225,2202,2225,2213,-4,-16,4,4
20150918,2225,2213,2231,2231,2231,2231,2231,18,18,2,2
20150921,2231,2231,,,,2231,2231,0,0,0,2
20150922,2231,2231,2285,2285,2186,2241,2235,10,4,8,4
20150923,2241,2235,,,,2235,2235,0,0,0,4
20150924,2235,2235,2235,2235,2231,2233,2233,-2,-2,6,2
20150925,2233,2233,2299,2322,2142,2280,2250,47,17,48,12
20150928,2280,2250,2280,2280,2280,2280,2280,30,30,4,12
20150929,2280,2280,,,,2280,2280,0,0,0,12
20150930,2280,2280,,,,2280,2280,0,0,0,12
20151008,2280,2280,2361,2431,2361,2385,2390,105,110,22,8
20151009,2385,2390,2370,2370,2370,2370,2370,-20,-20,2,6
20151012,2370,2370,,,,2379,2379,9,9,0,6
20151013,2379,2379,,,,2379,2379,0,0,0,6
20151014,2379,2379,,,,2379,2379,0,0,0,6
20151015,2379,2379,2449,2449,2420,2420,2437,41,58,14,6
20151016,2420,2437,,,,2437,2437,0,0,0,6
20151019,2437,2437,2440,2441,2404,2404,2428,-33,-9,8,4
20151020,2404,2428,,,,2428,2428,0,0,0,4
20151021,2428,2428,2441,2441,2441,2441,2441,13,13,2,4
20151022,2441,2441,,,,2438,2438,-3,-3,0,4
20151023,2438,2438,,,,2438,2438,0,0,0,4
20151026,2438,2438,,,,2438,2438,0,0,0,4
20151027,2438,2438,,,,2438,2438,0,0,0,4
20151028,2438,2438,,,,2438,2438,0,0,0,4
20151029,2438,2438,,,,2438,2438,0,0,0,4
20151030,2438,2438,,,,2438,2438,0,0,0,4
20151102,2438,2438,,,,2438,2438,0,0,0,4
20151103,2438,2438,,,,2438,2438,0,0,0,4
20151104,2438,2438,,,,2438,2438,0,0,0,4
20151105,2438,2438,,,,2438,2438,0,0,0,4
20151106,2438,2438,,,,2438,2438,0,0,0,4
20151109,2438,2438,,,,2438,2438,0,0,0,4
20151110,2438,2438,,,,2438,2438,0,0,0,4
20151111,2438,2438,,,,2438,2438,0,0,0,4
20151112,2438,2438,,,,2438,2438,0,0,0,4
20151113,2438,2438,,,,2438,2438,0,0,0,4
20151116,2438,2438,2359,2359,2359,2359,2359,-79,-79,6,2
20151117,2359,2359,,,,2359,2359,0,0,0,2
20151118,2359,2359,2422,2422,2422,2422,2422,63,63,2,0
20151119,2422,2422,,,,2422,2422,0,0,0,0
20151120,2422,2422,2300,2382,2300,2382,2341,-40,-81,4,0
20151123,2382,2341,,,,2341,2341,0,0,0,0
20151124,2341,2341,,,,2341,2341,0,0,0,0
20151125,2341,2341,,,,2341,2341,0,0,0,0
20151126,2341,2341,,,,2341,2341,0,0,0,0
20151127,2341,2341,,,,2341,2341,0,0,0,0
20151130,2341,2341,,,,2341,2341,0,0,0,0
fu1603,20150302,3173,3173,,,,3250,3250,77,77,0,0
20150303,3250,3250,,,,3339,3339,89,89,0,0
20150304,3339,3339,,,,3339,3339,0,0,0,0
20150305,3339,3339,3672,3672,3672,3672,3672,333,333,2,2
20150306,3672,3672,,,,3529,3529,-143,-143,0,2
20150309,3529,3529,,,,3354,3354,-175,-175,0,2
20150310,3354,3354,,,,3361,3361,7,7,0,2
20150311,3361,3361,,,,3195,3195,-166,-166,0,2
20150312,3195,3195,,,,3195,3195,0,0,0,2
20150313,3195,3195,,,,3037,3037,-158,-158,0,2
20150316,3037,3037,2885,2902,2885,2902,2893,-135,-144,4,0
20150317,2902,2893,,,,2893,2893,0,0,0,0
20150318,2893,2893,,,,3037,3037,144,144,0,0
20150319,3037,3037,,,,2885,2885,-152,-152,0,0
20150320,2885,2885,,,,3001,3001,116,116,0,0
20150323,3001,3001,,,,3151,3151,150,150,0,0
20150324,3151,3151,,,,3308,3308,157,157,0,0
20150325,3308,3308,,,,3230,3230,-78,-78,0,0
20150326,3230,3230,,,,3207,3207,-23,-23,0,0
20150327,3207,3207,,,,3050,3050,-157,-157,0,0
20150330,3050,3050,,,,3201,3201,151,151,0,0
20150331,3201,3201,,,,3139,3139,-62,-62,0,0
20150401,3139,3139,,,,2982,2982,-157,-157,0,0
20150402,2982,2982,,,,3131,3131,149,149,0,0
20150403,3131,3131,,,,3082,3082,-49,-49,0,0
20150407,3082,3082,,,,3236,3236,154,154,0,0
20150408,3236,3236,,,,3074,3074,-162,-162,0,0
20150409,3074,3074,,,,3227,3227,153,153,0,0
20150410,3227,3227,,,,3387,3387,160,160,0,0
20150413,3387,3387,,,,3341,3341,-46,-46,0,0
20150414,3341,3341,,,,3341,3341,0,0,0,0
20150415,3341,3341,,,,3336,3336,-5,-5,0,0
20150416,3336,3336,,,,3336,3336,0,0,0,0
20150417,3336,3336,,,,3336,3336,0,0,0,0
20150420,3336,3336,,,,3336,3336,0,0,0,0
20150421,3336,3336,,,,3202,3202,-134,-134,0,0
20150422,3202,3202,,,,3063,3063,-139,-139,0,0
20150423,3063,3063,,,,3216,3216,153,153,0,0
20150424,3216,3216,,,,3216,3216,0,0,0,0
20150427,3216,3216,,,,3297,3297,81,81,0,0
20150428,3297,3297,,,,3304,3304,7,7,0,0
20150429,3304,3304,,,,3138,3138,-166,-166,0,0
20150430,3138,3138,,,,3294,3294,156,156,0,0
20150504,3294,3294,,,,3457,3457,163,163,0,0
20150505,3457,3457,,,,3466,3466,9,9,0,0
20150506,3466,3466,,,,3294,3294,-172,-172,0,0
20150507,3294,3294,,,,3190,3190,-104,-104,0,0
20150508,3190,3190,,,,3190,3190,0,0,0,0
20150511,3190,3190,,,,3278,3278,88,88,0,0
20150512,3278,3278,,,,3114,3114,-164,-164,0,0
20150513,3114,3114,,,,3269,3269,155,155,0,0
20150514,3269,3269,,,,3263,3263,-6,-6,0,0
20150515,3263,3263,,,,3100,3100,-163,-163,0,0
20150518,3100,3100,,,,3255,3255,155,155,0,0
20150519,3255,3255,,,,3339,3339,84,84,0,0
20150520,3339,3339,,,,3291,3291,-48,-48,0,0
20150521,3291,3291,,,,3389,3389,98,98,0,0
20150522,3389,3389,,,,3389,3389,0,0,0,0
20150525,3389,3389,,,,3376,3376,-13,-13,0,0
20150526,3376,3376,,,,3207,3207,-169,-169,0,0
20150527,3207,3207,,,,3206,3206,-1,-1,0,0
20150528,3206,3206,,,,3056,3056,-150,-150,0,0
20150529,3056,3056,,,,3037,3037,-19,-19,0,0
20150601,3037,3037,,,,3188,3188,151,151,0,0
20150602,3188,3188,,,,3034,3034,-154,-154,0,0
20150603,3034,3034,,,,3185,3185,151,151,0,0
20150604,3185,3185,,,,3101,3101,-84,-84,0,0
20150605,3101,3101,,,,3115,3115,14,14,0,0
20150608,3115,3115,,,,3067,3067,-48,-48,0,0
20150609,3067,3067,,,,3035,3035,-32,-32,0,0
20150610,3035,3035,,,,2884,2884,-151,-151,0,0
20150611,2884,2884,,,,3028,3028,144,144,0,0
20150612,3028,3028,,,,3028,3028,0,0,0,0
20150615,3028,3028,,,,3179,3179,151,151,0,0
20150616,3179,3179,,,,3025,3025,-154,-154,0,0
20150617,3025,3025,,,,3176,3176,151,151,0,0
20150618,3176,3176,,,,3123,3123,-53,-53,0,0
20150619,3123,3123,,,,2979,2979,-144,-144,0,0
20150623,2979,2979,,,,2897,2897,-82,-82,0,0
20150624,2897,2897,,,,2910,2910,13,13,0,0
20150625,2910,2910,,,,2826,2826,-84,-84,0,0
20150626,2826,2826,,,,2724,2724,-102,-102,0,0
20150629,2724,2724,,,,2724,2724,0,0,0,0
20150630,2724,2724,,,,2698,2698,-26,-26,0,0
20150701,2698,2698,,,,2781,2781,83,83,0,0
20150702,2781,2781,2641,2919,2641,2919,2780,138,-1,4,0
20150703,2919,2780,,,,2720,2720,-60,-60,0,0
20150706,2720,2720,,,,2611,2611,-109,-109,0,0
20150707,2611,2611,,,,2480,2480,-131,-131,0,0
20150708,2480,2480,,,,2378,2378,-102,-102,0,0
20150709,2378,2378,,,,2354,2354,-24,-24,0,0
20150710,2354,2354,,,,2469,2469,115,115,0,0
20150713,2469,2469,,,,2435,2435,-34,-34,0,0
20150714,2435,2435,,,,2399,2399,-36,-36,0,0
20150715,2399,2399,,,,2279,2279,-120,-120,0,0
20150716,2279,2279,,,,2392,2392,113,113,0,0
20150717,2392,2392,,,,2418,2418,26,26,0,0
20150720,2418,2418,,,,2326,2326,-92,-92,0,0
20150721,2326,2326,,,,2355,2355,29,29,0,0
20150722,2355,2355,,,,2314,2314,-41,-41,0,0
20150723,2314,2314,,,,2274,2274,-40,-40,0,0
20150724,2274,2274,,,,2387,2387,113,113,0,0
20150727,2387,2387,,,,2414,2414,27,27,0,0
20150728,2414,2414,,,,2374,2374,-40,-40,0,0
20150729,2374,2374,,,,2388,2388,14,14,0,0
20150730,2388,2388,,,,2369,2369,-19,-19,0,0
20150731,2369,2369,,,,2322,2322,-47,-47,0,0
20150803,2322,2322,,,,2251,2251,-71,-71,0,0
20150804,2251,2251,,,,2216,2216,-35,-35,0,0
20150805,2216,2216,,,,2214,2214,-2,-2,0,0
20150806,2214,2214,,,,2193,2193,-21,-21,0,0
20150807,2193,2193,,,,2242,2242,49,49,0,0
20150810,2242,2242,,,,2256,2256,14,14,0,0
20150811,2256,2256,,,,2307,2307,51,51,0,0
20150812,2307,2307,,,,2340,2340,33,33,0,0
20150813,2340,2340,,,,2349,2349,9,9,0,0
20150814,2349,2349,,,,2269,2269,-80,-80,0,0
20150817,2269,2269,,,,2183,2183,-86,-86,0,0
20150818,2183,2183,,,,2142,2142,-41,-41,0,0
20150819,2142,2142,,,,2092,2092,-50,-50,0,0
20150820,2092,2092,,,,2069,2069,-23,-23,0,0
20150821,2069,2069,,,,2035,2035,-34,-34,0,0
20150824,2035,2035,,,,1946,1946,-89,-89,0,0
20150825,1946,1946,,,,1911,1911,-35,-35,0,0
20150826,1911,1911,,,,1841,1841,-70,-70,0,0
20150827,1841,1841,,,,1841,1841,0,0,0,0
20150828,1841,1841,,,,1845,1845,4,4,0,0
20150831,1845,1845,,,,1900,1900,55,55,0,0
20150901,1900,1900,,,,1974,1974,74,74,0,0
20150902,1974,1974,,,,1957,1957,-17,-17,0,0
20150907,1957,1957,,,,1841,1841,-116,-116,0,0
20150908,1841,1841,,,,1906,1906,65,65,0,0
20150909,1906,1906,,,,2001,2001,95,95,0,0
20150910,2001,2001,,,,2088,2088,87,87,0,0
20150911,2088,2088,,,,2114,2114,26,26,0,0
20150914,2114,2114,,,,2111,2111,-3,-3,0,0
20150915,2111,2111,,,,2171,2171,60,60,0,0
20150916,2171,2171,,,,2097,2097,-74,-74,0,0
20150917,2097,2097,,,,2082,2082,-15,-15,0,0
20150918,2082,2082,,,,2186,2186,104,104,0,0
20150921,2186,2186,,,,2191,2191,5,5,0,0
20150922,2191,2191,,,,2195,2195,4,4,0,0
20150923,2195,2195,,,,2224,2224,29,29,0,0
20150924,2224,2224,,,,2222,2222,-2,-2,0,0
20150925,2222,2222,,,,2239,2239,17,17,0,0
20150928,2239,2239,,,,2268,2268,29,29,0,0
20150929,2268,2268,,,,2289,2289,21,21,0,0
20150930,2289,2289,,,,2180,2180,-109,-109,0,0
20151008,2180,2180,,,,2285,2285,105,105,0,0
20151009,2285,2285,,,,2265,2265,-20,-20,0,0
20151012,2265,2265,,,,2210,2210,-55,-55,0,0
20151013,2210,2210,,,,2210,2210,0,0,0,0
20151014,2210,2210,,,,2110,2110,-100,-100,0,0
20151015,2110,2110,,,,2161,2161,51,51,0,0
20151016,2161,2161,,,,2161,2161,0,0,0,0
20151019,2161,2161,,,,2269,2269,108,108,0,0
20151020,2269,2269,,,,2269,2269,0,0,0,0
20151021,2269,2269,,,,2281,2281,12,12,0,0
20151022,2281,2281,,,,2172,2172,-109,-109,0,0
20151023,2172,2172,,,,2172,2172,0,0,0,0
20151026,2172,2172,,,,2277,2277,105,105,0,0
20151027,2277,2277,,,,2277,2277,0,0,0,0
20151028,2277,2277,,,,2323,2323,46,46,0,0
20151029,2323,2323,,,,2209,2209,-114,-114,0,0
20151030,2209,2209,,,,2319,2319,110,110,0,0
20151102,2319,2319,2203,2434,2203,2434,2318,115,-1,4,0
20151103,2434,2318,,,,2318,2318,0,0,0,0
20151104,2318,2318,,,,2318,2318,0,0,0,0
20151105,2318,2318,,,,2318,2318,0,0,0,0
20151106,2318,2318,,,,2318,2318,0,0,0,0
20151109,2318,2318,,,,2325,2325,7,7,0,0
20151110,2325,2325,,,,2325,2325,0,0,0,0
20151111,2325,2325,,,,2325,2325,0,0,0,0
20151112,2325,2325,,,,2325,2325,0,0,0,0
20151113,2325,2325,,,,2212,2212,-113,-113,0,0
20151116,2212,2212,,,,2140,2140,-72,-72,0,0
20151117,2140,2140,,,,2247,2247,107,107,0,0
20151118,2247,2247,,,,2307,2307,60,60,0,0
20151119,2307,2307,,,,2307,2307,0,0,0,0
20151120,2307,2307,,,,2229,2229,-78,-78,0,0
20151123,2229,2229,,,,2229,2229,0,0,0,0
20151124,2229,2229,,,,2229,2229,0,0,0,0
20151125,2229,2229,,,,2229,2229,0,0,0,0
20151126,2229,2229,,,,2229,2229,0,0,0,0
20151127,2229,2229,,,,2229,2229,0,0,0,0
20151130,2229,2229,,,,2229,2229,0,0,0,0
fu1604,20150401,3139,3139,,,,3139,3139,0,0,0,0
20150402,3139,3139,,,,3139,3139,0,0,0,0
20150403,3139,3139,,,,3139,3139,0,0,0,0
20150407,3139,3139,3452,3452,3452,3452,3452,313,313,2,2
20150408,3452,3452,,,,3279,3279,-173,-173,0,2
20150409,3279,3279,,,,3286,3286,7,7,0,2
20150410,3286,3286,,,,3286,3286,0,0,0,2
20150413,3286,3286,,,,3241,3241,-45,-45,0,2
20150414,3241,3241,,,,3080,3080,-161,-161,0,2
20150415,3080,3080,,,,3234,3234,154,154,0,2
20150416,3234,3234,,,,3269,3269,35,35,0,2
20150417,3269,3269,,,,3247,3247,-22,-22,0,2
20150420,3247,3247,,,,3235,3235,-12,-12,0,2
20150421,3235,3235,,,,3105,3105,-130,-130,0,2
20150422,3105,3105,,,,2970,2970,-135,-135,0,2
20150423,2970,2970,,,,3118,3118,148,148,0,2
20150424,3118,3118,,,,3118,3118,0,0,0,2
20150427,3118,3118,,,,3197,3197,79,79,0,2
20150428,3197,3197,,,,3203,3203,6,6,0,2
20150429,3203,3203,,,,3042,3042,-161,-161,0,2
20150430,3042,3042,,,,3194,3194,152,152,0,2
20150504,3194,3194,,,,3352,3352,158,158,0,2
20150505,3352,3352,,,,3361,3361,9,9,0,2
20150506,3361,3361,,,,3194,3194,-167,-167,0,2
20150507,3194,3194,,,,3353,3353,159,159,0,2
20150508,3353,3353,,,,3353,3353,0,0,0,2
20150511,3353,3353,,,,3445,3445,92,92,0,2
20150512,3445,3445,,,,3272,3272,-173,-173,0,2
20150513,3272,3272,,,,3272,3272,0,0,0,2
20150514,3272,3272,3372,3372,3372,3372,3372,100,100,2,2
20150515,3372,3372,,,,3203,3203,-169,-169,0,2
20150518,3203,3203,,,,3171,3171,-32,-32,0,2
20150519,3171,3171,,,,3253,3253,82,82,0,2
20150520,3253,3253,,,,3207,3207,-46,-46,0,2
20150521,3207,3207,,,,3302,3302,95,95,0,2
20150522,3302,3302,,,,3307,3307,5,5,0,2
20150525,3307,3307,,,,3294,3294,-13,-13,0,2
20150526,3294,3294,,,,3129,3129,-165,-165,0,2
20150527,3129,3129,,,,3128,3128,-1,-1,0,2
20150528,3128,3128,,,,2982,2982,-146,-146,0,2
20150529,2982,2982,,,,3131,3131,149,149,0,2
20150601,3131,3131,,,,3193,3193,62,62,0,2
20150602,3193,3193,,,,3039,3039,-154,-154,0,2
20150603,3039,3039,,,,3190,3190,151,151,0,2
20150604,3190,3190,,,,3106,3106,-84,-84,0,2
20150605,3106,3106,,,,3120,3120,14,14,0,2
20150608,3120,3120,,,,3072,3072,-48,-48,0,2
20150609,3072,3072,,,,3040,3040,-32,-32,0,2
20150610,3040,3040,,,,2889,2889,-151,-151,0,2
20150611,2889,2889,,,,3033,3033,144,144,0,2
20150612,3033,3033,,,,3033,3033,0,0,0,2
20150615,3033,3033,,,,3035,3035,2,2,0,2
20150616,3035,3035,,,,2888,2888,-147,-147,0,2
20150617,2888,2888,,,,3032,3032,144,144,0,2
20150618,3032,3032,,,,2981,2981,-51,-51,0,2
20150619,2981,2981,,,,2844,2844,-137,-137,0,2
20150623,2844,2844,,,,2986,2986,142,142,0,2
20150624,2986,2986,,,,3000,3000,14,14,0,2
20150625,3000,3000,,,,2913,2913,-87,-87,0,2
20150626,2913,2913,,,,2808,2808,-105,-105,0,2
20150629,2808,2808,,,,2808,2808,0,0,0,2
20150630,2808,2808,,,,2781,2781,-27,-27,0,2
20150701,2781,2781,,,,2866,2866,85,85,0,2
20150702,2866,2866,,,,2864,2864,-2,-2,0,2
20150703,2864,2864,,,,2802,2802,-62,-62,0,2
20150706,2802,2802,,,,2690,2690,-112,-112,0,2
20150707,2690,2690,,,,2555,2555,-135,-135,0,2
20150708,2555,2555,,,,2449,2449,-106,-106,0,2
20150709,2449,2449,,,,2425,2425,-24,-24,0,2
20150710,2425,2425,,,,2543,2543,118,118,0,2
20150713,2543,2543,,,,2508,2508,-35,-35,0,2
20150714,2508,2508,,,,2471,2471,-37,-37,0,2
20150715,2471,2471,,,,2347,2347,-124,-124,0,2
20150716,2347,2347,,,,2383,2383,36,36,0,2
20150717,2383,2383,,,,2409,2409,26,26,0,2
20150720,2409,2409,,,,2318,2318,-91,-91,0,2
20150721,2318,2318,,,,2347,2347,29,29,0,2
20150722,2347,2347,,,,2306,2306,-41,-41,0,2
20150723,2306,2306,,,,2266,2266,-40,-40,0,2
20150724,2266,2266,,,,2378,2378,112,112,0,2
20150727,2378,2378,,,,2404,2404,26,26,0,2
20150728,2404,2404,,,,2364,2364,-40,-40,0,2
20150729,2364,2364,,,,2378,2378,14,14,0,2
20150730,2378,2378,,,,2359,2359,-19,-19,0,2
20150731,2359,2359,,,,2313,2313,-46,-46,0,2
20150803,2313,2313,,,,2243,2243,-70,-70,0,2
20150804,2243,2243,,,,2208,2208,-35,-35,0,2
20150805,2208,2208,,,,2206,2206,-2,-2,0,2
20150806,2206,2206,,,,2185,2185,-21,-21,0,2
20150807,2185,2185,,,,2233,2233,48,48,0,2
20150810,2233,2233,,,,2247,2247,14,14,0,2
20150811,2247,2247,,,,2298,2298,51,51,0,2
20150812,2298,2298,,,,2330,2330,32,32,0,2
20150813,2330,2330,,,,2339,2339,9,9,0,2
20150814,2339,2339,,,,2260,2260,-79,-79,0,2
20150817,2260,2260,,,,2174,2174,-86,-86,0,2
20150818,2174,2174,,,,2133,2133,-41,-41,0,2
20150819,2133,2133,,,,2084,2084,-49,-49,0,2
20150820,2084,2084,,,,2061,2061,-23,-23,0,2
20150821,2061,2061,,,,2027,2027,-34,-34,0,2
20150824,2027,2027,,,,1938,1938,-89,-89,0,2
20150825,1938,1938,,,,1903,1903,-35,-35,0,2
20150826,1903,1903,,,,1833,1833,-70,-70,0,2
20150827,1833,1833,,,,1833,1833,0,0,0,2
20150828,1833,1833,,,,1837,1837,4,4,0,2
20150831,1837,1837,,,,1892,1892,55,55,0,2
20150901,1892,1892,,,,1965,1965,73,73,0,2
20150902,1965,1965,,,,1948,1948,-17,-17,0,2
20150907,1948,1948,,,,1832,1832,-116,-116,0,2
20150908,1832,1832,,,,1896,1896,64,64,0,2
20150909,1896,1896,,,,1990,1990,94,94,0,2
20150910,1990,1990,,,,2076,2076,86,86,0,2
20150911,2076,2076,,,,2179,2179,103,103,0,2
20150914,2179,2179,,,,2176,2176,-3,-3,0,2
20150915,2176,2176,,,,2238,2238,62,62,0,2
20150916,2238,2238,,,,2162,2162,-76,-76,0,2
20150917,2162,2162,,,,2146,2146,-16,-16,0,2
20150918,2146,2146,,,,2163,2163,17,17,0,2
20150921,2163,2163,,,,2168,2168,5,5,0,2
20150922,2168,2168,,,,2172,2172,4,4,0,2
20150923,2172,2172,,,,2201,2201,29,29,0,2
20150924,2201,2201,,,,2199,2199,-2,-2,0,2
20150925,2199,2199,,,,2216,2216,17,17,0,2
20150928,2216,2216,,,,2245,2245,29,29,0,2
20150929,2245,2245,,,,2266,2266,21,21,0,2
20150930,2266,2266,,,,2158,2158,-108,-108,0,2
20151008,2158,2158,,,,2262,2262,104,104,0,2
20151009,2262,2262,,,,2243,2243,-19,-19,0,2
20151012,2243,2243,,,,2188,2188,-55,-55,0,2
20151013,2188,2188,,,,2297,2297,109,109,0,2
20151014,2297,2297,,,,2193,2193,-104,-104,0,2
20151015,2193,2193,,,,2246,2246,53,53,0,2
20151016,2246,2246,,,,2246,2246,0,0,0,2
20151019,2246,2246,,,,2237,2237,-9,-9,0,2
20151020,2237,2237,,,,2237,2237,0,0,0,2
20151021,2237,2237,,,,2248,2248,11,11,0,2
20151022,2248,2248,,,,2140,2140,-108,-108,0,2
20151023,2140,2140,,,,2140,2140,0,0,0,2
20151026,2140,2140,,,,2243,2243,103,103,0,2
20151027,2243,2243,,,,2243,2243,0,0,0,2
20151028,2243,2243,,,,2355,2355,112,112,0,2
20151029,2355,2355,,,,2240,2240,-115,-115,0,2
20151030,2240,2240,,,,2352,2352,112,112,0,2
20151102,2352,2352,,,,2351,2351,-1,-1,0,2
20151103,2351,2351,,,,2351,2351,0,0,0,2
20151104,2351,2351,,,,2351,2351,0,0,0,2
20151105,2351,2351,,,,2351,2351,0,0,0,2
20151106,2351,2351,,,,2351,2351,0,0,0,2
20151109,2351,2351,,,,2358,2358,7,7,0,2
20151110,2358,2358,,,,2358,2358,0,0,0,2
20151111,2358,2358,,,,2358,2358,0,0,0,2
20151112,2358,2358,,,,2358,2358,0,0,0,2
20151113,2358,2358,,,,2243,2243,-115,-115,0,2
20151116,2243,2243,,,,2355,2355,112,112,0,2
20151117,2355,2355,,,,2355,2355,0,0,0,2
20151118,2355,2355,,,,2417,2417,62,62,0,2
20151119,2417,2417,,,,2417,2417,0,0,0,2
20151120,2417,2417,,,,2417,2417,0,0,0,2
20151123,2417,2417,2300,2536,2300,2536,2496,119,79,12,12
20151124,2536,2496,2410,2410,2410,2410,2410,-86,-86,2,12
20151125,2410,2410,2293,2514,2292,2422,2404,12,-6,40,4
20151126,2422,2404,2288,2435,2288,2435,2391,31,-13,8,6
20151127,2435,2391,2430,2506,2430,2442,2449,51,58,10,6
20151130,2442,2449,2356,2429,2356,2429,2392,-20,-57,4,6
fu1605,20150504,3194,3194,,,,3352,3352,158,158,0,0
20150505,3352,3352,,,,3361,3361,9,9,0,0
20150506,3361,3361,,,,3194,3194,-167,-167,0,0
20150507,3194,3194,,,,3094,3094,-100,-100,0,0
20150508,3094,3094,,,,3094,3094,0,0,0,0
20150511,3094,3094,,,,3179,3179,85,85,0,0
20150512,3179,3179,,,,3020,3020,-159,-159,0,0
20150513,3020,3020,,,,3322,3322,302,302,0,0
20150514,3322,3322,,,,3322,3322,0,0,0,0
20150515,3322,3322,,,,3322,3322,0,0,0,0
20150518,3322,3322,,,,3322,3322,0,0,0,0
20150519,3322,3322,,,,3408,3408,86,86,0,0
20150520,3408,3408,,,,3408,3408,0,0,0,0
20150521,3408,3408,,,,3408,3408,0,0,0,0
20150522,3408,3408,,,,3408,3408,0,0,0,0
20150525,3408,3408,,,,3395,3395,-13,-13,0,0
20150526,3395,3395,,,,3395,3395,0,0,0,0
20150527,3395,3395,,,,3395,3395,0,0,0,0
20150528,3395,3395,,,,3395,3395,0,0,0,0
20150529,3395,3395,,,,3395,3395,0,0,0,0
20150601,3395,3395,,,,3395,3395,0,0,0,0
20150602,3395,3395,,,,3395,3395,0,0,0,0
20150603,3395,3395,,,,3395,3395,0,0,0,0
20150604,3395,3395,,,,3395,3395,0,0,0,0
20150605,3395,3395,,,,3395,3395,0,0,0,0
20150608,3395,3395,,,,3395,3395,0,0,0,0
20150609,3395,3395,,,,3395,3395,0,0,0,0
20150610,3395,3395,,,,3395,3395,0,0,0,0
20150611,3395,3395,,,,3395,3395,0,0,0,0
20150612,3395,3395,,,,3395,3395,0,0,0,0
20150615,3395,3395,,,,3395,3395,0,0,0,0
20150616,3395,3395,,,,3395,3395,0,0,0,0
20150617,3395,3395,,,,3395,3395,0,0,0,0
20150618,3395,3395,,,,3338,3338,-57,-57,0,0
20150619,3338,3338,,,,3338,3338,0,0,0,0
20150623,3338,3338,,,,3338,3338,0,0,0,0
20150624,3338,3338,,,,3338,3338,0,0,0,0
20150625,3338,3338,,,,3338,3338,0,0,0,0
20150626,3338,3338,,,,3218,3218,-120,-120,0,0
20150629,3218,3218,,,,3218,3218,0,0,0,0
20150630,3218,3218,,,,3187,3187,-31,-31,0,0
20150701,3187,3187,,,,3187,3187,0,0,0,0
20150702,3187,3187,,,,3187,3187,0,0,0,0
20150703,3187,3187,,,,3187,3187,0,0,0,0
20150706,3187,3187,,,,3187,3187,0,0,0,0
20150707,3187,3187,,,,3026,3026,-161,-161,0,0
20150708,3026,3026,,,,3026,3026,0,0,0,0
20150709,3026,3026,,,,2996,2996,-30,-30,0,0
20150710,2996,2996,,,,3142,3142,146,146,0,0
20150713,3142,3142,,,,3098,3098,-44,-44,0,0
20150714,3098,3098,,,,3053,3053,-45,-45,0,0
20150715,3053,3053,,,,2900,2900,-153,-153,0,0
20150716,2900,2900,,,,2900,2900,0,0,0,0
20150717,2900,2900,,,,2900,2900,0,0,0,0
20150720,2900,2900,,,,2900,2900,0,0,0,0
20150721,2900,2900,,,,2900,2900,0,0,0,0
20150722,2900,2900,,,,2900,2900,0,0,0,0
20150723,2900,2900,,,,2900,2900,0,0,0,0
20150724,2900,2900,,,,2900,2900,0,0,0,0
20150727,2900,2900,,,,2900,2900,0,0,0,0
20150728,2900,2900,,,,2900,2900,0,0,0,0
20150729,2900,2900,,,,2918,2918,18,18,0,0
20150730,2918,2918,,,,2895,2895,-23,-23,0,0
20150731,2895,2895,,,,2838,2838,-57,-57,0,0
20150803,2838,2838,,,,2752,2752,-86,-86,0,0
20150804,2752,2752,,,,2709,2709,-43,-43,0,0
20150805,2709,2709,,,,2707,2707,-2,-2,0,0
20150806,2707,2707,,,,2682,2682,-25,-25,0,0
20150807,2682,2682,,,,2682,2682,0,0,0,0
20150810,2682,2682,,,,2699,2699,17,17,0,0
20150811,2699,2699,,,,2699,2699,0,0,0,0
20150812,2699,2699,,,,2699,2699,0,0,0,0
20150813,2699,2699,,,,2699,2699,0,0,0,0
20150814,2699,2699,,,,2699,2699,0,0,0,0
20150817,2699,2699,,,,2699,2699,0,0,0,0
20150818,2699,2699,,,,2699,2699,0,0,0,0
20150819,2699,2699,,,,2637,2637,-62,-62,0,0
20150820,2637,2637,,,,2608,2608,-29,-29,0,0
20150821,2608,2608,,,,2565,2565,-43,-43,0,0
20150824,2565,2565,,,,2565,2565,0,0,0,0
20150825,2565,2565,,,,2519,2519,-46,-46,0,0
20150826,2519,2519,,,,2427,2427,-92,-92,0,0
20150827,2427,2427,,,,2427,2427,0,0,0,0
20150828,2427,2427,,,,2432,2432,5,5,0,0
20150831,2432,2432,,,,2505,2505,73,73,0,0
20150901,2505,2505,,,,2602,2602,97,97,0,0
20150902,2602,2602,,,,2579,2579,-23,-23,0,0
20150907,2579,2579,,,,2426,2426,-153,-153,0,0
20150908,2426,2426,,,,2511,2511,85,85,0,0
20150909,2511,2511,,,,2583,2583,72,72,0,0
20150910,2583,2583,,,,2695,2695,112,112,0,0
20150911,2695,2695,,,,2729,2729,34,34,0,0
20150914,2729,2729,,,,2725,2725,-4,-4,0,0
20150915,2725,2725,,,,2803,2803,78,78,0,0
20150916,2803,2803,,,,2708,2708,-95,-95,0,0
20150917,2708,2708,,,,2689,2689,-19,-19,0,0
20150918,2689,2689,,,,2710,2710,21,21,0,0
20150921,2710,2710,2650,2699,2650,2699,2674,-11,-36,4,4
20150922,2699,2674,2540,2540,2540,2540,2540,-134,-134,2,6
20150923,2540,2540,2416,2416,2416,2416,2416,-124,-124,2,4
20150924,2416,2416,,,,2416,2416,0,0,0,4
20150925,2416,2416,,,,2416,2416,0,0,0,4
20150928,2416,2416,,,,2416,2416,0,0,0,4
20150929,2416,2416,,,,2416,2416,0,0,0,4
20150930,2416,2416,,,,2416,2416,0,0,0,4
20151008,2416,2416,,,,2416,2416,0,0,0,4
20151009,2416,2416,2535,2536,2534,2536,2535,120,119,6,6
20151012,2536,2535,2543,2543,2543,2543,2543,8,8,2,4
20151013,2543,2543,2434,2434,2434,2434,2434,-109,-109,2,4
20151014,2434,2434,,,,2323,2323,-111,-111,0,4
20151015,2323,2323,,,,2379,2379,56,56,0,4
20151016,2379,2379,,,,2379,2379,0,0,0,4
20151019,2379,2379,,,,2370,2370,-9,-9,0,4
20151020,2370,2370,,,,2370,2370,0,0,0,4
20151021,2370,2370,,,,2382,2382,12,12,0,4
20151022,2382,2382,,,,2268,2268,-114,-114,0,4
20151023,2268,2268,,,,2268,2268,0,0,0,4
20151026,2268,2268,,,,2377,2377,109,109,0,4
20151027,2377,2377,2258,2495,2258,2495,2416,118,39,6,6
20151028,2495,2416,,,,2416,2416,0,0,0,6
20151029,2416,2416,,,,2416,2416,0,0,0,6
20151030,2416,2416,,,,2416,2416,0,0,0,6
20151102,2416,2416,,,,2416,2416,0,0,0,6
20151103,2416,2416,,,,2416,2416,0,0,0,6
20151104,2416,2416,,,,2416,2416,0,0,0,6
20151105,2416,2416,,,,2416,2416,0,0,0,6
20151106,2416,2416,,,,2416,2416,0,0,0,6
20151109,2416,2416,,,,2416,2416,0,0,0,6
20151110,2416,2416,,,,2416,2416,0,0,0,6
20151111,2416,2416,2536,2536,2536,2536,2536,120,120,2,8
20151112,2536,2536,,,,2536,2536,0,0,0,8
20151113,2536,2536,,,,2413,2413,-123,-123,0,8
20151116,2413,2413,,,,2413,2413,0,0,0,8
20151117,2413,2413,,,,2413,2413,0,0,0,8
20151118,2413,2413,,,,2413,2413,0,0,0,8
20151119,2413,2413,,,,2413,2413,0,0,0,8
20151120,2413,2413,,,,2413,2413,0,0,0,8
20151123,2413,2413,,,,2413,2413,0,0,0,8
20151124,2413,2413,,,,2413,2413,0,0,0,8
20151125,2413,2413,2298,2533,2298,2533,2415,120,2,4,8
20151126,2533,2415,,,,2401,2401,-14,-14,0,8
20151127,2401,2401,2510,2510,2510,2510,2510,109,109,2,6
20151130,2510,2510,,,,2510,2510,0,0,0,6
fu1606,20150601,3395,3395,,,,3395,3395,0,0,0,0
20150602,3395,3395,,,,3395,3395,0,0,0,0
20150603,3395,3395,,,,3395,3395,0,0,0,0
20150604,3395,3395,,,,3395,3395,0,0,0,0
20150605,3395,3395,,,,3395,3395,0,0,0,0
20150608,3395,3395,,,,3395,3395,0,0,0,0
20150609,3395,3395,,,,3395,3395,0,0,0,0
20150610,3395,3395,,,,3395,3395,0,0,0,0
20150611,3395,3395,,,,3395,3395,0,0,0,0
20150612,3395,3395,,,,3395,3395,0,0,0,0
20150615,3395,3395,,,,3395,3395,0,0,0,0
20150616,3395,3395,3734,3734,3090,3300,3433,-95,38,12,0
20150617,3300,3433,,,,3433,3433,0,0,0,0
20150618,3433,3433,,,,3375,3375,-58,-58,0,0
20150619,3375,3375,,,,3375,3375,0,0,0,0
20150623,3375,3375,,,,3282,3282,-93,-93,0,0
20150624,3282,3282,,,,3282,3282,0,0,0,0
20150625,3282,3282,,,,3282,3282,0,0,0,0
20150626,3282,3282,,,,3164,3164,-118,-118,0,0
20150629,3164,3164,,,,3164,3164,0,0,0,0
20150630,3164,3164,,,,3133,3133,-31,-31,0,0
20150701,3133,3133,,,,3229,3229,96,96,0,0
20150702,3229,3229,,,,3227,3227,-2,-2,0,0
20150703,3227,3227,,,,3157,3157,-70,-70,0,0
20150706,3157,3157,,,,3030,3030,-127,-127,0,0
20150707,3030,3030,,,,2878,2878,-152,-152,0,0
20150708,2878,2878,,,,2759,2759,-119,-119,0,0
20150709,2759,2759,,,,2732,2732,-27,-27,0,0
20150710,2732,2732,,,,2865,2865,133,133,0,0
20150713,2865,2865,,,,2825,2825,-40,-40,0,0
20150714,2825,2825,,,,2784,2784,-41,-41,0,0
20150715,2784,2784,,,,2644,2644,-140,-140,0,0
20150716,2644,2644,,,,2684,2684,40,40,0,0
20150717,2684,2684,,,,2713,2713,29,29,0,0
20150720,2713,2713,,,,2610,2610,-103,-103,0,0
20150721,2610,2610,,,,2643,2643,33,33,0,0
20150722,2643,2643,,,,2597,2597,-46,-46,0,0
20150723,2597,2597,,,,2552,2552,-45,-45,0,0
20150724,2552,2552,,,,2679,2679,127,127,0,0
20150727,2679,2679,,,,2709,2709,30,30,0,0
20150728,2709,2709,,,,2664,2664,-45,-45,0,0
20150729,2664,2664,,,,2680,2680,16,16,0,0
20150730,2680,2680,,,,2659,2659,-21,-21,0,0
20150731,2659,2659,,,,2607,2607,-52,-52,0,0
20150803,2607,2607,,,,2528,2528,-79,-79,0,0
20150804,2528,2528,,,,2489,2489,-39,-39,0,0
20150805,2489,2489,,,,2487,2487,-2,-2,0,0
20150806,2487,2487,,,,2464,2464,-23,-23,0,0
20150807,2464,2464,,,,2519,2519,55,55,0,0
20150810,2519,2519,,,,2535,2535,16,16,0,0
20150811,2535,2535,,,,2593,2593,58,58,0,0
20150812,2593,2593,,,,2630,2630,37,37,0,0
20150813,2630,2630,,,,2640,2640,10,10,0,0
20150814,2640,2640,,,,2551,2551,-89,-89,0,0
20150817,2551,2551,,,,2454,2454,-97,-97,0,0
20150818,2454,2454,,,,2408,2408,-46,-46,0,0
20150819,2408,2408,,,,2352,2352,-56,-56,0,0
20150820,2352,2352,,,,2326,2326,-26,-26,0,0
20150821,2326,2326,,,,2288,2288,-38,-38,0,0
20150824,2288,2288,,,,2188,2188,-100,-100,0,0
20150825,2188,2188,,,,2149,2149,-39,-39,0,0
20150826,2149,2149,,,,2071,2071,-78,-78,0,0
20150827,2071,2071,,,,2071,2071,0,0,0,0
20150828,2071,2071,,,,2075,2075,4,4,0,0
20150831,2075,2075,,,,2137,2137,62,62,0,0
20150901,2137,2137,,,,2220,2220,83,83,0,0
20150902,2220,2220,,,,2201,2201,-19,-19,0,0
20150907,2201,2201,,,,2070,2070,-131,-131,0,0
20150908,2070,2070,,,,2143,2143,73,73,0,0
20150909,2143,2143,,,,2204,2204,61,61,0,0
20150910,2204,2204,,,,2300,2300,96,96,0,0
20150911,2300,2300,,,,2329,2329,29,29,0,0
20150914,2329,2329,,,,2326,2326,-3,-3,0,0
20150915,2326,2326,,,,2393,2393,67,67,0,0
20150916,2393,2393,,,,2312,2312,-81,-81,0,0
20150917,2312,2312,,,,2295,2295,-17,-17,0,0
20150918,2295,2295,,,,2313,2313,18,18,0,0
20150921,2313,2313,,,,2282,2282,-31,-31,0,0
20150922,2282,2282,,,,2167,2167,-115,-115,0,0
20150923,2167,2167,,,,2061,2061,-106,-106,0,0
20150924,2061,2061,,,,2059,2059,-2,-2,0,0
20150925,2059,2059,,,,2075,2075,16,16,0,0
20150928,2075,2075,,,,2102,2102,27,27,0,0
20150929,2102,2102,,,,2121,2121,19,19,0,0
20150930,2121,2121,,,,2020,2020,-101,-101,0,0
20151008,2020,2020,,,,2117,2117,97,97,0,0
20151009,2117,2117,,,,2222,2222,105,105,0,0
20151012,2222,2222,,,,2229,2229,7,7,0,0
20151013,2229,2229,,,,2133,2133,-96,-96,0,0
20151014,2133,2133,,,,2239,2239,106,106,0,0
20151015,2239,2239,,,,2293,2293,54,54,0,0
20151016,2293,2293,,,,2293,2293,0,0,0,0
20151019,2293,2293,,,,2284,2284,-9,-9,0,0
20151020,2284,2284,,,,2284,2284,0,0,0,0
20151021,2284,2284,,,,2296,2296,12,12,0,0
20151022,2296,2296,,,,2186,2186,-110,-110,0,0
20151023,2186,2186,,,,2186,2186,0,0,0,0
20151026,2186,2186,,,,2291,2291,105,105,0,0
20151027,2291,2291,,,,2328,2328,37,37,0,0
20151028,2328,2328,,,,2375,2375,47,47,0,0
20151029,2375,2375,,,,2259,2259,-116,-116,0,0
20151030,2259,2259,,,,2156,2156,-103,-103,0,0
20151102,2156,2156,,,,2263,2263,107,107,0,0
20151103,2263,2263,,,,2263,2263,0,0,0,0
20151104,2263,2263,,,,2263,2263,0,0,0,0
20151105,2263,2263,,,,2263,2263,0,0,0,0
20151106,2263,2263,,,,2263,2263,0,0,0,0
20151109,2263,2263,,,,2270,2270,7,7,0,0
20151110,2270,2270,,,,2270,2270,0,0,0,0
20151111,2270,2270,,,,2382,2382,112,112,0,0
20151112,2382,2382,,,,2382,2382,0,0,0,0
20151113,2382,2382,,,,2266,2266,-116,-116,0,0
20151116,2266,2266,,,,2192,2192,-74,-74,0,0
20151117,2192,2192,,,,2301,2301,109,109,0,0
20151118,2301,2301,,,,2362,2362,61,61,0,0
20151119,2362,2362,,,,2362,2362,0,0,0,0
20151120,2362,2362,,,,2283,2283,-79,-79,0,0
20151123,2283,2283,,,,2358,2358,75,75,0,0
20151124,2358,2358,,,,2276,2276,-82,-82,0,0
20151125,2276,2276,,,,2278,2278,2,2,0,0
20151126,2278,2278,,,,2265,2265,-13,-13,0,0
20151127,2265,2265,,,,2367,2367,102,102,0,0
20151130,2367,2367,,,,2312,2312,-55,-55,0,0
fu1607,20150701,3133,3133,,,,3133,3133,0,0,0,0
20150702,3133,3133,,,,3133,3133,0,0,0,0
20150703,3133,3133,,,,3133,3133,0,0,0,0
20150706,3133,3133,,,,3133,3133,0,0,0,0
20150707,3133,3133,,,,3133,3133,0,0,0,0
20150708,3133,3133,,,,3004,3004,-129,-129,0,0
20150709,3004,3004,,,,2974,2974,-30,-30,0,0
20150710,2974,2974,,,,3119,3119,145,145,0,0
20150713,3119,3119,,,,3076,3076,-43,-43,0,0
20150714,3076,3076,,,,3031,3031,-45,-45,0,0
20150715,3031,3031,,,,2879,2879,-152,-152,0,0
20150716,2879,2879,,,,2879,2879,0,0,0,0
20150717,2879,2879,,,,2879,2879,0,0,0,0
20150720,2879,2879,,,,2879,2879,0,0,0,0
20150721,2879,2879,,,,2879,2879,0,0,0,0
20150722,2879,2879,,,,2879,2879,0,0,0,0
20150723,2879,2879,,,,2879,2879,0,0,0,0
20150724,2879,2879,,,,2879,2879,0,0,0,0
20150727,2879,2879,,,,2879,2879,0,0,0,0
20150728,2879,2879,,,,2879,2879,0,0,0,0
20150729,2879,2879,,,,2879,2879,0,0,0,0
20150730,2879,2879,,,,2879,2879,0,0,0,0
20150731,2879,2879,,,,2879,2879,0,0,0,0
20150803,2879,2879,,,,2791,2791,-88,-88,0,0
20150804,2791,2791,,,,2748,2748,-43,-43,0,0
20150805,2748,2748,,,,2746,2746,-2,-2,0,0
20150806,2746,2746,,,,2720,2720,-26,-26,0,0
20150807,2720,2720,,,,2720,2720,0,0,0,0
20150810,2720,2720,,,,2737,2737,17,17,0,0
20150811,2737,2737,,,,2737,2737,0,0,0,0
20150812,2737,2737,,,,2737,2737,0,0,0,0
20150813,2737,2737,,,,2737,2737,0,0,0,0
20150814,2737,2737,,,,2737,2737,0,0,0,0
20150817,2737,2737,,,,2737,2737,0,0,0,0
20150818,2737,2737,,,,2737,2737,0,0,0,0
20150819,2737,2737,,,,2674,2674,-63,-63,0,0
20150820,2674,2674,,,,2644,2644,-30,-30,0,0
20150821,2644,2644,,,,2601,2601,-43,-43,0,0
20150824,2601,2601,,,,2601,2601,0,0,0,0
20150825,2601,2601,,,,2554,2554,-47,-47,0,0
20150826,2554,2554,,,,2461,2461,-93,-93,0,0
20150827,2461,2461,,,,2461,2461,0,0,0,0
20150828,2461,2461,,,,2466,2466,5,5,0,0
20150831,2466,2466,,,,2540,2540,74,74,0,0
20150901,2540,2540,,,,2639,2639,99,99,0,0
20150902,2639,2639,,,,2616,2616,-23,-23,0,0
20150907,2616,2616,,,,2461,2461,-155,-155,0,0
20150908,2461,2461,,,,2548,2548,87,87,0,0
20150909,2548,2548,2699,2699,2699,2699,2699,151,151,2,2
20150910,2699,2699,,,,2564,2564,-135,-135,0,2
20150911,2564,2564,2500,2500,2500,2500,2500,-64,-64,2,2
20150914,2500,2500,,,,2497,2497,-3,-3,0,2
20150915,2497,2497,,,,2497,2497,0,0,0,2
20150916,2497,2497,2372,2599,2372,2372,2447,-125,-50,6,2
20150917,2372,2447,,,,2429,2429,-18,-18,0,2
20150918,2429,2429,,,,2448,2448,19,19,0,2
20150921,2448,2448,,,,2415,2415,-33,-33,0,2
20150922,2415,2415,,,,2294,2294,-121,-121,0,2
20150923,2294,2294,,,,2182,2182,-112,-112,0,2
20150924,2182,2182,,,,2180,2180,-2,-2,0,2
20150925,2180,2180,,,,2197,2197,17,17,0,2
20150928,2197,2197,,,,2226,2226,29,29,0,2
20150929,2226,2226,,,,2246,2246,20,20,0,2
20150930,2246,2246,,,,2139,2139,-107,-107,0,2
20151008,2139,2139,,,,2242,2242,103,103,0,2
20151009,2242,2242,,,,2352,2352,110,110,0,2
20151012,2352,2352,,,,2359,2359,7,7,0,2
20151013,2359,2359,,,,2257,2257,-102,-102,0,2
20151014,2257,2257,,,,2154,2154,-103,-103,0,2
20151015,2154,2154,,,,2261,2261,107,107,0,2
20151016,2261,2261,,,,2261,2261,0,0,0,2
20151019,2261,2261,,,,2252,2252,-9,-9,0,2
20151020,2252,2252,,,,2252,2252,0,0,0,2
20151021,2252,2252,,,,2264,2264,12,12,0,2
20151022,2264,2264,,,,2156,2156,-108,-108,0,2
20151023,2156,2156,,,,2156,2156,0,0,0,2
20151026,2156,2156,,,,2260,2260,104,104,0,2
20151027,2260,2260,,,,2297,2297,37,37,0,2
20151028,2297,2297,,,,2344,2344,47,47,0,2
20151029,2344,2344,,,,2229,2229,-115,-115,0,2
20151030,2229,2229,,,,2128,2128,-101,-101,0,2
20151102,2128,2128,,,,2234,2234,106,106,0,2
20151103,2234,2234,,,,2234,2234,0,0,0,2
20151104,2234,2234,,,,2234,2234,0,0,0,2
20151105,2234,2234,,,,2234,2234,0,0,0,2
20151106,2234,2234,,,,2234,2234,0,0,0,2
20151109,2234,2234,,,,2241,2241,7,7,0,2
20151110,2241,2241,,,,2241,2241,0,0,0,2
20151111,2241,2241,,,,2352,2352,111,111,0,2
20151112,2352,2352,,,,2352,2352,0,0,0,2
20151113,2352,2352,,,,2238,2238,-114,-114,0,2
20151116,2238,2238,,,,2165,2165,-73,-73,0,2
20151117,2165,2165,,,,2273,2273,108,108,0,2
20151118,2273,2273,,,,2333,2333,60,60,0,2
20151119,2333,2333,,,,2333,2333,0,0,0,2
20151120,2333,2333,,,,2254,2254,-79,-79,0,2
20151123,2254,2254,,,,2328,2328,74,74,0,2
20151124,2328,2328,,,,2247,2247,-81,-81,0,2
20151125,2247,2247,,,,2249,2249,2,2,0,2
20151126,2249,2249,,,,2236,2236,-13,-13,0,2
20151127,2236,2236,,,,2337,2337,101,101,0,2
20151130,2337,2337,,,,2283,2283,-54,-54,0,2
fu1608,20150803,2879,2879,,,,2791,2791,-88,-88,0,0
20150804,2791,2791,,,,2791,2791,0,0,0,0
20150805,2791,2791,,,,2791,2791,0,0,0,0
20150806,2791,2791,,,,2791,2791,0,0,0,0
20150807,2791,2791,,,,2791,2791,0,0,0,0
20150810,2791,2791,,,,2808,2808,17,17,0,0
20150811,2808,2808,,,,2808,2808,0,0,0,0
20150812,2808,2808,,,,2808,2808,0,0,0,0
20150813,2808,2808,,,,2808,2808,0,0,0,0
20150814,2808,2808,,,,2808,2808,0,0,0,0
20150817,2808,2808,,,,2808,2808,0,0,0,0
20150818,2808,2808,,,,2808,2808,0,0,0,0
20150819,2808,2808,,,,2743,2743,-65,-65,0,0
20150820,2743,2743,,,,2713,2713,-30,-30,0,0
20150821,2713,2713,,,,2668,2668,-45,-45,0,0
20150824,2668,2668,,,,2551,2551,-117,-117,0,0
20150825,2551,2551,,,,2505,2505,-46,-46,0,0
20150826,2505,2505,,,,2414,2414,-91,-91,0,0
20150827,2414,2414,,,,2414,2414,0,0,0,0
20150828,2414,2414,,,,2419,2419,5,5,0,0
20150831,2419,2419,,,,2491,2491,72,72,0,0
20150901,2491,2491,,,,2588,2588,97,97,0,0
20150902,2588,2588,,,,2565,2565,-23,-23,0,0
20150907,2565,2565,,,,2413,2413,-152,-152,0,0
20150908,2413,2413,,,,2413,2413,0,0,0,0
20150909,2413,2413,,,,2413,2413,0,0,0,0
20150910,2413,2413,,,,2413,2413,0,0,0,0
20150911,2413,2413,,,,2413,2413,0,0,0,0
20150914,2413,2413,,,,2413,2413,0,0,0,0
20150915,2413,2413,,,,2413,2413,0,0,0,0
20150916,2413,2413,,,,2413,2413,0,0,0,0
20150917,2413,2413,,,,2413,2413,0,0,0,0
20150918,2413,2413,,,,2413,2413,0,0,0,0
20150921,2413,2413,,,,2413,2413,0,0,0,0
20150922,2413,2413,,,,2413,2413,0,0,0,0
20150923,2413,2413,,,,2413,2413,0,0,0,0
20150924,2413,2413,,,,2413,2413,0,0,0,0
20150925,2413,2413,,,,2413,2413,0,0,0,0
20150928,2413,2413,,,,2413,2413,0,0,0,0
20150929,2413,2413,,,,2413,2413,0,0,0,0
20150930,2413,2413,,,,2413,2413,0,0,0,0
20151008,2413,2413,,,,2413,2413,0,0,0,0
20151009,2413,2413,,,,2413,2413,0,0,0,0
20151012,2413,2413,,,,2413,2413,0,0,0,0
20151013,2413,2413,,,,2413,2413,0,0,0,0
20151014,2413,2413,,,,2413,2413,0,0,0,0
20151015,2413,2413,,,,2413,2413,0,0,0,0
20151016,2413,2413,,,,2413,2413,0,0,0,0
20151019,2413,2413,,,,2413,2413,0,0,0,0
20151020,2413,2413,,,,2499,2499,86,86,0,0
20151021,2499,2499,,,,2499,2499,0,0,0,0
20151022,2499,2499,,,,2499,2499,0,0,0,0
20151023,2499,2499,,,,2499,2499,0,0,0,0
20151026,2499,2499,,,,2499,2499,0,0,0,0
20151027,2499,2499,,,,2499,2499,0,0,0,0
20151028,2499,2499,,,,2499,2499,0,0,0,0
20151029,2499,2499,,,,2499,2499,0,0,0,0
20151030,2499,2499,,,,2499,2499,0,0,0,0
20151102,2499,2499,,,,2499,2499,0,0,0,0
20151103,2499,2499,,,,2499,2499,0,0,0,0
20151104,2499,2499,,,,2499,2499,0,0,0,0
20151105,2499,2499,,,,2499,2499,0,0,0,0
20151106,2499,2499,,,,2499,2499,0,0,0,0
20151109,2499,2499,,,,2499,2499,0,0,0,0
20151110,2499,2499,,,,2499,2499,0,0,0,0
20151111,2499,2499,,,,2499,2499,0,0,0,0
20151112,2499,2499,,,,2499,2499,0,0,0,0
20151113,2499,2499,,,,2499,2499,0,0,0,0
20151116,2499,2499,,,,2499,2499,0,0,0,0
20151117,2499,2499,,,,2499,2499,0,0,0,0
20151118,2499,2499,,,,2499,2499,0,0,0,0
20151119,2499,2499,,,,2499,2499,0,0,0,0
20151120,2499,2499,,,,2499,2499,0,0,0,0
20151123,2499,2499,,,,2499,2499,0,0,0,0
20151124,2499,2499,,,,2499,2499,0,0,0,0
20151125,2499,2499,,,,2499,2499,0,0,0,0
20151126,2499,2499,,,,2499,2499,0,0,0,0
20151127,2499,2499,,,,2499,2499,0,0,0,0
20151130,2499,2499,,,,2499,2499,0,0,0,0
fu1609,20150901,2491,2491,2740,2740,2242,2242,2491,-249,0,4,0
20150902,2242,2491,,,,2469,2469,-22,-22,0,0
20150907,2469,2469,,,,2322,2322,-147,-147,0,0
20150908,2322,2322,,,,2404,2404,82,82,0,0
20150909,2404,2404,,,,2524,2524,120,120,0,0
20150910,2524,2524,,,,2633,2633,109,109,0,0
20150911,2633,2633,2764,2764,2764,2764,2764,131,131,2,2
20150914,2764,2764,2625,2625,2625,2625,2625,-139,-139,28,30
20150915,2625,2625,2625,2625,2493,2493,2608,-132,-17,16,16
20150916,2493,2608,,,,2556,2556,-52,-52,0,16
20150917,2556,2556,2620,2620,2593,2593,2614,37,58,18,6
20150918,2593,2614,2498,2566,2498,2566,2543,-48,-71,6,8
20150921,2566,2543,,,,2543,2543,0,0,0,8
20150922,2543,2543,,,,2543,2543,0,0,0,8
20150923,2543,2543,,,,2543,2543,0,0,0,8
20150924,2543,2543,,,,2543,2543,0,0,0,8
20150925,2543,2543,2576,2576,2576,2576,2576,33,33,2,8
20150928,2576,2576,,,,2576,2576,0,0,0,8
20150929,2576,2576,2449,2535,2449,2535,2472,-41,-104,10,2
20150930,2535,2472,,,,2472,2472,0,0,0,2
20151008,2472,2472,,,,2472,2472,0,0,0,2
20151009,2472,2472,,,,2593,2593,121,121,0,2
20151012,2593,2593,,,,2593,2593,0,0,0,2
20151013,2593,2593,,,,2593,2593,0,0,0,2
20151014,2593,2593,,,,2593,2593,0,0,0,2
20151015,2593,2593,,,,2593,2593,0,0,0,2
20151016,2593,2593,,,,2593,2593,0,0,0,2
20151019,2593,2593,,,,2583,2583,-10,-10,0,2
20151020,2583,2583,,,,2583,2583,0,0,0,2
20151021,2583,2583,,,,2583,2583,0,0,0,2
20151022,2583,2583,,,,2460,2460,-123,-123,0,2
20151023,2460,2460,,,,2460,2460,0,0,0,2
20151026,2460,2460,,,,2460,2460,0,0,0,2
20151027,2460,2460,,,,2460,2460,0,0,0,2
20151028,2460,2460,,,,2510,2510,50,50,0,2
20151029,2510,2510,,,,2500,2500,-10,-10,0,2
20151030,2500,2500,,,,2500,2500,0,0,0,2
20151102,2500,2500,,,,2500,2500,0,0,0,2
20151103,2500,2500,,,,2500,2500,0,0,0,2
20151104,2500,2500,,,,2500,2500,0,0,0,2
20151105,2500,2500,,,,2500,2500,0,0,0,2
20151106,2500,2500,,,,2500,2500,0,0,0,2
20151109,2500,2500,,,,2500,2500,0,0,0,2
20151110,2500,2500,,,,2500,2500,0,0,0,2
20151111,2500,2500,,,,2500,2500,0,0,0,2
20151112,2500,2500,,,,2500,2500,0,0,0,2
20151113,2500,2500,,,,2500,2500,0,0,0,2
20151116,2500,2500,,,,2500,2500,0,0,0,2
20151117,2500,2500,,,,2500,2500,0,0,0,2
20151118,2500,2500,,,,2500,2500,0,0,0,2
20151119,2500,2500,,,,2500,2500,0,0,0,2
20151120,2500,2500,,,,2500,2500,0,0,0,2
20151123,2500,2500,,,,2500,2500,0,0,0,2
20151124,2500,2500,,,,2413,2413,-87,-87,0,2
20151125,2413,2413,,,,2415,2415,2,2,0,2
20151126,2415,2415,,,,2401,2401,-14,-14,0,2
20151127,2401,2401,,,,2510,2510,109,109,0,2
20151130,2510,2510,,,,2452,2452,-58,-58,0,2
fu1610,20151008,2472,2472,,,,2472,2472,0,0,0,0
20151009,2472,2472,,,,2472,2472,0,0,0,0
20151012,2472,2472,,,,2472,2472,0,0,0,0
20151013,2472,2472,,,,2472,2472,0,0,0,0
20151014,2472,2472,,,,2472,2472,0,0,0,0
20151015,2472,2472,,,,2472,2472,0,0,0,0
20151016,2472,2472,,,,2472,2472,0,0,0,0
20151019,2472,2472,,,,2472,2472,0,0,0,0
20151020,2472,2472,,,,2472,2472,0,0,0,0
20151021,2472,2472,,,,2472,2472,0,0,0,0
20151022,2472,2472,,,,2472,2472,0,0,0,0
20151023,2472,2472,,,,2472,2472,0,0,0,0
20151026,2472,2472,,,,2472,2472,0,0,0,0
20151027,2472,2472,,,,2472,2472,0,0,0,0
20151028,2472,2472,,,,2472,2472,0,0,0,0
20151029,2472,2472,,,,2472,2472,0,0,0,0
20151030,2472,2472,,,,2472,2472,0,0,0,0
20151102,2472,2472,,,,2472,2472,0,0,0,0
20151103,2472,2472,,,,2472,2472,0,0,0,0
20151104,2472,2472,,,,2472,2472,0,0,0,0
20151105,2472,2472,,,,2472,2472,0,0,0,0
20151106,2472,2472,,,,2472,2472,0,0,0,0
20151109,2472,2472,,,,2472,2472,0,0,0,0
20151110,2472,2472,,,,2472,2472,0,0,0,0
20151111,2472,2472,,,,2472,2472,0,0,0,0
20151112,2472,2472,,,,2472,2472,0,0,0,0
20151113,2472,2472,,,,2472,2472,0,0,0,0
20151116,2472,2472,,,,2472,2472,0,0,0,0
20151117,2472,2472,,,,2472,2472,0,0,0,0
20151118,2472,2472,,,,2472,2472,0,0,0,0
20151119,2472,2472,,,,2472,2472,0,0,0,0
20151120,2472,2472,,,,2472,2472,0,0,0,0
20151123,2472,2472,,,,2472,2472,0,0,0,0
20151124,2472,2472,,,,2472,2472,0,0,0,0
20151125,2472,2472,,,,2472,2472,0,0,0,0
20151126,2472,2472,,,,2472,2472,0,0,0,0
20151127,2472,2472,,,,2472,2472,0,0,0,0
20151130,2472,2472,,,,2472,2472,0,0,0,0
fu1611,20151102,2472,2472,,,,2472,2472,0,0,0,0
20151103,2472,2472,,,,2472,2472,0,0,0,0
20151104,2472,2472,,,,2472,2472,0,0,0,0
20151105,2472,2472,,,,2472,2472,0,0,0,0
20151106,2472,2472,,,,2472,2472,0,0,0,0
20151109,2472,2472,,,,2472,2472,0,0,0,0
20151110,2472,2472,,,,2472,2472,0,0,0,0
20151111,2472,2472,,,,2472,2472,0,0,0,0
20151112,2472,2472,,,,2472,2472,0,0,0,0
20151113,2472,2472,,,,2472,2472,0,0,0,0
20151116,2472,2472,,,,2472,2472,0,0,0,0
20151117,2472,2472,,,,2472,2472,0,0,0,0
20151118,2472,2472,,,,2472,2472,0,0,0,0
20151119,2472,2472,,,,2472,2472,0,0,0,0
20151120,2472,2472,,,,2472,2472,0,0,0,0
20151123,2472,2472,,,,2472,2472,0,0,0,0
20151124,2472,2472,,,,2472,2472,0,0,0,0
20151125,2472,2472,,,,2472,2472,0,0,0,0
20151126,2472,2472,,,,2472,2472,0,0,0,0
20151127,2472,2472,,,,2472,2472,0,0,0,0
20151130,2472,2472,,,,2472,2472,0,0,0,0
hc1501,20150105,2970,2992,2950,2980,2950,2980,2966,-12,-26,594,9900
20150106,2980,2966,2970,2972,2970,2972,2970,6,4,300,9780
20150107,2972,2970,3000,3000,2980,3000,2990,30,20,540,9240
20150108,3000,2990,,,,2990,2990,0,0,0,9240
20150109,2990,2990,2962,2980,2960,2980,2968,-10,-22,300,9120
20150112,2980,2968,2972,2972,2950,2950,2960,-18,-8,120,9000
20150113,2950,2960,2866,2866,2866,2866,2866,-94,-94,60,8940
20150114,2866,2866,2760,2760,2760,2760,2760,-106,-106,60,9000
20150115,2760,2760,2662,2850,2648,2850,2760,90,0,480,9120
hc1502,20150105,2976,2976,,,,2952,2952,-24,-24,0,0
20150106,2952,2952,,,,2956,2956,4,4,0,0
20150107,2956,2956,,,,2974,2974,18,18,0,0
20150108,2974,2974,,,,2974,2974,0,0,0,0
20150109,2974,2974,,,,2952,2952,-22,-22,0,0
20150112,2952,2952,,,,2944,2944,-8,-8,0,0
20150113,2944,2944,,,,2850,2850,-94,-94,0,0
20150114,2850,2850,,,,2744,2744,-106,-106,0,0
20150115,2744,2744,,,,2744,2744,0,0,0,0
20150116,2744,2744,,,,2744,2744,0,0,0,0
20150119,2744,2744,,,,2744,2744,0,0,0,0
20150120,2744,2744,,,,2744,2744,0,0,0,0
20150121,2744,2744,,,,2744,2744,0,0,0,0
20150122,2744,2744,,,,2744,2744,0,0,0,0
20150123,2744,2744,,,,2744,2744,0,0,0,0
20150126,2744,2744,,,,2744,2744,0,0,0,0
20150127,2744,2744,,,,2744,2744,0,0,0,0
20150128,2744,2744,,,,2744,2744,0,0,0,0
20150129,2744,2744,,,,2744,2744,0,0,0,0
20150130,2744,2744,,,,2744,2744,0,0,0,0
20150202,2744,2744,,,,2744,2744,0,0,0,0
20150203,2744,2744,,,,2744,2744,0,0,0,0
20150204,2744,2744,,,,2744,2744,0,0,0,0
20150205,2744,2744,,,,2744,2744,0,0,0,0
20150206,2744,2744,,,,2744,2744,0,0,0,0
20150209,2744,2744,,,,2744,2744,0,0,0,0
20150210,2744,2744,,,,2744,2744,0,0,0,0
hc1503,20150105,2830,2830,,,,2806,2806,-24,-24,0,312
20150106,2806,2806,,,,2810,2810,4,4,0,312
20150107,2810,2810,2922,2922,2806,2806,2864,-4,54,4,312
20150108,2806,2864,,,,2864,2864,0,0,0,312
20150109,2864,2864,,,,2842,2842,-22,-22,0,312
20150112,2842,2842,,,,2834,2834,-8,-8,0,312
20150113,2834,2834,,,,2744,2744,-90,-90,0,312
20150114,2744,2744,,,,2642,2642,-102,-102,0,312
20150115,2642,2642,,,,2642,2642,0,0,0,312
20150116,2642,2642,,,,2642,2642,0,0,0,312
20150119,2642,2642,,,,2642,2642,0,0,0,312
20150120,2642,2642,2564,2638,2536,2596,2586,-46,-56,10,308
20150121,2596,2586,,,,2586,2586,0,0,0,308
20150122,2586,2586,,,,2586,2586,0,0,0,308
20150123,2586,2586,,,,2586,2586,0,0,0,308
20150126,2586,2586,,,,2586,2586,0,0,0,308
20150127,2586,2586,,,,2586,2586,0,0,0,308
20150128,2586,2586,,,,2586,2586,0,0,0,308
20150129,2586,2586,,,,2586,2586,0,0,0,308
20150130,2586,2586,,,,2586,2586,0,0,0,308
20150202,2586,2586,,,,2586,2586,0,0,0,308
20150203,2586,2586,,,,2586,2586,0,0,0,308
20150204,2586,2586,,,,2586,2586,0,0,0,308
20150205,2586,2586,,,,2586,2586,0,0,0,308
20150206,2586,2586,,,,2586,2586,0,0,0,308
20150209,2586,2586,,,,2586,2586,0,0,0,308
20150210,2586,2586,,,,2586,2586,0,0,0,308
20150211,2586,2586,,,,2586,2586,0,0,0,308
20150212,2586,2586,,,,2500,2500,-86,-86,0,308
20150213,2500,2500,2450,2600,2418,2420,2456,-80,-44,18,308
20150216,2420,2456,2554,2554,2554,2554,2554,98,98,8,300
20150217,2554,2554,2500,2500,2400,2400,2482,-154,-72,12,302
20150225,2400,2482,,,,2482,2482,0,0,0,302
20150226,2482,2482,,,,2482,2482,0,0,0,302
20150227,2482,2482,2400,2400,2400,2400,2400,-82,-82,2,300
20150302,2400,2400,,,,2400,2400,0,0,0,300
20150303,2400,2400,,,,2400,2400,0,0,0,300
20150304,2400,2400,,,,2400,2400,0,0,0,300
20150305,2400,2400,2380,2420,2380,2420,2404,20,4,300,300
20150306,2420,2404,,,,2404,2404,0,0,0,300
20150309,2404,2404,,,,2404,2404,0,0,0,300
20150310,2404,2404,,,,2404,2404,0,0,0,300
20150311,2404,2404,2400,2400,2400,2400,2400,-4,-4,300,300
20150312,2400,2400,,,,2400,2400,0,0,0,300
20150313,2400,2400,2470,2470,2470,2470,2470,70,70,60,300
20150316,2470,2470,,,,2470,2470,0,0,0,300
hc1504,20150105,2778,2778,,,,2754,2754,-24,-24,0,2
20150106,2754,2754,,,,2758,2758,4,4,0,2
20150107,2758,2758,,,,2810,2810,52,52,0,2
20150108,2810,2810,,,,2810,2810,0,0,0,2
20150109,2810,2810,,,,2790,2790,-20,-20,0,2
20150112,2790,2790,,,,2782,2782,-8,-8,0,2
20150113,2782,2782,2890,2890,2680,2680,2784,-102,2,8,2
20150114,2680,2784,,,,2680,2680,-104,-104,0,2
20150115,2680,2680,,,,2680,2680,0,0,0,2
20150116,2680,2680,,,,2680,2680,0,0,0,2
20150119,2680,2680,,,,2680,2680,0,0,0,2
20150120,2680,2680,,,,2624,2624,-56,-56,0,2
20150121,2624,2624,,,,2624,2624,0,0,0,2
20150122,2624,2624,,,,2624,2624,0,0,0,2
20150123,2624,2624,,,,2624,2624,0,0,0,2
20150126,2624,2624,,,,2624,2624,0,0,0,2
20150127,2624,2624,,,,2624,2624,0,0,0,2
20150128,2624,2624,,,,2624,2624,0,0,0,2
20150129,2624,2624,,,,2624,2624,0,0,0,2
20150130,2624,2624,,,,2624,2624,0,0,0,2
20150202,2624,2624,,,,2624,2624,0,0,0,2
20150203,2624,2624,,,,2624,2624,0,0,0,2
20150204,2624,2624,,,,2624,2624,0,0,0,2
20150205,2624,2624,,,,2624,2624,0,0,0,2
20150206,2624,2624,,,,2624,2624,0,0,0,2
20150209,2624,2624,2726,2726,2714,2714,2720,90,96,4,2
20150210,2714,2720,,,,2720,2720,0,0,0,2
20150211,2720,2720,,,,2720,2720,0,0,0,2
20150212,2720,2720,,,,2720,2720,0,0,0,2
20150213,2720,2720,2828,2828,2828,2828,2828,108,108,2,4
20150216,2828,2828,,,,2714,2714,-114,-114,0,4
20150217,2714,2714,,,,2714,2714,0,0,0,4
20150225,2714,2714,,,,2714,2714,0,0,0,4
20150226,2714,2714,,,,2714,2714,0,0,0,4
20150227,2714,2714,2584,2584,2584,2584,2584,-130,-130,2,4
20150302,2584,2584,2600,2600,2600,2600,2600,16,16,2,2
20150303,2600,2600,2470,2720,2470,2720,2594,120,-6,16,2
20150304,2720,2594,2722,2722,2504,2598,2662,4,68,16,2
20150305,2598,2662,2528,2528,2528,2528,2528,-134,-134,2,2
20150306,2528,2528,2402,2402,2402,2402,2402,-126,-126,2,2
20150309,2402,2402,,,,2402,2402,0,0,0,2
20150310,2402,2402,,,,2402,2402,0,0,0,2
20150311,2402,2402,,,,2398,2398,-4,-4,0,2
20150312,2398,2398,2308,2308,2308,2308,2308,-90,-90,2,2
20150313,2308,2308,,,,2374,2374,66,66,0,2
20150316,2374,2374,,,,2374,2374,0,0,0,2
20150317,2374,2374,2328,2328,2328,2328,2328,-46,-46,2,2
20150318,2328,2328,,,,2328,2328,0,0,0,2
20150319,2328,2328,2314,2314,2314,2314,2314,-14,-14,2,2
20150320,2314,2314,,,,2396,2396,82,82,0,2
20150323,2396,2396,2276,2378,2276,2378,2326,-18,-70,4,0
20150324,2378,2326,,,,2326,2326,0,0,0,0
20150325,2326,2326,,,,2326,2326,0,0,0,0
20150326,2326,2326,,,,2326,2326,0,0,0,0
20150327,2326,2326,,,,2326,2326,0,0,0,0
20150330,2326,2326,,,,2326,2326,0,0,0,0
20150331,2326,2326,,,,2326,2326,0,0,0,0
20150401,2326,2326,,,,2326,2326,0,0,0,0
20150402,2326,2326,,,,2326,2326,0,0,0,0
20150403,2326,2326,,,,2326,2326,0,0,0,0
20150407,2326,2326,,,,2326,2326,0,0,0,0
20150408,2326,2326,,,,2326,2326,0,0,0,0
20150409,2326,2326,,,,2326,2326,0,0,0,0
20150410,2326,2326,,,,2326,2326,0,0,0,0
20150413,2326,2326,,,,2326,2326,0,0,0,0
20150414,2326,2326,,,,2326,2326,0,0,0,0
20150415,2326,2326,,,,2326,2326,0,0,0,0
hc1505,20150105,2928,2924,2928,2928,2886,2902,2900,-22,-24,3480,14328
20150106,2902,2900,2882,2992,2882,2936,2936,36,36,7502,14760
20150107,2936,2936,2930,2932,2894,2902,2904,-34,-32,4930,14582
20150108,2902,2904,2902,2912,2874,2878,2888,-26,-16,3476,14606
20150109,2878,2888,2882,2882,2832,2834,2854,-54,-34,4748,15336
20150112,2834,2854,2836,2842,2750,2752,2792,-102,-62,10700,15696
20150113,2752,2792,2750,2764,2724,2736,2738,-56,-54,7650,17142
20150114,2736,2738,2732,2742,2628,2670,2682,-68,-56,20266,20594
20150115,2670,2682,2670,2696,2658,2692,2674,10,-8,11844,21966
20150116,2692,2674,2698,2708,2650,2682,2676,8,2,11764,22776
20150119,2682,2676,2676,2684,2650,2666,2664,-10,-12,10318,23730
20150120,2666,2664,2656,2674,2638,2644,2650,-20,-14,10034,22320
20150121,2644,2650,2650,2662,2632,2640,2646,-10,-4,9092,21312
20150122,2640,2646,2628,2656,2612,2632,2638,-14,-8,8936,21898
20150123,2632,2638,2632,2640,2606,2610,2620,-28,-18,9434,24036
20150126,2610,2620,2604,2612,2544,2560,2576,-60,-44,18546,25014
20150127,2560,2576,2560,2576,2546,2550,2558,-26,-18,20578,32330
20150128,2550,2558,2550,2620,2546,2594,2592,36,34,38828,33702
20150129,2594,2592,2602,2626,2586,2622,2608,30,16,23438,37972
20150130,2622,2608,2620,2624,2596,2600,2612,-8,4,11080,37316
20150202,2600,2612,2602,2716,2578,2592,2606,-20,-6,22808,40268
20150203,2592,2606,2598,2602,2582,2586,2592,-20,-14,13414,43610
20150204,2586,2592,2590,2606,2572,2574,2586,-18,-6,21074,49806
20150205,2574,2586,2586,2588,2564,2578,2576,-8,-10,18368,55352
20150206,2578,2576,2578,2594,2574,2584,2580,8,4,13122,59312
20150209,2584,2580,2588,2588,2566,2574,2574,-6,-6,10306,60020
20150210,2574,2574,2570,2586,2570,2582,2578,8,4,5198,59506
20150211,2582,2578,2582,2606,2578,2602,2588,24,10,7740,58380
20150212,2602,2588,2606,2610,2580,2596,2588,8,0,5844,58176
20150213,2596,2588,2598,2622,2586,2610,2606,22,18,11490,58164
20150216,2610,2606,2608,2646,2608,2624,2628,18,22,14306,58304
20150217,2624,2628,2628,2628,2602,2612,2612,-16,-16,6546,58520
20150225,2612,2612,2614,2614,2572,2594,2588,-18,-24,6510,57920
20150226,2594,2588,2594,2614,2588,2610,2600,22,12,10500,59772
20150227,2610,2600,2614,2620,2582,2584,2598,-16,-2,11906,60794
20150302,2584,2598,2584,2606,2570,2594,2584,-4,-14,16776,60410
20150303,2594,2584,2592,2602,2578,2584,2588,0,4,12670,61224
20150304,2584,2588,2582,2594,2578,2590,2586,2,-2,7622,61116
20150305,2590,2586,2590,2590,2554,2562,2568,-24,-18,26012,59512
20150306,2562,2568,2562,2572,2544,2548,2556,-20,-12,17016,57808
20150309,2548,2556,2548,2562,2516,2526,2534,-30,-22,30006,54124
20150310,2526,2534,2524,2532,2494,2498,2514,-36,-20,16732,49812
20150311,2498,2514,2482,2508,2482,2494,2494,-20,-20,14032,47990
20150312,2494,2494,2488,2560,2484,2510,2506,16,12,15190,46778
20150313,2510,2506,2512,2526,2498,2502,2512,-4,6,9272,45808
20150316,2502,2512,2502,2530,2496,2528,2512,16,0,7804,45022
20150317,2528,2512,2518,2536,2516,2534,2526,22,14,6372,44096
20150318,2534,2526,2532,2538,2498,2504,2514,-22,-12,14544,39188
20150319,2504,2514,2502,2524,2498,2510,2510,-4,-4,6528,39008
20150320,2510,2510,2506,2524,2506,2510,2514,0,4,6560,38942
20150323,2510,2514,2510,2568,2502,2558,2538,44,24,15814,35758
20150324,2558,2538,2576,2580,2546,2554,2560,16,22,10188,33026
20150325,2554,2560,2552,2566,2532,2536,2546,-24,-14,7886,29524
20150326,2536,2546,2540,2546,2514,2518,2528,-28,-18,10798,25476
20150327,2518,2528,2512,2520,2458,2508,2490,-20,-38,10010,23798
20150330,2508,2490,2508,2520,2474,2488,2494,-2,4,6086,23340
20150331,2488,2494,2490,2506,2476,2478,2484,-16,-10,5566,23460
20150401,2478,2484,2480,2502,2448,2452,2466,-32,-18,8982,21024
20150402,2452,2466,2452,2460,2410,2410,2426,-56,-40,10034,18756
20150403,2410,2426,2412,2430,2392,2398,2410,-28,-16,6570,16678
20150407,2398,2410,2394,2410,2342,2342,2378,-68,-32,6728,14100
20150408,2342,2378,2348,2380,2314,2350,2340,-28,-38,5854,12730
20150409,2350,2340,2354,2354,2318,2326,2328,-14,-12,1886,12316
20150410,2326,2328,2320,2324,2282,2310,2310,-18,-18,2634,12192
20150413,2310,2310,2302,2362,2302,2362,2334,52,24,2480,11610
20150414,2362,2334,2366,2370,2330,2358,2352,24,18,1146,11462
20150415,2358,2352,2356,2362,2316,2318,2346,-34,-6,1506,10834
20150416,2318,2346,2318,2358,2318,2346,2338,0,-8,1198,10898
20150417,2346,2338,2352,2364,2328,2348,2342,10,4,516,10736
20150420,2348,2342,2330,2348,2322,2322,2330,-20,-12,1850,10398
20150421,2322,2330,2312,2330,2304,2330,2314,0,-16,2280,9710
20150422,2330,2314,2320,2386,2316,2366,2332,52,18,2406,9152
20150423,2366,2332,2374,2374,2348,2364,2360,32,28,662,8992
20150424,2364,2360,2374,2412,2358,2412,2390,52,30,2448,8088
20150427,2412,2390,2408,2440,2372,2428,2414,38,24,1674,7764
20150428,2428,2414,2438,2446,2429,2430,2437,16,23,982,7504
20150429,2430,2437,2412,2444,2366,2390,2418,-47,-19,570,7088
20150430,2390,2418,2373,2420,2361,2401,2378,-17,-40,3296,6842
20150504,2401,2378,2430,2479,2420,2479,2471,101,93,1322,6660
20150505,2479,2471,2500,2508,2480,2497,2495,26,24,780,6360
20150506,2497,2495,,,,2495,2495,0,0,0,6360
20150507,2495,2495,2418,2488,2418,2468,2459,-27,-36,900,5700
20150508,2468,2459,2347,2459,2346,2459,2417,0,-42,360,5580
20150511,2459,2417,,,,2417,2417,0,0,0,5580
20150512,2417,2417,2300,2300,2300,2300,2300,-117,-117,60,5520
20150513,2300,2300,2410,2410,2410,2410,2410,110,110,240,5280
20150514,2410,2410,,,,2410,2410,0,0,0,5280
20150515,2410,2410,,,,2410,2410,0,0,0,5280
hc1506,20150105,2976,2976,,,,2976,2976,0,0,0,2
20150106,2976,2976,,,,2976,2976,0,0,0,2
20150107,2976,2976,,,,2944,2944,-32,-32,0,2
20150108,2944,2944,,,,2928,2928,-16,-16,0,2
20150109,2928,2928,2810,2956,2810,2956,2882,28,-46,4,2
20150112,2956,2882,,,,2818,2818,-64,-64,0,2
20150113,2818,2818,,,,2764,2764,-54,-54,0,2
20150114,2764,2764,,,,2708,2708,-56,-56,0,2
20150115,2708,2708,,,,2700,2700,-8,-8,0,2
20150116,2700,2700,,,,2702,2702,2,2,0,2
20150119,2702,2702,,,,2690,2690,-12,-12,0,2
20150120,2690,2690,,,,2676,2676,-14,-14,0,2
20150121,2676,2676,,,,2672,2672,-4,-4,0,2
20150122,2672,2672,,,,2664,2664,-8,-8,0,2
20150123,2664,2664,,,,2646,2646,-18,-18,0,2
20150126,2646,2646,,,,2602,2602,-44,-44,0,2
20150127,2602,2602,,,,2582,2582,-20,-20,0,2
20150128,2582,2582,2610,2610,2610,2610,2610,28,28,2,2
20150129,2610,2610,,,,2628,2628,18,18,0,2
20150130,2628,2628,,,,2632,2632,4,4,0,2
20150202,2632,2632,,,,2626,2626,-6,-6,0,2
20150203,2626,2626,,,,2610,2610,-16,-16,0,2
20150204,2610,2610,,,,2604,2604,-6,-6,0,2
20150205,2604,2604,,,,2594,2594,-10,-10,0,2
20150206,2594,2594,,,,2598,2598,4,4,0,2
20150209,2598,2598,,,,2592,2592,-6,-6,0,2
20150210,2592,2592,,,,2596,2596,4,4,0,2
20150211,2596,2596,,,,2606,2606,10,10,0,2
20150212,2606,2606,,,,2606,2606,0,0,0,2
20150213,2606,2606,,,,2624,2624,18,18,0,2
20150216,2624,2624,,,,2646,2646,22,22,0,2
20150217,2646,2646,,,,2646,2646,0,0,0,2
20150225,2646,2646,,,,2646,2646,0,0,0,2
20150226,2646,2646,2714,2714,2714,2714,2714,68,68,2,4
20150227,2714,2714,2680,2680,2680,2680,2680,-34,-34,2,4
20150302,2680,2680,,,,2680,2680,0,0,0,4
20150303,2680,2680,,,,2680,2680,0,0,0,4
20150304,2680,2680,,,,2680,2680,0,0,0,4
20150305,2680,2680,,,,2680,2680,0,0,0,4
20150306,2680,2680,,,,2680,2680,0,0,0,4
20150309,2680,2680,,,,2658,2658,-22,-22,0,4
20150310,2658,2658,,,,2636,2636,-22,-22,0,4
20150311,2636,2636,,,,2614,2614,-22,-22,0,4
20150312,2614,2614,,,,2614,2614,0,0,0,4
20150313,2614,2614,,,,2614,2614,0,0,0,4
20150316,2614,2614,,,,2614,2614,0,0,0,4
20150317,2614,2614,,,,2614,2614,0,0,0,4
20150318,2614,2614,,,,2614,2614,0,0,0,4
20150319,2614,2614,,,,2614,2614,0,0,0,4
20150320,2614,2614,,,,2614,2614,0,0,0,4
20150323,2614,2614,2628,2630,2628,2630,2628,16,14,8,12
20150324,2630,2628,2584,2584,2584,2584,2584,-44,-44,2,10
20150325,2584,2584,,,,2570,2570,-14,-14,0,10
20150326,2570,2570,,,,2552,2552,-18,-18,0,10
20150327,2552,2552,,,,2552,2552,0,0,0,10
20150330,2552,2552,,,,2556,2556,4,4,0,10
20150331,2556,2556,,,,2556,2556,0,0,0,10
20150401,2556,2556,,,,2538,2538,-18,-18,0,10
20150402,2538,2538,,,,2498,2498,-40,-40,0,10
20150403,2498,2498,,,,2480,2480,-18,-18,0,10
20150407,2480,2480,,,,2448,2448,-32,-32,0,10
20150408,2448,2448,,,,2410,2410,-38,-38,0,10
20150409,2410,2410,,,,2398,2398,-12,-12,0,10
20150410,2398,2398,2320,2410,2320,2410,2358,12,-40,12,10
20150413,2410,2358,,,,2382,2382,24,24,0,10
20150414,2382,2382,,,,2400,2400,18,18,0,10
20150415,2400,2400,,,,2392,2392,-8,-8,0,10
20150416,2392,2392,,,,2384,2384,-8,-8,0,10
20150417,2384,2384,2400,2426,2324,2400,2396,16,12,12,8
20150420,2400,2396,2312,2312,2312,2312,2312,-84,-84,2,8
20150421,2312,2312,,,,2296,2296,-16,-16,0,8
20150422,2296,2296,,,,2314,2314,18,18,0,8
20150423,2314,2314,2348,2350,2342,2342,2346,28,32,10,2
20150424,2342,2346,,,,2376,2376,30,30,0,2
20150427,2376,2376,,,,2400,2400,24,24,0,2
20150428,2400,2400,,,,2423,2423,23,23,0,2
20150429,2423,2423,,,,2404,2404,-19,-19,0,2
20150430,2404,2404,,,,2365,2365,-39,-39,0,2
20150504,2365,2365,,,,2457,2457,92,92,0,2
20150505,2457,2457,,,,2481,2481,24,24,0,2
20150506,2481,2481,,,,2481,2481,0,0,0,2
20150507,2481,2481,,,,2445,2445,-36,-36,0,2
20150508,2445,2445,,,,2403,2403,-42,-42,0,2
20150511,2403,2403,,,,2403,2403,0,0,0,2
20150512,2403,2403,,,,2286,2286,-117,-117,0,2
20150513,2286,2286,,,,2395,2395,109,109,0,2
20150514,2395,2395,,,,2395,2395,0,0,0,2
20150515,2395,2395,2276,2514,2275,2514,2394,119,-1,8,2
20150518,2514,2394,2274,2274,2274,2274,2274,-120,-120,2,2
20150519,2274,2274,2160,2160,2160,2160,2160,-114,-114,2,0
20150520,2160,2160,,,,2160,2160,0,0,0,0
20150521,2160,2160,,,,2160,2160,0,0,0,0
20150522,2160,2160,,,,2160,2160,0,0,0,0
20150525,2160,2160,,,,2160,2160,0,0,0,0
20150526,2160,2160,,,,2160,2160,0,0,0,0
20150527,2160,2160,,,,2160,2160,0,0,0,0
20150528,2160,2160,,,,2160,2160,0,0,0,0
20150529,2160,2160,,,,2160,2160,0,0,0,0
20150601,2160,2160,,,,2160,2160,0,0,0,0
20150602,2160,2160,,,,2160,2160,0,0,0,0
20150603,2160,2160,,,,2160,2160,0,0,0,0
20150604,2160,2160,,,,2160,2160,0,0,0,0
20150605,2160,2160,,,,2160,2160,0,0,0,0
20150608,2160,2160,,,,2160,2160,0,0,0,0
20150609,2160,2160,,,,2160,2160,0,0,0,0
20150610,2160,2160,,,,2160,2160,0,0,0,0
20150611,2160,2160,,,,2160,2160,0,0,0,0
20150612,2160,2160,,,,2160,2160,0,0,0,0
20150615,2160,2160,,,,2160,2160,0,0,0,0
hc1507,20150105,3024,3024,,,,2998,2998,-26,-26,0,2
20150106,2998,2998,,,,3036,3036,38,38,0,2
20150107,3036,3036,,,,3002,3002,-34,-34,0,2
20150108,3002,3002,,,,2986,2986,-16,-16,0,2
20150109,2986,2986,,,,2940,2940,-46,-46,0,2
20150112,2940,2940,,,,2876,2876,-64,-64,0,2
20150113,2876,2876,,,,2820,2820,-56,-56,0,2
20150114,2820,2820,,,,2764,2764,-56,-56,0,2
20150115,2764,2764,,,,2756,2756,-8,-8,0,2
20150116,2756,2756,,,,2758,2758,2,2,0,2
20150119,2758,2758,,,,2746,2746,-12,-12,0,2
20150120,2746,2746,,,,2732,2732,-14,-14,0,2
20150121,2732,2732,,,,2728,2728,-4,-4,0,2
20150122,2728,2728,,,,2720,2720,-8,-8,0,2
20150123,2720,2720,,,,2702,2702,-18,-18,0,2
20150126,2702,2702,,,,2658,2658,-44,-44,0,2
20150127,2658,2658,,,,2658,2658,0,0,0,2
20150128,2658,2658,,,,2686,2686,28,28,0,2
20150129,2686,2686,,,,2704,2704,18,18,0,2
20150130,2704,2704,,,,2708,2708,4,4,0,2
20150202,2708,2708,,,,2708,2708,0,0,0,2
20150203,2708,2708,,,,2692,2692,-16,-16,0,2
20150204,2692,2692,,,,2686,2686,-6,-6,0,2
20150205,2686,2686,,,,2676,2676,-10,-10,0,2
20150206,2676,2676,,,,2682,2682,6,6,0,2
20150209,2682,2682,,,,2676,2676,-6,-6,0,2
20150210,2676,2676,,,,2680,2680,4,4,0,2
20150211,2680,2680,,,,2690,2690,10,10,0,2
20150212,2690,2690,,,,2690,2690,0,0,0,2
20150213,2690,2690,,,,2708,2708,18,18,0,2
20150216,2708,2708,,,,2732,2732,24,24,0,2
20150217,2732,2732,,,,2714,2714,-18,-18,0,2
20150225,2714,2714,,,,2690,2690,-24,-24,0,2
20150226,2690,2690,,,,2758,2758,68,68,0,2
20150227,2758,2758,,,,2722,2722,-36,-36,0,2
20150302,2722,2722,,,,2706,2706,-16,-16,0,2
20150303,2706,2706,,,,2710,2710,4,4,0,2
20150304,2710,2710,,,,2708,2708,-2,-2,0,2
20150305,2708,2708,,,,2688,2688,-20,-20,0,2
20150306,2688,2688,,,,2676,2676,-12,-12,0,2
20150309,2676,2676,,,,2654,2654,-22,-22,0,2
20150310,2654,2654,,,,2632,2632,-22,-22,0,2
20150311,2632,2632,,,,2610,2610,-22,-22,0,2
20150312,2610,2610,,,,2624,2624,14,14,0,2
20150313,2624,2624,,,,2630,2630,6,6,0,2
20150316,2630,2630,,,,2630,2630,0,0,0,2
20150317,2630,2630,,,,2646,2646,16,16,0,2
20150318,2646,2646,,,,2634,2634,-12,-12,0,2
20150319,2634,2634,,,,2628,2628,-6,-6,0,2
20150320,2628,2628,,,,2632,2632,4,4,0,2
20150323,2632,2632,,,,2646,2646,14,14,0,2
20150324,2646,2646,,,,2600,2600,-46,-46,0,2
20150325,2600,2600,,,,2586,2586,-14,-14,0,2
20150326,2586,2586,,,,2566,2566,-20,-20,0,2
20150327,2566,2566,,,,2528,2528,-38,-38,0,2
20150330,2528,2528,,,,2532,2532,4,4,0,2
20150331,2532,2532,,,,2522,2522,-10,-10,0,2
20150401,2522,2522,,,,2504,2504,-18,-18,0,2
20150402,2504,2504,,,,2464,2464,-40,-40,0,2
20150403,2464,2464,,,,2446,2446,-18,-18,0,2
20150407,2446,2446,,,,2414,2414,-32,-32,0,2
20150408,2414,2414,,,,2376,2376,-38,-38,0,2
20150409,2376,2376,,,,2364,2364,-12,-12,0,2
20150410,2364,2364,,,,2324,2324,-40,-40,0,2
20150413,2324,2324,,,,2348,2348,24,24,0,2
20150414,2348,2348,,,,2366,2366,18,18,0,2
20150415,2366,2366,,,,2360,2360,-6,-6,0,2
20150416,2360,2360,,,,2352,2352,-8,-8,0,2
20150417,2352,2352,,,,2364,2364,12,12,0,2
20150420,2364,2364,,,,2280,2280,-84,-84,0,2
20150421,2280,2280,,,,2264,2264,-16,-16,0,2
20150422,2264,2264,,,,2282,2282,18,18,0,2
20150423,2282,2282,,,,2314,2314,32,32,0,2
20150424,2314,2314,,,,2344,2344,30,30,0,2
20150427,2344,2344,,,,2368,2368,24,24,0,2
20150428,2368,2368,,,,2391,2391,23,23,0,2
20150429,2391,2391,,,,2372,2372,-19,-19,0,2
20150430,2372,2372,,,,2333,2333,-39,-39,0,2
20150504,2333,2333,,,,2424,2424,91,91,0,2
20150505,2424,2424,,,,2448,2448,24,24,0,2
20150506,2448,2448,,,,2448,2448,0,0,0,2
20150507,2448,2448,,,,2413,2413,-35,-35,0,2
20150508,2413,2413,,,,2371,2371,-42,-42,0,2
20150511,2371,2371,2392,2485,2392,2485,2428,114,57,34,4
20150512,2485,2428,,,,2310,2310,-118,-118,0,4
20150513,2310,2310,2425,2425,2425,2425,2425,115,115,2,2
20150514,2425,2425,,,,2425,2425,0,0,0,2
20150515,2425,2425,,,,2424,2424,-1,-1,0,2
20150518,2424,2424,,,,2302,2302,-122,-122,0,2
20150519,2302,2302,,,,2186,2186,-116,-116,0,2
20150520,2186,2186,,,,2186,2186,0,0,0,2
20150521,2186,2186,,,,2186,2186,0,0,0,2
20150522,2186,2186,,,,2186,2186,0,0,0,2
20150525,2186,2186,,,,2186,2186,0,0,0,2
20150526,2186,2186,,,,2186,2186,0,0,0,2
20150527,2186,2186,,,,2186,2186,0,0,0,2
20150528,2186,2186,,,,2186,2186,0,0,0,2
20150529,2186,2186,,,,2186,2186,0,0,0,2
20150601,2186,2186,2290,2293,2290,2293,2291,107,105,4,2
20150602,2293,2291,,,,2291,2291,0,0,0,2
20150603,2291,2291,,,,2291,2291,0,0,0,2
20150604,2291,2291,,,,2291,2291,0,0,0,2
20150605,2291,2291,,,,2291,2291,0,0,0,2
20150608,2291,2291,,,,2291,2291,0,0,0,2
20150609,2291,2291,,,,2291,2291,0,0,0,2
20150610,2291,2291,,,,2291,2291,0,0,0,2
20150611,2291,2291,,,,2291,2291,0,0,0,2
20150612,2291,2291,,,,2291,2291,0,0,0,2
20150615,2291,2291,,,,2291,2291,0,0,0,2
20150616,2291,2291,,,,2291,2291,0,0,0,2
20150617,2291,2291,,,,2291,2291,0,0,0,2
20150618,2291,2291,,,,2291,2291,0,0,0,2
20150619,2291,2291,2405,2405,2350,2350,2377,59,86,4,2
20150623,2350,2377,,,,2377,2377,0,0,0,2
20150624,2377,2377,,,,2377,2377,0,0,0,2
20150625,2377,2377,,,,2377,2377,0,0,0,2
20150626,2377,2377,,,,2377,2377,0,0,0,2
20150629,2377,2377,,,,2377,2377,0,0,0,2
20150630,2377,2377,2259,2259,2258,2258,2258,-119,-119,6,0
20150701,2258,2258,,,,2258,2258,0,0,0,0
20150702,2258,2258,,,,2258,2258,0,0,0,0
20150703,2258,2258,,,,2258,2258,0,0,0,0
20150706,2258,2258,,,,2258,2258,0,0,0,0
20150707,2258,2258,,,,2258,2258,0,0,0,0
20150708,2258,2258,,,,2258,2258,0,0,0,0
20150709,2258,2258,,,,2258,2258,0,0,0,0
20150710,2258,2258,,,,2258,2258,0,0,0,0
20150713,2258,2258,,,,2258,2258,0,0,0,0
20150714,2258,2258,,,,2258,2258,0,0,0,0
20150715,2258,2258,,,,2258,2258,0,0,0,0
hc1508,20150105,3004,3004,,,,3004,3004,0,0,0,0
20150106,3004,3004,,,,3004,3004,0,0,0,0
20150107,3004,3004,,,,3004,3004,0,0,0,0
20150108,3004,3004,,,,3004,3004,0,0,0,0
20150109,3004,3004,,,,3004,3004,0,0,0,0
20150112,3004,3004,,,,3004,3004,0,0,0,0
20150113,3004,3004,,,,3004,3004,0,0,0,0
20150114,3004,3004,2762,2762,2762,2762,2762,-242,-242,2,2
20150115,2762,2762,,,,2754,2754,-8,-8,0,2
20150116,2754,2754,,,,2756,2756,2,2,0,2
20150119,2756,2756,,,,2744,2744,-12,-12,0,2
20150120,2744,2744,,,,2730,2730,-14,-14,0,2
20150121,2730,2730,,,,2726,2726,-4,-4,0,2
20150122,2726,2726,,,,2718,2718,-8,-8,0,2
20150123,2718,2718,,,,2700,2700,-18,-18,0,2
20150126,2700,2700,,,,2656,2656,-44,-44,0,2
20150127,2656,2656,,,,2636,2636,-20,-20,0,2
20150128,2636,2636,,,,2664,2664,28,28,0,2
20150129,2664,2664,,,,2682,2682,18,18,0,2
20150130,2682,2682,,,,2686,2686,4,4,0,2
20150202,2686,2686,,,,2686,2686,0,0,0,2
20150203,2686,2686,,,,2670,2670,-16,-16,0,2
20150204,2670,2670,,,,2664,2664,-6,-6,0,2
20150205,2664,2664,,,,2654,2654,-10,-10,0,2
20150206,2654,2654,,,,2660,2660,6,6,0,2
20150209,2660,2660,,,,2654,2654,-6,-6,0,2
20150210,2654,2654,,,,2658,2658,4,4,0,2
20150211,2658,2658,,,,2668,2668,10,10,0,2
20150212,2668,2668,,,,2668,2668,0,0,0,2
20150213,2668,2668,,,,2686,2686,18,18,0,2
20150216,2686,2686,,,,2710,2710,24,24,0,2
20150217,2710,2710,,,,2694,2694,-16,-16,0,2
20150225,2694,2694,,,,2670,2670,-24,-24,0,2
20150226,2670,2670,,,,2738,2738,68,68,0,2
20150227,2738,2738,,,,2702,2702,-36,-36,0,2
20150302,2702,2702,,,,2688,2688,-14,-14,0,2
20150303,2688,2688,,,,2692,2692,4,4,0,2
20150304,2692,2692,,,,2690,2690,-2,-2,0,2
20150305,2690,2690,,,,2670,2670,-20,-20,0,2
20150306,2670,2670,,,,2658,2658,-12,-12,0,2
20150309,2658,2658,,,,2636,2636,-22,-22,0,2
20150310,2636,2636,,,,2614,2614,-22,-22,0,2
20150311,2614,2614,,,,2594,2594,-20,-20,0,2
20150312,2594,2594,,,,2608,2608,14,14,0,2
20150313,2608,2608,,,,2614,2614,6,6,0,2
20150316,2614,2614,,,,2614,2614,0,0,0,2
20150317,2614,2614,,,,2630,2630,16,16,0,2
20150318,2630,2630,,,,2618,2618,-12,-12,0,2
20150319,2618,2618,,,,2612,2612,-6,-6,0,2
20150320,2612,2612,,,,2616,2616,4,4,0,2
20150323,2616,2616,,,,2630,2630,14,14,0,2
20150324,2630,2630,,,,2584,2584,-46,-46,0,2
20150325,2584,2584,,,,2570,2570,-14,-14,0,2
20150326,2570,2570,2636,2636,2500,2500,2568,-70,-2,4,4
20150327,2500,2568,,,,2530,2530,-38,-38,0,4
20150330,2530,2530,,,,2530,2530,0,0,0,4
20150331,2530,2530,,,,2520,2520,-10,-10,0,4
20150401,2520,2520,,,,2502,2502,-18,-18,0,4
20150402,2502,2502,,,,2462,2462,-40,-40,0,4
20150403,2462,2462,,,,2444,2444,-18,-18,0,4
20150407,2444,2444,,,,2412,2412,-32,-32,0,4
20150408,2412,2412,2390,2390,2390,2390,2390,-22,-22,2,2
20150409,2390,2390,,,,2378,2378,-12,-12,0,2
20150410,2378,2378,,,,2338,2338,-40,-40,0,2
20150413,2338,2338,,,,2362,2362,24,24,0,2
20150414,2362,2362,,,,2380,2380,18,18,0,2
20150415,2380,2380,,,,2374,2374,-6,-6,0,2
20150416,2374,2374,,,,2366,2366,-8,-8,0,2
20150417,2366,2366,,,,2378,2378,12,12,0,2
20150420,2378,2378,,,,2294,2294,-84,-84,0,2
20150421,2294,2294,,,,2278,2278,-16,-16,0,2
20150422,2278,2278,,,,2296,2296,18,18,0,2
20150423,2296,2296,,,,2328,2328,32,32,0,2
20150424,2328,2328,,,,2358,2358,30,30,0,2
20150427,2358,2358,2474,2474,2474,2474,2474,116,116,2,0
20150428,2474,2474,2424,2584,2424,2471,2461,-3,-13,56,0
20150429,2471,2461,,,,2442,2442,-19,-19,0,0
20150430,2442,2442,,,,2402,2402,-40,-40,0,0
20150504,2402,2402,,,,2496,2496,94,94,0,0
20150505,2496,2496,2615,2615,2467,2467,2541,-29,45,4,4
20150506,2467,2541,2620,2620,2456,2515,2530,-26,-11,6,4
20150507,2515,2530,,,,2493,2493,-37,-37,0,4
20150508,2493,2493,,,,2450,2450,-43,-43,0,4
20150511,2450,2450,,,,2509,2509,59,59,0,4
20150512,2509,2509,,,,2387,2387,-122,-122,0,4
20150513,2387,2387,,,,2505,2505,118,118,0,4
20150514,2505,2505,,,,2505,2505,0,0,0,4
20150515,2505,2505,,,,2504,2504,-1,-1,0,4
20150518,2504,2504,,,,2378,2378,-126,-126,0,4
20150519,2378,2378,2315,2315,2315,2315,2315,-63,-63,2,4
20150520,2315,2315,,,,2315,2315,0,0,0,4
20150521,2315,2315,,,,2315,2315,0,0,0,4
20150522,2315,2315,,,,2315,2315,0,0,0,4
20150525,2315,2315,,,,2315,2315,0,0,0,4
20150526,2315,2315,,,,2315,2315,0,0,0,4
20150527,2315,2315,,,,2315,2315,0,0,0,4
20150528,2315,2315,,,,2315,2315,0,0,0,4
20150529,2315,2315,,,,2315,2315,0,0,0,4
20150601,2315,2315,,,,2426,2426,111,111,0,4
20150602,2426,2426,,,,2426,2426,0,0,0,4
20150603,2426,2426,,,,2426,2426,0,0,0,4
20150604,2426,2426,,,,2426,2426,0,0,0,4
20150605,2426,2426,,,,2426,2426,0,0,0,4
20150608,2426,2426,,,,2426,2426,0,0,0,4
20150609,2426,2426,,,,2426,2426,0,0,0,4
20150610,2426,2426,,,,2426,2426,0,0,0,4
20150611,2426,2426,,,,2426,2426,0,0,0,4
20150612,2426,2426,,,,2426,2426,0,0,0,4
20150615,2426,2426,,,,2426,2426,0,0,0,4
20150616,2426,2426,,,,2426,2426,0,0,0,4
20150617,2426,2426,,,,2426,2426,0,0,0,4
20150618,2426,2426,,,,2426,2426,0,0,0,4
20150619,2426,2426,,,,2517,2517,91,91,0,4
20150623,2517,2517,2516,2516,2516,2516,2516,-1,-1,2,2
20150624,2516,2516,,,,2516,2516,0,0,0,2
20150625,2516,2516,,,,2516,2516,0,0,0,2
20150626,2516,2516,,,,2516,2516,0,0,0,2
20150629,2516,2516,,,,2516,2516,0,0,0,2
20150630,2516,2516,2391,2500,2390,2390,2420,-126,-96,12,6
20150701,2390,2420,,,,2420,2420,0,0,0,6
20150702,2420,2420,,,,2299,2299,-121,-121,0,6
20150703,2299,2299,,,,2299,2299,0,0,0,6
20150706,2299,2299,2410,2410,2379,2379,2394,80,95,4,8
20150707,2379,2394,2274,2274,2274,2274,2274,-120,-120,2,8
20150708,2274,2274,2092,2092,2092,2092,2092,-182,-182,2,8
20150709,2092,2092,2196,2196,2196,2196,2196,104,104,2,6
20150710,2196,2196,,,,2196,2196,0,0,0,6
20150713,2196,2196,,,,2196,2196,0,0,0,6
20150714,2196,2196,,,,2196,2196,0,0,0,6
20150715,2196,2196,,,,2196,2196,0,0,0,6
20150716,2196,2196,,,,2196,2196,0,0,0,6
20150717,2196,2196,2086,2086,2086,2086,2086,-110,-110,4,2
20150720,2086,2086,,,,2086,2086,0,0,0,2
20150721,2086,2086,,,,2086,2086,0,0,0,2
20150722,2086,2086,,,,2086,2086,0,0,0,2
20150723,2086,2086,,,,2086,2086,0,0,0,2
20150724,2086,2086,,,,2086,2086,0,0,0,2
20150727,2086,2086,,,,2086,2086,0,0,0,2
20150728,2086,2086,,,,2086,2086,0,0,0,2
20150729,2086,2086,,,,2086,2086,0,0,0,2
20150730,2086,2086,1981,2190,1981,2190,2085,104,-1,4,2
20150731,2190,2085,1980,1980,1980,1980,1980,-105,-105,2,0
20150803,1980,1980,,,,1980,1980,0,0,0,0
20150804,1980,1980,,,,1980,1980,0,0,0,0
20150805,1980,1980,,,,1980,1980,0,0,0,0
20150806,1980,1980,,,,1980,1980,0,0,0,0
20150807,1980,1980,,,,1980,1980,0,0,0,0
20150810,1980,1980,,,,1980,1980,0,0,0,0
20150811,1980,1980,,,,1980,1980,0,0,0,0
20150812,1980,1980,,,,1980,1980,0,0,0,0
20150813,1980,1980,,,,1980,1980,0,0,0,0
20150814,1980,1980,,,,1980,1980,0,0,0,0
20150817,1980,1980,,,,1980,1980,0,0,0,0
hc1509,20150105,3012,3012,,,,3012,3012,0,0,0,0
20150106,3012,3012,,,,3012,3012,0,0,0,0
20150107,3012,3012,,,,3012,3012,0,0,0,0
20150108,3012,3012,,,,3012,3012,0,0,0,0
20150109,3012,3012,,,,3012,3012,0,0,0,0
20150112,3012,3012,,,,3012,3012,0,0,0,0
20150113,3012,3012,,,,3012,3012,0,0,0,0
20150114,3012,3012,2770,2770,2770,2770,2770,-242,-242,4,4
20150115,2770,2770,2802,2814,2752,2752,2796,-18,26,16,16
20150116,2752,2796,2786,2786,2686,2686,2760,-110,-36,8,20
20150119,2686,2760,2652,2754,2652,2754,2662,-6,-98,20,4
20150120,2754,2662,,,,2648,2648,-14,-14,0,4
20150121,2648,2648,,,,2644,2644,-4,-4,0,4
20150122,2644,2644,,,,2636,2636,-8,-8,0,4
20150123,2636,2636,,,,2618,2618,-18,-18,0,4
20150126,2618,2618,,,,2574,2574,-44,-44,0,4
20150127,2574,2574,,,,2574,2574,0,0,0,4
20150128,2574,2574,,,,2600,2600,26,26,0,4
20150129,2600,2600,,,,2616,2616,16,16,0,4
20150130,2616,2616,2618,2676,2600,2630,2636,14,20,18,10
20150202,2630,2636,2738,2738,2648,2648,2670,12,34,10,8
20150203,2648,2670,2620,2634,2620,2634,2622,-36,-48,8,2
20150204,2634,2622,,,,2622,2622,0,0,0,2
20150205,2622,2622,,,,2622,2622,0,0,0,2
20150206,2622,2622,2622,2622,2622,2622,2622,0,0,2,2
20150209,2622,2622,,,,2622,2622,0,0,0,2
20150210,2622,2622,,,,2622,2622,0,0,0,2
20150211,2622,2622,,,,2622,2622,0,0,0,2
20150212,2622,2622,,,,2622,2622,0,0,0,2
20150213,2622,2622,,,,2622,2622,0,0,0,2
20150216,2622,2622,,,,2644,2644,22,22,0,2
20150217,2644,2644,2696,2696,2650,2650,2672,6,28,4,2
20150225,2650,2672,,,,2672,2672,0,0,0,2
20150226,2672,2672,2700,2700,2594,2626,2644,-46,-28,10,2
20150227,2626,2644,2672,2676,2618,2618,2646,-26,2,12,2
20150302,2618,2646,2680,2680,2680,2680,2680,34,34,4,6
20150303,2680,2680,2672,2672,2642,2642,2656,-38,-24,4,4
20150304,2642,2656,,,,2656,2656,0,0,0,4
20150305,2656,2656,2622,2622,2622,2622,2622,-34,-34,2,2
20150306,2622,2622,,,,2622,2622,0,0,0,2
20150309,2622,2622,2514,2524,2508,2522,2516,-100,-106,100,100
20150310,2522,2516,,,,2528,2528,12,12,0,100
20150311,2528,2528,,,,2528,2528,0,0,0,100
20150312,2528,2528,,,,2528,2528,0,0,0,100
20150313,2528,2528,2580,2608,2510,2572,2552,44,24,14,102
20150316,2572,2552,,,,2552,2552,0,0,0,102
20150317,2552,2552,2618,2618,2618,2618,2618,66,66,2,100
20150318,2618,2618,2656,2656,2520,2520,2580,-98,-38,80,102
20150319,2520,2580,2544,2568,2544,2568,2556,-12,-24,4,100
20150320,2568,2556,,,,2556,2556,0,0,0,100
20150323,2556,2556,,,,2556,2556,0,0,0,100
20150324,2556,2556,,,,2556,2556,0,0,0,100
20150325,2556,2556,2560,2646,2544,2552,2576,-4,20,32,100
20150326,2552,2576,,,,2576,2576,0,0,0,100
20150327,2576,2576,2594,2594,2486,2486,2536,-90,-40,8,100
20150330,2486,2536,2542,2542,2542,2542,2542,6,6,2,100
20150331,2542,2542,2560,2560,2560,2560,2560,18,18,2,100
20150401,2560,2560,2504,2508,2472,2472,2488,-88,-72,48,100
20150402,2472,2488,2440,2460,2438,2460,2446,-28,-42,6,100
20150403,2460,2446,2442,2444,2420,2420,2434,-26,-12,6,100
20150407,2420,2434,,,,2406,2406,-28,-28,0,100
20150408,2406,2406,2376,2410,2296,2368,2364,-38,-42,132,100
20150409,2368,2364,2290,2290,2290,2290,2290,-74,-74,2,100
20150410,2290,2290,2360,2374,2290,2336,2336,46,46,22,100
20150413,2336,2336,2338,2408,2312,2388,2356,52,20,122,100
20150414,2388,2356,2356,2400,2328,2400,2360,44,4,6,100
20150415,2400,2360,2372,2372,2362,2362,2366,2,6,10,100
20150416,2362,2366,2340,2372,2336,2364,2350,-2,-16,30,100
20150417,2364,2350,2346,2362,2344,2352,2352,2,2,14,100
20150420,2352,2352,2304,2350,2304,2330,2326,-22,-26,30,100
20150421,2330,2326,2334,2418,2310,2328,2338,2,12,46,102
20150422,2328,2338,2352,2370,2320,2370,2344,32,6,22,108
20150423,2370,2344,2382,2454,2366,2384,2378,40,34,68,108
20150424,2384,2378,2402,2450,2402,2450,2434,72,56,18,102
20150427,2450,2434,2468,2504,2426,2482,2468,48,34,92,114
20150428,2482,2468,2566,2566,2566,2566,2566,98,98,4,112
20150429,2566,2566,2510,2510,2437,2454,2488,-112,-78,22,108
20150430,2454,2488,2440,2523,2403,2474,2467,-14,-21,26,124
20150504,2474,2467,2520,2520,2520,2520,2520,53,53,2,122
20150505,2520,2520,2552,2552,2540,2540,2548,20,28,36,112
20150506,2540,2548,2560,2560,2471,2529,2524,-19,-24,8,110
20150507,2529,2524,2502,2530,2502,2530,2516,6,-8,4,110
20150508,2530,2516,2470,2479,2415,2415,2460,-101,-56,28,104
20150511,2415,2460,2498,2498,2466,2466,2469,6,9,22,102
20150512,2466,2469,2510,2510,2450,2450,2479,-19,10,20,104
20150513,2450,2479,2478,2478,2442,2466,2462,-13,-17,18,100
20150514,2466,2462,2473,2475,2458,2475,2471,13,9,12,100
20150515,2475,2471,2498,2510,2420,2474,2468,3,-3,38,114
20150518,2474,2468,,,,2468,2468,0,0,0,114
20150519,2468,2468,2470,2470,2467,2467,2469,-1,1,12,116
20150520,2467,2469,2420,2436,2418,2418,2419,-51,-50,24,112
20150521,2418,2419,2475,2475,2333,2475,2427,56,8,6,114
20150522,2475,2427,2389,2389,2389,2389,2389,-38,-38,2,112
20150525,2389,2389,,,,2406,2406,17,17,0,112
20150526,2406,2406,,,,2410,2410,4,4,0,112
20150527,2410,2410,,,,2410,2410,0,0,0,112
20150528,2410,2410,,,,2410,2410,0,0,0,112
20150529,2410,2410,2412,2486,2412,2486,2449,76,39,4,114
20150601,2486,2449,2444,2444,2444,2444,2444,-5,-5,14,106
20150602,2444,2444,2460,2460,2460,2460,2460,16,16,4,106
20150603,2460,2460,2530,2530,2401,2425,2470,-35,10,16,104
20150604,2425,2470,2454,2499,2436,2436,2451,-34,-19,14,104
20150605,2436,2451,2405,2405,2344,2377,2369,-74,-82,26,108
20150608,2377,2369,2371,2410,2370,2377,2394,8,25,24,102
20150609,2377,2394,2414,2414,2409,2409,2411,15,17,4,100
20150610,2409,2411,,,,2410,2410,-1,-1,0,100
20150611,2410,2410,2439,2439,2408,2408,2423,-2,13,4,100
20150612,2408,2423,,,,2423,2423,0,0,0,100
20150615,2423,2423,2371,2371,2371,2371,2371,-52,-52,2,100
20150616,2371,2371,2341,2341,2340,2340,2340,-31,-31,8,100
20150617,2340,2340,2261,2261,2230,2230,2245,-110,-95,8,104
20150618,2230,2245,2311,2357,2268,2272,2300,27,55,14,102
20150619,2272,2300,2288,2300,2288,2300,2294,0,-6,4,102
20150623,2300,2294,,,,2294,2294,0,0,0,102
20150624,2294,2294,,,,2294,2294,0,0,0,102
20150625,2294,2294,2340,2340,2340,2340,2340,46,46,2,100
20150626,2340,2340,2250,2250,2250,2250,2250,-90,-90,2,100
20150629,2250,2250,2273,2273,2213,2230,2251,-20,1,50,100
20150630,2230,2251,2150,2150,2150,2150,2150,-101,-101,4,102
20150701,2150,2150,,,,2151,2151,1,1,0,102
20150702,2151,2151,,,,2151,2151,0,0,0,102
20150703,2151,2151,,,,2151,2151,0,0,0,102
20150706,2151,2151,2099,2099,2099,2099,2099,-52,-52,2,100
20150707,2099,2099,2058,2058,2058,2058,2058,-41,-41,22,78
20150708,2058,2058,1958,1999,1958,1999,1972,-59,-86,6,80
20150709,1999,1972,1975,2069,1975,2068,2047,96,75,30,72
20150710,2068,2047,,,,2047,2047,0,0,0,72
20150713,2047,2047,,,,2047,2047,0,0,0,72
20150714,2047,2047,1949,2038,1949,1953,1980,-94,-67,6,72
20150715,1953,1980,,,,1980,1980,0,0,0,72
20150716,1980,1980,,,,1980,1980,0,0,0,72
20150717,1980,1980,1881,1881,1881,1881,1881,-99,-99,4,72
20150720,1881,1881,,,,1975,1975,94,94,0,72
20150721,1975,1975,2073,2073,2018,2018,2055,43,80,10,74
20150722,2018,2055,1961,2118,1961,2118,2046,63,-9,12,72
20150723,2118,2046,2080,2121,2052,2052,2096,6,50,10,70
20150724,2052,2096,2160,2160,2121,2121,2141,25,45,6,70
20150727,2121,2141,2111,2111,2111,2111,2111,-30,-30,2,70
20150728,2111,2111,,,,2111,2111,0,0,0,70
20150729,2111,2111,,,,2111,2111,0,0,0,70
20150730,2111,2111,,,,2111,2111,0,0,0,70
20150731,2111,2111,,,,2005,2005,-106,-106,0,70
20150803,2005,2005,2100,2100,2100,2100,2100,95,95,4,66
20150804,2100,2100,,,,2100,2100,0,0,0,66
20150805,2100,2100,,,,2110,2110,10,10,0,66
20150806,2110,2110,2100,2198,2090,2110,2139,0,29,12,66
20150807,2110,2139,,,,2139,2139,0,0,0,66
20150810,2139,2139,2098,2098,2098,2098,2098,-41,-41,2,66
20150811,2098,2098,2201,2201,2201,2201,2201,103,103,2,66
20150812,2201,2201,,,,2201,2201,0,0,0,66
20150813,2201,2201,2114,2261,2090,2090,2120,-111,-81,16,74
20150814,2090,2120,2014,2109,2014,2109,2061,-11,-59,4,74
20150817,2109,2061,2072,2092,1957,2032,2037,-29,-24,20,68
20150818,2032,2037,,,,2037,2037,0,0,0,68
20150819,2037,2037,,,,2037,2037,0,0,0,68
20150820,2037,2037,,,,2037,2037,0,0,0,68
20150821,2037,2037,,,,2037,2037,0,0,0,68
20150824,2037,2037,1939,1939,1936,1936,1936,-101,-101,8,74
20150825,1936,1936,1839,1850,1839,1850,1847,-86,-89,10,66
20150826,1850,1847,,,,1871,1871,24,24,0,66
20150827,1871,1871,,,,1871,1871,0,0,0,66
20150828,1871,1871,1925,1925,1925,1925,1925,54,54,6,60
20150831,1925,1925,,,,1925,1925,0,0,0,60
20150901,1925,1925,,,,1925,1925,0,0,0,60
20150902,1925,1925,1915,1915,1915,1915,1915,-10,-10,60,60
20150907,1915,1915,,,,1915,1915,0,0,0,60
20150908,1915,1915,,,,1915,1915,0,0,0,60
20150909,1915,1915,,,,1915,1915,0,0,0,60
20150910,1915,1915,,,,1915,1915,0,0,0,60
20150911,1915,1915,,,,1915,1915,0,0,0,60
20150914,1915,1915,,,,1915,1915,0,0,0,60
20150915,1915,1915,,,,1915,1915,0,0,0,60
hc1510,20150105,2936,2936,,,,2912,2912,-24,-24,0,2
20150106,2912,2912,,,,2948,2948,36,36,0,2
20150107,2948,2948,,,,2916,2916,-32,-32,0,2
20150108,2916,2916,,,,2900,2900,-16,-16,0,2
20150109,2900,2900,2976,2976,2798,2798,2886,-102,-14,4,4
20150112,2798,2886,,,,2822,2822,-64,-64,0,4
20150113,2822,2822,2710,2796,2710,2734,2746,-88,-76,6,2
20150114,2734,2746,,,,2746,2746,0,0,0,2
20150115,2746,2746,,,,2772,2772,26,26,0,2
20150116,2772,2772,,,,2736,2736,-36,-36,0,2
20150119,2736,2736,,,,2736,2736,0,0,0,2
20150120,2736,2736,2760,2760,2760,2760,2760,24,24,2,0
20150121,2760,2760,,,,2756,2756,-4,-4,0,0
20150122,2756,2756,,,,2748,2748,-8,-8,0,0
20150123,2748,2748,,,,2730,2730,-18,-18,0,0
20150126,2730,2730,,,,2684,2684,-46,-46,0,0
20150127,2684,2684,,,,2684,2684,0,0,0,0
20150128,2684,2684,,,,2712,2712,28,28,0,0
20150129,2712,2712,,,,2712,2712,0,0,0,0
20150130,2712,2712,,,,2712,2712,0,0,0,0
20150202,2712,2712,,,,2712,2712,0,0,0,0
20150203,2712,2712,,,,2664,2664,-48,-48,0,0
20150204,2664,2664,,,,2664,2664,0,0,0,0
20150205,2664,2664,,,,2654,2654,-10,-10,0,0
20150206,2654,2654,,,,2654,2654,0,0,0,0
20150209,2654,2654,,,,2648,2648,-6,-6,0,0
20150210,2648,2648,,,,2648,2648,0,0,0,0
20150211,2648,2648,2608,2608,2608,2608,2608,-40,-40,2,2
20150212,2608,2608,2670,2670,2670,2670,2670,62,62,2,2
20150213,2670,2670,,,,2670,2670,0,0,0,2
20150216,2670,2670,,,,2670,2670,0,0,0,2
20150217,2670,2670,,,,2670,2670,0,0,0,2
20150225,2670,2670,,,,2646,2646,-24,-24,0,2
20150226,2646,2646,,,,2646,2646,0,0,0,2
20150227,2646,2646,,,,2646,2646,0,0,0,2
20150302,2646,2646,2646,2646,2646,2646,2646,0,0,2,4
20150303,2646,2646,,,,2646,2646,0,0,0,4
20150304,2646,2646,2592,2690,2590,2690,2632,44,-14,142,86
20150305,2690,2632,2660,2676,2640,2640,2650,8,18,84,94
20150306,2640,2650,2650,2656,2614,2614,2638,-36,-12,16,94
20150309,2614,2638,2604,2638,2594,2612,2608,-26,-30,120,184
20150310,2612,2608,2610,2610,2572,2584,2600,-24,-8,372,468
20150311,2584,2600,2526,2572,2526,2564,2560,-36,-40,304,494
20150312,2564,2560,2570,2592,2554,2586,2572,26,12,234,574
20150313,2586,2572,2582,2602,2560,2568,2568,-4,-4,1804,1534
20150316,2568,2568,2568,2600,2558,2594,2584,26,16,1448,2358
20150317,2594,2584,2600,2602,2582,2590,2590,6,6,288,2384
20150318,2590,2590,2590,2596,2558,2570,2582,-20,-8,1352,2890
20150319,2570,2582,2556,2580,2556,2566,2568,-16,-14,458,2920
20150320,2566,2568,2558,2570,2552,2560,2562,-8,-6,1206,3408
20150323,2560,2562,2576,2600,2554,2590,2586,28,24,5404,7148
20150324,2590,2586,2596,2622,2592,2598,2606,12,20,3366,8518
20150325,2598,2606,2602,2606,2578,2586,2590,-20,-16,3794,9912
20150326,2586,2590,2580,2588,2572,2574,2578,-16,-12,2500,11090
20150327,2574,2578,2570,2574,2500,2552,2538,-26,-40,2810,11064
20150330,2552,2538,2546,2560,2526,2532,2540,-6,2,1742,11692
20150331,2532,2540,2540,2548,2518,2522,2528,-18,-12,2404,11942
20150401,2522,2528,2524,2528,2482,2494,2502,-34,-26,5676,10954
20150402,2494,2502,2480,2484,2446,2450,2458,-52,-44,9396,14348
20150403,2450,2458,2448,2468,2430,2432,2444,-26,-14,4478,15316
20150407,2432,2444,2430,2436,2376,2376,2394,-68,-50,13406,21928
20150408,2376,2394,2376,2404,2354,2392,2374,-2,-20,9706,22790
20150409,2392,2374,2382,2388,2358,2362,2370,-12,-4,4618,22972
20150410,2362,2370,2362,2366,2344,2346,2354,-24,-16,5278,22758
20150413,2346,2354,2346,2420,2344,2412,2378,58,24,8930,23238
20150414,2412,2378,2412,2424,2390,2406,2404,28,26,8230,23888
20150415,2406,2404,2408,2414,2380,2382,2398,-22,-6,7002,23954
20150416,2382,2398,2372,2410,2372,2396,2394,-2,-4,7012,23922
20150417,2396,2394,2398,2414,2390,2396,2400,2,6,6458,25024
20150420,2396,2400,2390,2394,2364,2366,2378,-34,-22,10158,23054
20150421,2366,2378,2364,2376,2356,2372,2366,-6,-12,5278,23038
20150422,2372,2366,2376,2430,2370,2422,2402,56,36,10954,22792
20150423,2422,2402,2424,2436,2408,2434,2424,32,22,15212,22382
20150424,2434,2424,2434,2496,2434,2490,2466,66,42,29142,26170
20150427,2490,2466,2500,2516,2476,2510,2496,44,30,14874,26244
20150428,2510,2496,2512,2532,2492,2498,2513,2,17,19506,27638
20150429,2498,2513,2497,2519,2446,2460,2487,-53,-26,17196,27710
20150430,2460,2487,2460,2492,2454,2487,2478,0,-9,9826,27246
20150504,2487,2478,2493,2545,2486,2532,2521,54,43,17728,29616
20150505,2532,2521,2531,2597,2528,2561,2551,40,30,25924,30904
20150506,2561,2551,2561,2567,2530,2535,2544,-16,-7,21672,35384
20150507,2535,2544,2535,2542,2491,2495,2510,-49,-34,18810,34228
20150508,2495,2510,2496,2510,2470,2504,2491,-6,-19,25350,35700
20150511,2504,2491,2498,2522,2497,2515,2510,24,19,13742,36964
20150512,2515,2510,2510,2522,2485,2486,2500,-24,-10,10898,36680
20150513,2486,2500,2490,2506,2481,2487,2493,-13,-7,12658,37984
20150514,2487,2493,2487,2492,2452,2471,2467,-22,-26,17216,38184
20150515,2471,2467,2470,2477,2460,2471,2469,4,2,10176,40116
20150518,2471,2469,2470,2482,2458,2458,2469,-11,0,7740,41898
20150519,2458,2469,2452,2455,2434,2443,2446,-26,-23,8968,41932
20150520,2443,2446,2435,2443,2407,2412,2420,-34,-26,8984,39894
20150521,2412,2420,2417,2448,2412,2439,2430,19,10,9064,41092
20150522,2439,2430,2440,2475,2427,2454,2443,24,13,8390,41600
20150525,2454,2443,2441,2465,2425,2455,2448,12,5,7734,40658
20150526,2455,2448,2453,2490,2441,2464,2472,16,24,12846,40126
20150527,2464,2472,2466,2475,2454,2470,2465,-2,-7,5382,39786
20150528,2470,2465,2456,2481,2443,2460,2464,-5,-1,8066,39306
20150529,2460,2464,2458,2469,2436,2460,2455,-4,-9,7106,38632
20150601,2460,2455,2463,2497,2457,2482,2471,27,16,10504,38122
20150602,2482,2471,2478,2489,2467,2478,2477,7,6,8700,38362
20150603,2478,2477,2477,2481,2460,2460,2471,-17,-6,7776,36130
20150604,2460,2471,2451,2463,2447,2459,2454,-12,-17,6344,35220
20150605,2459,2454,2462,2466,2432,2448,2447,-6,-7,7982,32422
20150608,2448,2447,2447,2447,2431,2440,2438,-7,-9,4472,32886
20150609,2440,2438,2436,2460,2436,2449,2449,11,11,4950,33008
20150610,2449,2449,2447,2462,2445,2460,2451,11,2,4838,33322
20150611,2460,2451,2462,2473,2458,2463,2465,12,14,6904,33934
20150612,2463,2465,2461,2465,2392,2401,2427,-64,-38,12314,34146
20150615,2401,2427,2391,2416,2380,2383,2396,-44,-31,6712,33844
20150616,2383,2396,2377,2390,2346,2348,2369,-48,-27,8488,32560
20150617,2348,2369,2346,2353,2315,2319,2328,-50,-41,26048,37972
20150618,2319,2328,2327,2345,2320,2336,2333,8,5,10252,38888
20150619,2336,2333,2335,2360,2330,2342,2347,9,14,8548,37546
20150623,2342,2347,2350,2350,2310,2329,2328,-18,-19,6732,38934
20150624,2329,2328,2333,2339,2323,2333,2331,5,3,7172,40556
20150625,2333,2331,2335,2336,2294,2296,2313,-35,-18,14946,44814
20150626,2296,2313,2280,2312,2280,2288,2297,-25,-16,18380,48218
20150629,2288,2297,2290,2301,2264,2269,2281,-28,-16,11526,45588
20150630,2269,2281,2267,2267,2180,2220,2219,-61,-62,32072,42196
20150701,2220,2219,2215,2223,2202,2204,2211,-15,-8,11004,42258
20150702,2204,2211,2192,2206,2176,2197,2190,-14,-21,16658,40706
20150703,2197,2190,2199,2235,2192,2207,2215,17,25,16306,38692
20150706,2207,2215,2204,2207,2104,2109,2146,-106,-69,27222,39346
20150707,2109,2146,2109,2111,2038,2041,2077,-105,-69,36072,36060
20150708,2041,2077,2041,2089,1973,1973,2015,-104,-62,34314,34010
20150709,1973,2015,1860,2139,1860,2063,2046,48,31,39112,33956
20150710,2063,2046,2072,2112,2055,2065,2086,19,40,17354,36334
20150713,2065,2086,2042,2078,2004,2030,2045,-56,-41,18590,35944
20150714,2030,2045,2040,2055,2015,2032,2037,-13,-8,16060,37046
20150715,2032,2037,2036,2044,2010,2015,2025,-22,-12,11732,36010
20150716,2015,2025,2015,2055,1993,2022,2021,-3,-4,29020,32442
20150717,2022,2021,2023,2034,2015,2030,2025,9,4,8468,31608
20150720,2030,2025,2030,2108,2011,2100,2065,75,40,25466,29970
20150721,2100,2065,2118,2118,2053,2063,2085,-2,20,15530,29812
20150722,2063,2085,2065,2077,2004,2030,2042,-55,-43,14976,29288
20150723,2030,2042,2026,2043,2011,2036,2028,-6,-14,9056,28482
20150724,2036,2028,2035,2049,2023,2028,2034,0,6,6280,27888
20150727,2028,2034,2033,2068,2031,2046,2049,12,15,10396,27426
20150728,2046,2049,2043,2064,2030,2050,2045,1,-4,11550,26998
20150729,2050,2045,2054,2075,2050,2064,2062,19,17,12436,28912
20150730,2064,2062,2063,2074,2016,2039,2051,-23,-11,12444,29442
20150731,2039,2051,2038,2052,2027,2050,2040,-1,-11,9674,29808
20150803,2050,2040,2059,2089,2049,2062,2068,22,28,11774,28166
20150804,2062,2068,2062,2086,2050,2072,2068,4,0,7592,28454
20150805,2072,2068,2080,2084,2069,2083,2075,15,7,5148,26450
20150806,2083,2075,2095,2095,2072,2083,2083,8,8,3654,25222
20150807,2083,2083,2072,2084,2069,2079,2076,-4,-7,3640,24688
20150810,2079,2076,2073,2079,2056,2066,2066,-10,-10,4270,24060
20150811,2066,2066,2065,2073,2056,2056,2063,-10,-3,3782,23530
20150812,2056,2063,2046,2062,2042,2062,2056,-1,-7,4510,21530
20150813,2062,2056,2064,2078,2064,2073,2071,17,15,4208,20202
20150814,2073,2071,2073,2078,2065,2076,2071,5,0,2100,19132
20150817,2076,2071,2079,2085,2056,2056,2070,-15,-1,2104,18572
20150818,2056,2070,2057,2063,2056,2062,2060,-8,-10,2040,18068
20150819,2062,2060,2060,2073,2015,2036,2048,-24,-12,3768,16392
20150820,2036,2048,2036,2048,2027,2030,2032,-18,-16,2540,16192
20150821,2030,2032,2030,2038,2022,2022,2028,-10,-4,754,16074
20150824,2022,2028,2015,2026,1926,1926,1972,-102,-56,3728,13894
20150825,1926,1972,1902,1967,1902,1926,1937,-46,-35,1722,13560
20150826,1926,1937,1948,1950,1915,1921,1936,-16,-1,1908,13166
20150827,1921,1936,1905,1930,1905,1927,1921,-9,-15,2778,12284
20150828,1927,1921,1929,1956,1925,1956,1939,35,18,1362,12042
20150831,1956,1939,1943,1946,1913,1931,1930,-8,-9,1350,11660
20150901,1931,1930,1942,1944,1923,1927,1931,-3,1,826,11180
20150902,1927,1931,1927,1937,1921,1927,1927,-4,-4,594,10868
20150907,1927,1927,1940,1956,1916,1916,1923,-11,-4,576,10568
20150908,1916,1923,1920,1922,1902,1920,1915,-3,-8,1526,10368
20150909,1920,1915,1938,1938,1916,1924,1930,9,15,2106,10158
20150910,1924,1930,1927,1930,1920,1925,1924,-5,-6,534,10052
20150911,1925,1924,1926,1927,1902,1919,1923,-5,-1,510,9982
20150914,1919,1923,1924,1938,1895,1895,1905,-28,-18,1744,9400
20150915,1895,1905,1905,1905,1879,1885,1890,-20,-15,1846,9176
20150916,1885,1890,1889,1908,1886,1894,1893,4,3,1246,8946
20150917,1894,1893,1895,1900,1888,1892,1894,-1,1,810,8890
20150918,1892,1894,1896,1897,1872,1894,1888,0,-6,1252,8912
20150921,1894,1888,1895,1895,1872,1879,1882,-9,-6,572,8862
20150922,1879,1882,1889,1889,1860,1876,1874,-6,-8,1966,7708
20150923,1876,1874,1874,1883,1870,1880,1879,6,5,382,7362
20150924,1880,1879,1871,1883,1871,1871,1877,-8,-2,304,7158
20150925,1871,1877,1878,1881,1853,1862,1866,-15,-11,1164,6980
20150928,1862,1866,1782,1852,1782,1839,1840,-27,-26,1744,6186
20150929,1839,1840,1811,1849,1811,1849,1838,9,-2,792,5684
20150930,1849,1838,1847,1877,1767,1767,1815,-71,-23,356,5522
20151008,1767,1815,1887,1887,1850,1850,1857,35,42,302,5280
20151009,1850,1857,1859,1870,1851,1851,1861,-6,4,420,5100
20151012,1851,1861,,,,1861,1861,0,0,0,5100
20151013,1861,1861,,,,1861,1861,0,0,0,5100
20151014,1861,1861,1851,1851,1851,1851,1851,-10,-10,300,5100
20151015,1851,1851,,,,1851,1851,0,0,0,5100
hc1511,20150105,2828,2828,,,,2804,2804,-24,-24,0,0
20150106,2804,2804,,,,2840,2840,36,36,0,0
20150107,2840,2840,,,,2808,2808,-32,-32,0,0
20150108,2808,2808,,,,2792,2792,-16,-16,0,0
20150109,2792,2792,,,,2778,2778,-14,-14,0,0
20150112,2778,2778,,,,2716,2716,-62,-62,0,0
20150113,2716,2716,,,,2716,2716,0,0,0,0
20150114,2716,2716,,,,2716,2716,0,0,0,0
20150115,2716,2716,,,,2742,2742,26,26,0,0
20150116,2742,2742,,,,2706,2706,-36,-36,0,0
20150119,2706,2706,,,,2610,2610,-96,-96,0,0
20150120,2610,2610,,,,2632,2632,22,22,0,0
20150121,2632,2632,,,,2628,2628,-4,-4,0,0
20150122,2628,2628,,,,2620,2620,-8,-8,0,0
20150123,2620,2620,,,,2602,2602,-18,-18,0,0
20150126,2602,2602,,,,2558,2558,-44,-44,0,0
20150127,2558,2558,,,,2558,2558,0,0,0,0
20150128,2558,2558,,,,2584,2584,26,26,0,0
20150129,2584,2584,,,,2584,2584,0,0,0,0
20150130,2584,2584,,,,2584,2584,0,0,0,0
20150202,2584,2584,,,,2584,2584,0,0,0,0
20150203,2584,2584,,,,2538,2538,-46,-46,0,0
20150204,2538,2538,,,,2532,2532,-6,-6,0,0
20150205,2532,2532,,,,2522,2522,-10,-10,0,0
20150206,2522,2522,,,,2522,2522,0,0,0,0
20150209,2522,2522,,,,2552,2552,30,30,0,0
20150210,2552,2552,,,,2560,2560,8,8,0,0
20150211,2560,2560,,,,2520,2520,-40,-40,0,0
20150212,2520,2520,,,,2554,2554,34,34,0,0
20150213,2554,2554,,,,2580,2580,26,26,0,0
20150216,2580,2580,,,,2580,2580,0,0,0,0
20150217,2580,2580,,,,2608,2608,28,28,0,0
20150225,2608,2608,,,,2584,2584,-24,-24,0,0
20150226,2584,2584,,,,2584,2584,0,0,0,0
20150227,2584,2584,,,,2584,2584,0,0,0,0
20150302,2584,2584,,,,2584,2584,0,0,0,0
20150303,2584,2584,,,,2584,2584,0,0,0,0
20150304,2584,2584,,,,2570,2570,-14,-14,0,0
20150305,2570,2570,,,,2570,2570,0,0,0,0
20150306,2570,2570,,,,2570,2570,0,0,0,0
20150309,2570,2570,,,,2570,2570,0,0,0,0
20150310,2570,2570,,,,2570,2570,0,0,0,0
20150311,2570,2570,,,,2570,2570,0,0,0,0
20150312,2570,2570,,,,2570,2570,0,0,0,0
20150313,2570,2570,,,,2570,2570,0,0,0,0
20150316,2570,2570,,,,2570,2570,0,0,0,0
20150317,2570,2570,,,,2570,2570,0,0,0,0
20150318,2570,2570,,,,2570,2570,0,0,0,0
20150319,2570,2570,,,,2570,2570,0,0,0,0
20150320,2570,2570,,,,2570,2570,0,0,0,0
20150323,2570,2570,,,,2570,2570,0,0,0,0
20150324,2570,2570,,,,2570,2570,0,0,0,0
20150325,2570,2570,,,,2570,2570,0,0,0,0
20150326,2570,2570,,,,2570,2570,0,0,0,0
20150327,2570,2570,,,,2570,2570,0,0,0,0
20150330,2570,2570,,,,2570,2570,0,0,0,0
20150331,2570,2570,,,,2570,2570,0,0,0,0
20150401,2570,2570,,,,2570,2570,0,0,0,0
20150402,2570,2570,,,,2548,2548,-22,-22,0,0
20150403,2548,2548,,,,2524,2524,-24,-24,0,0
20150407,2524,2524,,,,2470,2470,-54,-54,0,0
20150408,2470,2470,,,,2470,2470,0,0,0,0
20150409,2470,2470,,,,2458,2458,-12,-12,0,0
20150410,2458,2458,,,,2448,2448,-10,-10,0,0
20150413,2448,2448,2320,2442,2320,2370,2364,-78,-84,8,2
20150414,2370,2364,,,,2364,2364,0,0,0,2
20150415,2364,2364,,,,2364,2364,0,0,0,2
20150416,2364,2364,,,,2364,2364,0,0,0,2
20150417,2364,2364,,,,2370,2370,6,6,0,2
20150420,2370,2370,,,,2370,2370,0,0,0,2
20150421,2370,2370,,,,2370,2370,0,0,0,2
20150422,2370,2370,,,,2406,2406,36,36,0,2
20150423,2406,2406,,,,2406,2406,0,0,0,2
20150424,2406,2406,,,,2430,2430,24,24,0,2
20150427,2430,2430,,,,2444,2444,14,14,0,2
20150428,2444,2444,,,,2447,2447,3,3,0,2
20150429,2447,2447,,,,2470,2470,23,23,0,2
20150430,2470,2470,,,,2470,2470,0,0,0,2
20150504,2470,2470,,,,2473,2473,3,3,0,2
20150505,2473,2473,2587,2587,2514,2514,2559,41,86,16,2
20150506,2514,2559,,,,2552,2552,-7,-7,0,2
20150507,2552,2552,,,,2552,2552,0,0,0,2
20150508,2552,2552,,,,2549,2549,-3,-3,0,2
20150511,2549,2549,,,,2549,2549,0,0,0,2
20150512,2549,2549,,,,2549,2549,0,0,0,2
20150513,2549,2549,,,,2549,2549,0,0,0,2
20150514,2549,2549,,,,2523,2523,-26,-26,0,2
20150515,2523,2523,,,,2523,2523,0,0,0,2
20150518,2523,2523,,,,2523,2523,0,0,0,2
20150519,2523,2523,,,,2523,2523,0,0,0,2
20150520,2523,2523,2420,2420,2420,2420,2420,-103,-103,2,0
20150521,2420,2420,,,,2430,2430,10,10,0,0
20150522,2430,2430,,,,2443,2443,13,13,0,0
20150525,2443,2443,,,,2448,2448,5,5,0,0
20150526,2448,2448,,,,2472,2472,24,24,0,0
20150527,2472,2472,,,,2465,2465,-7,-7,0,0
20150528,2465,2465,,,,2464,2464,-1,-1,0,0
20150529,2464,2464,,,,2455,2455,-9,-9,0,0
20150601,2455,2455,,,,2471,2471,16,16,0,0
20150602,2471,2471,,,,2477,2477,6,6,0,0
20150603,2477,2477,,,,2471,2471,-6,-6,0,0
20150604,2471,2471,,,,2454,2454,-17,-17,0,0
20150605,2454,2454,,,,2447,2447,-7,-7,0,0
20150608,2447,2447,,,,2438,2438,-9,-9,0,0
20150609,2438,2438,,,,2449,2449,11,11,0,0
20150610,2449,2449,,,,2451,2451,2,2,0,0
20150611,2451,2451,,,,2465,2465,14,14,0,0
20150612,2465,2465,,,,2427,2427,-38,-38,0,0
20150615,2427,2427,,,,2396,2396,-31,-31,0,0
20150616,2396,2396,,,,2369,2369,-27,-27,0,0
20150617,2369,2369,,,,2328,2328,-41,-41,0,0
20150618,2328,2328,,,,2333,2333,5,5,0,0
20150619,2333,2333,,,,2347,2347,14,14,0,0
20150623,2347,2347,,,,2328,2328,-19,-19,0,0
20150624,2328,2328,,,,2331,2331,3,3,0,0
20150625,2331,2331,,,,2313,2313,-18,-18,0,0
20150626,2313,2313,,,,2297,2297,-16,-16,0,0
20150629,2297,2297,,,,2281,2281,-16,-16,0,0
20150630,2281,2281,,,,2219,2219,-62,-62,0,0
20150701,2219,2219,,,,2211,2211,-8,-8,0,0
20150702,2211,2211,,,,2190,2190,-21,-21,0,0
20150703,2190,2190,,,,2215,2215,25,25,0,0
20150706,2215,2215,,,,2146,2146,-69,-69,0,0
20150707,2146,2146,,,,2077,2077,-69,-69,0,0
20150708,2077,2077,,,,2015,2015,-62,-62,0,0
20150709,2015,2015,,,,2046,2046,31,31,0,0
20150710,2046,2046,2148,2148,2148,2148,2148,102,102,2,2
20150713,2148,2148,2054,2054,2054,2054,2054,-94,-94,2,0
20150714,2054,2054,,,,2046,2046,-8,-8,0,0
20150715,2046,2046,,,,2034,2034,-12,-12,0,0
20150716,2034,2034,,,,2030,2030,-4,-4,0,0
20150717,2030,2030,,,,2034,2034,4,4,0,0
20150720,2034,2034,2130,2130,2130,2130,2130,96,96,2,2
20150721,2130,2130,,,,2151,2151,21,21,0,2
20150722,2151,2151,,,,2106,2106,-45,-45,0,2
20150723,2106,2106,,,,2091,2091,-15,-15,0,2
20150724,2091,2091,,,,2097,2097,6,6,0,2
20150727,2097,2097,,,,2113,2113,16,16,0,2
20150728,2113,2113,2131,2131,2007,2061,2063,-52,-50,30,0
20150729,2061,2063,,,,2080,2080,17,17,0,0
20150730,2080,2080,,,,2069,2069,-11,-11,0,0
20150731,2069,2069,,,,2058,2058,-11,-11,0,0
20150803,2058,2058,,,,2086,2086,28,28,0,0
20150804,2086,2086,,,,2086,2086,0,0,0,0
20150805,2086,2086,,,,2093,2093,7,7,0,0
20150806,2093,2093,,,,2102,2102,9,9,0,0
20150807,2102,2102,,,,2095,2095,-7,-7,0,0
20150810,2095,2095,,,,2085,2085,-10,-10,0,0
20150811,2085,2085,,,,2082,2082,-3,-3,0,0
20150812,2082,2082,,,,2075,2075,-7,-7,0,0
20150813,2075,2075,,,,2090,2090,15,15,0,0
20150814,2090,2090,,,,2090,2090,0,0,0,0
20150817,2090,2090,,,,2089,2089,-1,-1,0,0
20150818,2089,2089,,,,2078,2078,-11,-11,0,0
20150819,2078,2078,,,,2066,2066,-12,-12,0,0
20150820,2066,2066,,,,2050,2050,-16,-16,0,0
20150821,2050,2050,,,,2046,2046,-4,-4,0,0
20150824,2046,2046,,,,1990,1990,-56,-56,0,0
20150825,1990,1990,,,,1955,1955,-35,-35,0,0
20150826,1955,1955,,,,1954,1954,-1,-1,0,0
20150827,1954,1954,,,,1939,1939,-15,-15,0,0
20150828,1939,1939,,,,1957,1957,18,18,0,0
20150831,1957,1957,,,,1947,1947,-10,-10,0,0
20150901,1947,1947,,,,1948,1948,1,1,0,0
20150902,1948,1948,,,,1944,1944,-4,-4,0,0
20150907,1944,1944,,,,1940,1940,-4,-4,0,0
20150908,1940,1940,,,,1932,1932,-8,-8,0,0
20150909,1932,1932,,,,1947,1947,15,15,0,0
20150910,1947,1947,,,,1941,1941,-6,-6,0,0
20150911,1941,1941,,,,1939,1939,-2,-2,0,0
20150914,1939,1939,,,,1921,1921,-18,-18,0,0
20150915,1921,1921,,,,1906,1906,-15,-15,0,0
20150916,1906,1906,,,,1910,1910,4,4,0,0
20150917,1910,1910,,,,1911,1911,1,1,0,0
20150918,1911,1911,,,,1904,1904,-7,-7,0,0
20150921,1904,1904,,,,1898,1898,-6,-6,0,0
20150922,1898,1898,,,,1890,1890,-8,-8,0,0
20150923,1890,1890,,,,1895,1895,5,5,0,0
20150924,1895,1895,,,,1893,1893,-2,-2,0,0
20150925,1893,1893,,,,1882,1882,-11,-11,0,0
20150928,1882,1882,,,,1856,1856,-26,-26,0,0
20150929,1856,1856,,,,1854,1854,-2,-2,0,0
20150930,1854,1854,,,,1831,1831,-23,-23,0,0
20151008,1831,1831,,,,1873,1873,42,42,0,0
20151009,1873,1873,,,,1877,1877,4,4,0,0
20151012,1877,1877,,,,1877,1877,0,0,0,0
20151013,1877,1877,,,,1877,1877,0,0,0,0
20151014,1877,1877,,,,1866,1866,-11,-11,0,0
20151015,1866,1866,,,,1866,1866,0,0,0,0
20151016,1866,1866,,,,1866,1866,0,0,0,0
20151019,1866,1866,,,,1866,1866,0,0,0,0
20151020,1866,1866,,,,1866,1866,0,0,0,0
20151021,1866,1866,,,,1866,1866,0,0,0,0
20151022,1866,1866,,,,1866,1866,0,0,0,0
20151023,1866,1866,,,,1866,1866,0,0,0,0
20151026,1866,1866,,,,1866,1866,0,0,0,0
20151027,1866,1866,,,,1866,1866,0,0,0,0
20151028,1866,1866,,,,1866,1866,0,0,0,0
20151029,1866,1866,,,,1866,1866,0,0,0,0
20151030,1866,1866,,,,1866,1866,0,0,0,0
20151102,1866,1866,,,,1866,1866,0,0,0,0
20151103,1866,1866,,,,1866,1866,0,0,0,0
20151104,1866,1866,,,,1866,1866,0,0,0,0
20151105,1866,1866,,,,1866,1866,0,0,0,0
20151106,1866,1866,,,,1866,1866,0,0,0,0
20151109,1866,1866,,,,1866,1866,0,0,0,0
20151110,1866,1866,,,,1866,1866,0,0,0,0
20151111,1866,1866,,,,1866,1866,0,0,0,0
20151112,1866,1866,,,,1866,1866,0,0,0,0
20151113,1866,1866,,,,1866,1866,0,0,0,0
20151116,1866,1866,,,,1866,1866,0,0,0,0
hc1512,20150105,2828,2828,,,,2804,2804,-24,-24,0,0
20150106,2804,2804,,,,2840,2840,36,36,0,0
20150107,2840,2840,,,,2808,2808,-32,-32,0,0
20150108,2808,2808,,,,2792,2792,-16,-16,0,0
20150109,2792,2792,,,,2778,2778,-14,-14,0,0
20150112,2778,2778,,,,2716,2716,-62,-62,0,0
20150113,2716,2716,,,,2716,2716,0,0,0,0
20150114,2716,2716,,,,2716,2716,0,0,0,0
20150115,2716,2716,,,,2742,2742,26,26,0,0
20150116,2742,2742,,,,2706,2706,-36,-36,0,0
20150119,2706,2706,,,,2706,2706,0,0,0,0
20150120,2706,2706,2770,2770,2640,2640,2704,-66,-2,4,0
20150121,2640,2704,,,,2700,2700,-4,-4,0,0
20150122,2700,2700,,,,2692,2692,-8,-8,0,0
20150123,2692,2692,,,,2674,2674,-18,-18,0,0
20150126,2674,2674,,,,2630,2630,-44,-44,0,0
20150127,2630,2630,,,,2610,2610,-20,-20,0,0
20150128,2610,2610,,,,2638,2638,28,28,0,0
20150129,2638,2638,,,,2656,2656,18,18,0,0
20150130,2656,2656,,,,2656,2656,0,0,0,0
20150202,2656,2656,,,,2690,2690,34,34,0,0
20150203,2690,2690,,,,2642,2642,-48,-48,0,0
20150204,2642,2642,,,,2636,2636,-6,-6,0,0
20150205,2636,2636,,,,2626,2626,-10,-10,0,0
20150206,2626,2626,,,,2626,2626,0,0,0,0
20150209,2626,2626,,,,2620,2620,-6,-6,0,0
20150210,2620,2620,,,,2620,2620,0,0,0,0
20150211,2620,2620,,,,2580,2580,-40,-40,0,0
20150212,2580,2580,,,,2640,2640,60,60,0,0
20150213,2640,2640,,,,2658,2658,18,18,0,0
20150216,2658,2658,,,,2658,2658,0,0,0,0
20150217,2658,2658,,,,2658,2658,0,0,0,0
20150225,2658,2658,,,,2634,2634,-24,-24,0,0
20150226,2634,2634,,,,2634,2634,0,0,0,0
20150227,2634,2634,,,,2634,2634,0,0,0,0
20150302,2634,2634,,,,2634,2634,0,0,0,0
20150303,2634,2634,,,,2634,2634,0,0,0,0
20150304,2634,2634,,,,2634,2634,0,0,0,0
20150305,2634,2634,,,,2634,2634,0,0,0,0
20150306,2634,2634,,,,2634,2634,0,0,0,0
20150309,2634,2634,,,,2634,2634,0,0,0,0
20150310,2634,2634,,,,2634,2634,0,0,0,0
20150311,2634,2634,2508,2664,2508,2664,2586,30,-48,4,0
20150312,2664,2586,,,,2586,2586,0,0,0,0
20150313,2586,2586,,,,2586,2586,0,0,0,0
20150316,2586,2586,,,,2586,2586,0,0,0,0
20150317,2586,2586,,,,2586,2586,0,0,0,0
20150318,2586,2586,,,,2586,2586,0,0,0,0
20150319,2586,2586,,,,2586,2586,0,0,0,0
20150320,2586,2586,,,,2586,2586,0,0,0,0
20150323,2586,2586,,,,2586,2586,0,0,0,0
20150324,2586,2586,,,,2586,2586,0,0,0,0
20150325,2586,2586,,,,2586,2586,0,0,0,0
20150326,2586,2586,,,,2574,2574,-12,-12,0,0
20150327,2574,2574,,,,2574,2574,0,0,0,0
20150330,2574,2574,,,,2574,2574,0,0,0,0
20150331,2574,2574,,,,2574,2574,0,0,0,0
20150401,2574,2574,,,,2574,2574,0,0,0,0
20150402,2574,2574,,,,2530,2530,-44,-44,0,0
20150403,2530,2530,,,,2516,2516,-14,-14,0,0
20150407,2516,2516,,,,2464,2464,-52,-52,0,0
20150408,2464,2464,,,,2464,2464,0,0,0,0
20150409,2464,2464,,,,2458,2458,-6,-6,0,0
20150410,2458,2458,,,,2440,2440,-18,-18,0,0
20150413,2440,2440,,,,2440,2440,0,0,0,0
20150414,2440,2440,,,,2440,2440,0,0,0,0
20150415,2440,2440,,,,2440,2440,0,0,0,0
20150416,2440,2440,,,,2436,2436,-4,-4,0,0
20150417,2436,2436,,,,2442,2442,6,6,0,0
20150420,2442,2442,,,,2420,2420,-22,-22,0,0
20150421,2420,2420,,,,2406,2406,-14,-14,0,0
20150422,2406,2406,,,,2442,2442,36,36,0,0
20150423,2442,2442,,,,2464,2464,22,22,0,0
20150424,2464,2464,,,,2508,2508,44,44,0,0
20150427,2508,2508,,,,2508,2508,0,0,0,0
20150428,2508,2508,2480,2537,2480,2537,2500,29,-8,30,18
20150429,2537,2500,,,,2500,2500,0,0,0,18
20150430,2500,2500,,,,2491,2491,-9,-9,0,18
20150504,2491,2491,,,,2535,2535,44,44,0,18
20150505,2535,2535,,,,2623,2623,88,88,0,18
20150506,2623,2623,,,,2616,2616,-7,-7,0,18
20150507,2616,2616,,,,2581,2581,-35,-35,0,18
20150508,2581,2581,,,,2562,2562,-19,-19,0,18
20150511,2562,2562,,,,2582,2582,20,20,0,18
20150512,2582,2582,,,,2571,2571,-11,-11,0,18
20150513,2571,2571,,,,2564,2564,-7,-7,0,18
20150514,2564,2564,,,,2537,2537,-27,-27,0,18
20150515,2537,2537,,,,2540,2540,3,3,0,18
20150518,2540,2540,,,,2540,2540,0,0,0,18
20150519,2540,2540,,,,2516,2516,-24,-24,0,18
20150520,2516,2516,,,,2413,2413,-103,-103,0,18
20150521,2413,2413,,,,2423,2423,10,10,0,18
20150522,2423,2423,,,,2436,2436,13,13,0,18
20150525,2436,2436,,,,2441,2441,5,5,0,18
20150526,2441,2441,,,,2465,2465,24,24,0,18
20150527,2465,2465,,,,2458,2458,-7,-7,0,18
20150528,2458,2458,,,,2457,2457,-1,-1,0,18
20150529,2457,2457,,,,2448,2448,-9,-9,0,18
20150601,2448,2448,,,,2464,2464,16,16,0,18
20150602,2464,2464,,,,2470,2470,6,6,0,18
20150603,2470,2470,,,,2464,2464,-6,-6,0,18
20150604,2464,2464,,,,2447,2447,-17,-17,0,18
20150605,2447,2447,,,,2440,2440,-7,-7,0,18
20150608,2440,2440,,,,2431,2431,-9,-9,0,18
20150609,2431,2431,,,,2442,2442,11,11,0,18
20150610,2442,2442,,,,2444,2444,2,2,0,18
20150611,2444,2444,,,,2458,2458,14,14,0,18
20150612,2458,2458,,,,2420,2420,-38,-38,0,18
20150615,2420,2420,,,,2389,2389,-31,-31,0,18
20150616,2389,2389,,,,2362,2362,-27,-27,0,18
20150617,2362,2362,,,,2321,2321,-41,-41,0,18
20150618,2321,2321,,,,2326,2326,5,5,0,18
20150619,2326,2326,,,,2339,2339,13,13,0,18
20150623,2339,2339,,,,2320,2320,-19,-19,0,18
20150624,2320,2320,,,,2323,2323,3,3,0,18
20150625,2323,2323,,,,2305,2305,-18,-18,0,18
20150626,2305,2305,,,,2289,2289,-16,-16,0,18
20150629,2289,2289,,,,2273,2273,-16,-16,0,18
20150630,2273,2273,,,,2211,2211,-62,-62,0,18
20150701,2211,2211,,,,2203,2203,-8,-8,0,18
20150702,2203,2203,,,,2182,2182,-21,-21,0,18
20150703,2182,2182,,,,2207,2207,25,25,0,18
20150706,2207,2207,,,,2138,2138,-69,-69,0,18
20150707,2138,2138,,,,2070,2070,-68,-68,0,18
20150708,2070,2070,,,,2008,2008,-62,-62,0,18
20150709,2008,2008,,,,2039,2039,31,31,0,18
20150710,2039,2039,,,,2140,2140,101,101,0,18
20150713,2140,2140,,,,2046,2046,-94,-94,0,18
20150714,2046,2046,,,,2038,2038,-8,-8,0,18
20150715,2038,2038,,,,2026,2026,-12,-12,0,18
20150716,2026,2026,,,,2022,2022,-4,-4,0,18
20150717,2022,2022,,,,2026,2026,4,4,0,18
20150720,2026,2026,,,,2121,2121,95,95,0,18
20150721,2121,2121,2104,2107,2101,2105,2104,-16,-17,18,4
20150722,2105,2104,,,,2104,2104,0,0,0,4
20150723,2104,2104,,,,2104,2104,0,0,0,4
20150724,2104,2104,,,,2104,2104,0,0,0,4
20150727,2104,2104,,,,2120,2120,16,16,0,4
20150728,2120,2120,,,,2120,2120,0,0,0,4
20150729,2120,2120,2032,2162,2032,2156,2097,36,-23,124,4
20150730,2156,2097,,,,2097,2097,0,0,0,4
20150731,2097,2097,,,,2097,2097,0,0,0,4
20150803,2097,2097,,,,2097,2097,0,0,0,4
20150804,2097,2097,,,,2097,2097,0,0,0,4
20150805,2097,2097,,,,2097,2097,0,0,0,4
20150806,2097,2097,,,,2097,2097,0,0,0,4
20150807,2097,2097,,,,2097,2097,0,0,0,4
20150810,2097,2097,2139,2139,2066,2066,2102,-31,5,8,4
20150811,2066,2102,,,,2102,2102,0,0,0,4
20150812,2102,2102,2118,2118,2032,2061,2070,-41,-32,6,4
20150813,2061,2070,,,,2070,2070,0,0,0,4
20150814,2070,2070,,,,2070,2070,0,0,0,4
20150817,2070,2070,,,,2070,2070,0,0,0,4
20150818,2070,2070,,,,2070,2070,0,0,0,4
20150819,2070,2070,,,,2070,2070,0,0,0,4
20150820,2070,2070,,,,2054,2054,-16,-16,0,4
20150821,2054,2054,,,,2054,2054,0,0,0,4
20150824,2054,2054,,,,1998,1998,-56,-56,0,4
20150825,1998,1998,,,,1998,1998,0,0,0,4
20150826,1998,1998,,,,1998,1998,0,0,0,4
20150827,1998,1998,,,,1998,1998,0,0,0,4
20150828,1998,1998,,,,2017,2017,19,19,0,4
20150831,2017,2017,,,,2007,2007,-10,-10,0,4
20150901,2007,2007,,,,2007,2007,0,0,0,4
20150902,2007,2007,,,,2007,2007,0,0,0,4
20150907,2007,2007,1941,1941,1909,1941,1930,-66,-77,6,6
20150908,1941,1930,,,,1930,1930,0,0,0,6
20150909,1930,1930,1999,1999,1959,1959,1977,29,47,8,4
20150910,1959,1977,1975,1975,1936,1965,1963,-12,-14,10,4
20150911,1965,1963,,,,1961,1961,-2,-2,0,4
20150914,1961,1961,,,,1943,1943,-18,-18,0,4
20150915,1943,1943,,,,1928,1928,-15,-15,0,4
20150916,1928,1928,,,,1932,1932,4,4,0,4
20150917,1932,1932,,,,1933,1933,1,1,0,4
20150918,1933,1933,,,,1933,1933,0,0,0,4
20150921,1933,1933,,,,1927,1927,-6,-6,0,4
20150922,1927,1927,,,,1919,1919,-8,-8,0,4
20150923,1919,1919,,,,1919,1919,0,0,0,4
20150924,1919,1919,,,,1919,1919,0,0,0,4
20150925,1919,1919,1990,1990,1918,1918,1954,-1,35,4,4
20150928,1918,1954,,,,1927,1927,-27,-27,0,4
20150929,1927,1927,,,,1925,1925,-2,-2,0,4
20150930,1925,1925,,,,1899,1899,-26,-26,0,4
20151008,1899,1899,,,,1899,1899,0,0,0,4
20151009,1899,1899,,,,1903,1903,4,4,0,4
20151012,1903,1903,,,,1903,1903,0,0,0,4
20151013,1903,1903,,,,1903,1903,0,0,0,4
20151014,1903,1903,,,,1892,1892,-11,-11,0,4
20151015,1892,1892,,,,1892,1892,0,0,0,4
20151016,1892,1892,,,,1892,1892,0,0,0,4
20151019,1892,1892,,,,1892,1892,0,0,0,4
20151020,1892,1892,,,,1892,1892,0,0,0,4
20151021,1892,1892,,,,1892,1892,0,0,0,4
20151022,1892,1892,,,,1892,1892,0,0,0,4
20151023,1892,1892,,,,1892,1892,0,0,0,4
20151026,1892,1892,,,,1892,1892,0,0,0,4
20151027,1892,1892,,,,1892,1892,0,0,0,4
20151028,1892,1892,,,,1892,1892,0,0,0,4
20151029,1892,1892,,,,1892,1892,0,0,0,4
20151030,1892,1892,,,,1892,1892,0,0,0,4
20151102,1892,1892,1919,1919,1899,1899,1909,7,17,4,4
20151103,1899,1909,1813,2004,1813,1813,1896,-96,-13,20,2
20151104,1813,1896,,,,1896,1896,0,0,0,2
20151105,1896,1896,,,,1801,1801,-95,-95,0,2
20151106,1801,1801,,,,1801,1801,0,0,0,2
20151109,1801,1801,,,,1801,1801,0,0,0,2
20151110,1801,1801,,,,1801,1801,0,0,0,2
20151111,1801,1801,,,,1801,1801,0,0,0,2
20151112,1801,1801,,,,1801,1801,0,0,0,2
20151113,1801,1801,,,,1801,1801,0,0,0,2
20151116,1801,1801,,,,1801,1801,0,0,0,2
20151117,1801,1801,,,,1801,1801,0,0,0,2
20151118,1801,1801,1750,1890,1750,1890,1820,89,19,4,2
20151119,1890,1820,1848,1848,1848,1848,1848,28,28,2,0
20151120,1848,1848,,,,1848,1848,0,0,0,0
20151123,1848,1848,,,,1848,1848,0,0,0,0
20151124,1848,1848,,,,1848,1848,0,0,0,0
20151125,1848,1848,,,,1848,1848,0,0,0,0
20151126,1848,1848,,,,1848,1848,0,0,0,0
20151127,1848,1848,,,,1848,1848,0,0,0,0
20151130,1848,1848,,,,1848,1848,0,0,0,0
hc1601,20150116,2742,2742,,,,2742,2742,0,0,0,0
20150119,2742,2742,,,,2742,2742,0,0,0,0
20150120,2742,2742,2598,2598,2598,2598,2598,-144,-144,2,2
20150121,2598,2598,2570,2620,2570,2620,2594,22,-4,4,6
20150122,2620,2594,,,,2594,2594,0,0,0,6
20150123,2594,2594,,,,2594,2594,0,0,0,6
20150126,2594,2594,2538,2538,2538,2538,2538,-56,-56,2,6
20150127,2538,2538,2502,2596,2502,2516,2526,-22,-12,10,6
20150128,2516,2526,2624,2626,2554,2626,2600,100,74,12,6
20150129,2626,2600,2662,2680,2626,2626,2656,26,56,6,8
20150130,2626,2656,,,,2656,2656,0,0,0,8
20150202,2656,2656,,,,2656,2656,0,0,0,8
20150203,2656,2656,,,,2656,2656,0,0,0,8
20150204,2656,2656,2698,2698,2698,2698,2698,42,42,2,10
20150205,2698,2698,,,,2698,2698,0,0,0,10
20150206,2698,2698,,,,2698,2698,0,0,0,10
20150209,2698,2698,,,,2698,2698,0,0,0,10
20150210,2698,2698,,,,2698,2698,0,0,0,10
20150211,2698,2698,,,,2698,2698,0,0,0,10
20150212,2698,2698,,,,2698,2698,0,0,0,10
20150213,2698,2698,,,,2698,2698,0,0,0,10
20150216,2698,2698,,,,2698,2698,0,0,0,10
20150217,2698,2698,2598,2736,2598,2736,2666,38,-32,4,8
20150225,2736,2666,,,,2642,2642,-24,-24,0,8
20150226,2642,2642,,,,2646,2646,4,4,0,8
20150227,2646,2646,,,,2646,2646,0,0,0,8
20150302,2646,2646,,,,2646,2646,0,0,0,8
20150303,2646,2646,,,,2646,2646,0,0,0,8
20150304,2646,2646,,,,2646,2646,0,0,0,8
20150305,2646,2646,,,,2646,2646,0,0,0,8
20150306,2646,2646,,,,2634,2634,-12,-12,0,8
20150309,2634,2634,,,,2634,2634,0,0,0,8
20150310,2634,2634,,,,2634,2634,0,0,0,8
20150311,2634,2634,,,,2634,2634,0,0,0,8
20150312,2634,2634,,,,2634,2634,0,0,0,8
20150313,2634,2634,,,,2630,2630,-4,-4,0,8
20150316,2630,2630,,,,2630,2630,0,0,0,8
20150317,2630,2630,,,,2636,2636,6,6,0,8
20150318,2636,2636,,,,2628,2628,-8,-8,0,8
20150319,2628,2628,,,,2614,2614,-14,-14,0,8
20150320,2614,2614,,,,2614,2614,0,0,0,8
20150323,2614,2614,,,,2614,2614,0,0,0,8
20150324,2614,2614,2680,2680,2582,2582,2630,-32,16,4,10
20150325,2582,2630,,,,2614,2614,-16,-16,0,10
20150326,2614,2614,,,,2614,2614,0,0,0,10
20150327,2614,2614,2582,2582,2582,2582,2582,-32,-32,2,8
20150330,2582,2582,,,,2582,2582,0,0,0,8
20150331,2582,2582,,,,2582,2582,0,0,0,8
20150401,2582,2582,,,,2582,2582,0,0,0,8
20150402,2582,2582,2574,2574,2510,2510,2548,-72,-34,6,12
20150403,2510,2548,,,,2548,2548,0,0,0,12
20150407,2548,2548,2424,2424,2422,2422,2422,-126,-126,6,14
20150408,2422,2422,,,,2422,2422,0,0,0,14
20150409,2422,2422,,,,2422,2422,0,0,0,14
20150410,2422,2422,,,,2422,2422,0,0,0,14
20150413,2422,2422,,,,2422,2422,0,0,0,14
20150414,2422,2422,2490,2490,2450,2450,2470,28,48,4,14
20150415,2450,2470,,,,2470,2470,0,0,0,14
20150416,2470,2470,,,,2470,2470,0,0,0,14
20150417,2470,2470,,,,2470,2470,0,0,0,14
20150420,2470,2470,2498,2498,2370,2370,2434,-100,-36,4,14
20150421,2370,2434,,,,2420,2420,-14,-14,0,14
20150422,2420,2420,,,,2470,2470,50,50,0,14
20150423,2470,2470,2500,2500,2500,2500,2500,30,30,2,16
20150424,2500,2500,,,,2502,2502,2,2,0,16
20150427,2502,2502,2502,2622,2502,2608,2610,106,108,58,62
20150428,2608,2610,2603,2603,2600,2601,2600,-9,-10,22,72
20150429,2601,2600,2570,2570,2570,2570,2570,-30,-30,6,76
20150430,2570,2570,,,,2570,2570,0,0,0,76
20150504,2570,2570,2600,2639,2600,2639,2611,69,41,34,96
20150505,2639,2611,2649,2649,2585,2604,2598,-7,-13,164,154
20150506,2604,2598,2593,2616,2555,2597,2596,-1,-2,20,158
20150507,2597,2596,2581,2588,2570,2570,2578,-26,-18,20,166
20150508,2570,2578,2589,2590,2525,2587,2583,9,5,52,194
20150511,2587,2583,2581,2592,2578,2590,2583,7,0,64,238
20150512,2590,2583,2579,2579,2550,2550,2563,-33,-20,160,352
20150513,2550,2563,2555,2555,2545,2545,2549,-18,-14,54,404
20150514,2545,2549,2540,2567,2452,2505,2484,-44,-65,172,498
20150515,2505,2484,2517,2525,2503,2517,2517,33,33,90,452
20150518,2517,2517,2512,2537,2507,2508,2517,-9,0,12,452
20150519,2508,2517,2509,2509,2497,2497,2502,-20,-15,8,450
20150520,2497,2502,2493,2499,2466,2466,2485,-36,-17,40,436
20150521,2466,2485,2482,2495,2482,2495,2489,10,4,6,436
20150522,2495,2489,2500,2500,2486,2488,2497,-1,8,36,436
20150525,2488,2497,,,,2497,2497,0,0,0,436
20150526,2497,2497,2528,2542,2528,2528,2536,31,39,10,440
20150527,2528,2536,2513,2526,2499,2499,2512,-37,-24,6,438
20150528,2499,2512,2506,2509,2506,2509,2506,-3,-6,26,436
20150529,2509,2506,2500,2507,2500,2507,2503,1,-3,4,436
20150601,2507,2503,2528,2533,2479,2510,2514,7,11,228,624
20150602,2510,2514,2505,2529,2505,2523,2518,9,4,336,914
20150603,2523,2518,2513,2526,2498,2498,2509,-20,-9,114,936
20150604,2498,2509,2497,2497,2497,2497,2497,-12,-12,4,936
20150605,2497,2497,,,,2497,2497,0,0,0,936
20150608,2497,2497,2472,2490,2472,2472,2476,-25,-21,8,938
20150609,2472,2476,2488,2491,2483,2483,2488,7,12,22,932
20150610,2483,2488,2503,2503,2484,2484,2492,-4,4,10,932
20150611,2484,2492,2536,2536,2488,2504,2500,12,8,22,932
20150612,2504,2500,2501,2501,2452,2460,2468,-40,-32,118,960
20150615,2460,2468,2446,2458,2430,2435,2436,-33,-32,34,972
20150616,2435,2436,2435,2435,2399,2405,2429,-31,-7,86,1044
20150617,2405,2429,2380,2399,2370,2375,2377,-54,-52,384,1382
20150618,2375,2377,2377,2393,2372,2383,2381,6,4,166,1500
20150619,2383,2381,2392,2406,2388,2400,2396,19,15,62,1530
20150623,2400,2396,,,,2396,2396,0,0,0,1530
20150624,2396,2396,2381,2411,2381,2400,2402,4,6,18,1532
20150625,2400,2402,2376,2390,2350,2357,2367,-45,-35,278,1708
20150626,2357,2367,2352,2377,2336,2349,2347,-18,-20,2284,3532
20150629,2349,2347,2342,2360,2313,2321,2338,-26,-9,2288,5266
20150630,2321,2338,2305,2324,2250,2279,2300,-59,-38,1216,5494
20150701,2279,2300,2283,2289,2277,2283,2284,-17,-16,640,5966
20150702,2283,2284,2262,2289,2245,2271,2266,-13,-18,1660,7070
20150703,2271,2266,2270,2294,2260,2263,2275,-3,9,1802,8098
20150706,2263,2275,2260,2260,2162,2165,2186,-110,-89,3018,9270
20150707,2165,2186,2161,2162,2076,2076,2120,-110,-66,4646,10538
20150708,2076,2120,2059,2104,2014,2014,2050,-106,-70,1708,11198
20150709,2014,2050,1946,2155,1946,2101,2053,51,3,6074,13844
20150710,2101,2053,2105,2150,2066,2107,2128,54,75,2530,15214
20150713,2107,2128,2112,2123,2049,2077,2088,-51,-40,5562,16436
20150714,2077,2088,2085,2101,2064,2071,2080,-17,-8,4144,18394
20150715,2071,2080,2072,2091,2055,2062,2071,-18,-9,1480,18678
20150716,2062,2071,2058,2087,2037,2065,2065,-6,-6,4020,19914
20150717,2065,2065,2071,2079,2050,2067,2064,2,-1,1846,20428
20150720,2067,2064,2064,2140,2053,2139,2112,75,48,6504,21120
20150721,2139,2112,2126,2145,2090,2110,2113,-2,1,7072,24120
20150722,2110,2113,2091,2103,2032,2048,2072,-65,-41,5330,24520
20150723,2048,2072,2046,2075,2040,2062,2056,-10,-16,3970,26052
20150724,2062,2056,2060,2078,2051,2060,2065,4,9,3164,26184
20150727,2060,2065,2067,2106,2065,2083,2087,18,22,5514,28668
20150728,2083,2087,2067,2105,2060,2077,2080,-10,-7,5290,30428
20150729,2077,2080,2080,2108,2079,2096,2094,16,14,7262,33120
20150730,2096,2094,2100,2101,2066,2069,2086,-25,-8,5766,32428
20150731,2069,2086,2069,2073,2052,2063,2060,-23,-26,10260,31580
20150803,2063,2060,2059,2116,2059,2075,2082,15,22,9512,30348
20150804,2075,2082,2070,2100,2062,2099,2085,17,3,10466,29548
20150805,2099,2085,2105,2111,2091,2107,2101,22,16,9412,29836
20150806,2107,2101,2150,2150,2089,2100,2103,-1,2,11934,29594
20150807,2100,2103,2098,2099,2067,2080,2083,-23,-20,8160,28914
20150810,2080,2083,2075,2087,2060,2076,2071,-7,-12,7838,28864
20150811,2076,2071,2075,2091,2070,2072,2081,1,10,9504,29426
20150812,2072,2081,2071,2086,2021,2085,2069,4,-12,9662,29816
20150813,2085,2069,2089,2116,2085,2094,2097,25,28,14424,30974
20150814,2094,2097,2091,2102,2083,2102,2094,5,-3,9058,31492
20150817,2102,2094,2106,2112,2076,2076,2092,-18,-2,10172,31512
20150818,2076,2092,2076,2085,2072,2075,2077,-17,-15,7172,31616
20150819,2075,2077,2072,2076,2049,2052,2059,-25,-18,15570,35354
20150820,2052,2059,2056,2064,2030,2036,2042,-23,-17,20654,41630
20150821,2036,2042,2041,2047,2030,2035,2038,-7,-4,8438,42098
20150824,2035,2038,2032,2080,1936,1941,1985,-97,-53,31652,40710
20150825,1941,1985,1934,1975,1920,1942,1949,-43,-36,17552,39856
20150826,1942,1949,1961,1979,1948,1948,1962,-1,13,12074,39852
20150827,1948,1962,1950,1985,1942,1970,1964,8,2,11564,41398
20150828,1970,1964,1971,2008,1967,1978,1984,14,20,17452,41568
20150831,1978,1984,1981,1982,1948,1959,1967,-25,-17,15518,42112
20150901,1959,1967,1955,1972,1952,1965,1962,-2,-5,12974,43310
20150902,1965,1962,1962,1969,1955,1962,1962,0,0,10002,41756
20150907,1962,1962,1961,1962,1856,1936,1938,-26,-24,9650,41608
20150908,1936,1938,1926,1952,1923,1952,1935,14,-3,12010,44710
20150909,1952,1935,1953,1996,1953,1956,1968,21,33,23754,48216
20150910,1956,1968,1958,1972,1948,1964,1961,-4,-7,8792,48302
20150911,1964,1961,1963,1975,1960,1961,1967,0,6,13922,48878
20150914,1961,1967,1958,1962,1942,1943,1951,-24,-16,11024,48676
20150915,1943,1951,1940,1943,1916,1919,1933,-32,-18,15992,52140
20150916,1919,1933,1920,1947,1919,1941,1933,8,0,14046,52248
20150917,1941,1933,1941,1960,1936,1939,1945,6,12,13968,51028
20150918,1939,1945,1942,1946,1933,1937,1939,-8,-6,11118,50778
20150921,1937,1939,1936,1943,1909,1923,1925,-16,-14,11656,50524
20150922,1923,1925,1923,1933,1901,1915,1911,-10,-14,14404,51722
20150923,1915,1911,1910,1924,1900,1921,1913,10,2,13688,51080
20150924,1921,1913,1920,1933,1910,1916,1918,3,5,8028,52280
20150925,1916,1918,1914,1932,1909,1916,1920,-2,2,9044,51684
20150928,1916,1920,1910,1910,1881,1884,1896,-36,-24,10350,51810
20150929,1884,1896,1873,1889,1852,1864,1868,-32,-28,13840,49554
20150930,1864,1868,1865,1872,1852,1853,1862,-15,-6,10814,47806
20151008,1853,1862,1869,1880,1840,1853,1863,-9,1,8104,48012
20151009,1853,1863,1855,1892,1851,1883,1872,20,9,11890,48476
20151012,1883,1872,1889,1900,1866,1881,1884,9,12,12868,48358
20151013,1881,1884,1884,1884,1863,1877,1870,-7,-14,11190,46014
20151014,1877,1870,1878,1883,1870,1877,1877,7,7,6752,46336
20151015,1877,1877,1878,1886,1872,1879,1878,2,1,7514,47218
20151016,1879,1878,1879,1880,1865,1870,1870,-8,-8,7166,47584
20151019,1870,1870,1868,1872,1842,1846,1855,-24,-15,15564,49058
20151020,1846,1855,1846,1855,1843,1850,1848,-5,-7,7500,48194
20151021,1850,1848,1850,1859,1800,1854,1848,6,0,9948,47676
20151022,1854,1848,1856,1860,1848,1848,1852,0,4,7798,47472
20151023,1848,1852,1847,1855,1825,1844,1839,-8,-13,7848,47636
20151026,1844,1839,1844,1858,1833,1836,1839,-3,0,7176,47906
20151027,1836,1839,1835,1837,1821,1830,1831,-9,-8,7760,48468
20151028,1830,1831,1829,1832,1812,1819,1820,-12,-11,6266,47854
20151029,1819,1820,1820,1834,1812,1815,1818,-5,-2,6742,48204
20151030,1815,1818,1817,1821,1810,1819,1816,1,-2,8326,46502
20151102,1819,1816,1822,1828,1814,1818,1820,2,4,7790,46566
20151103,1818,1820,1813,1823,1788,1789,1801,-31,-19,11500,47292
20151104,1789,1801,1788,1796,1782,1785,1788,-16,-13,10576,47916
20151105,1785,1788,1786,1793,1768,1770,1780,-18,-8,14014,49538
20151106,1770,1780,1776,1777,1762,1769,1770,-11,-10,18752,49292
20151109,1769,1770,1770,1792,1764,1790,1781,20,11,18798,47238
20151110,1790,1781,1790,1794,1780,1785,1786,4,5,9494,46032
20151111,1785,1786,1785,1786,1768,1771,1773,-15,-13,6618,45852
20151112,1771,1773,1773,1779,1763,1776,1770,3,-3,7830,45734
20151113,1776,1770,1775,1793,1770,1770,1779,0,9,9530,45118
20151116,1770,1779,1768,1786,1765,1775,1777,-4,-2,7202,46552
20151117,1775,1777,1774,1781,1772,1780,1777,3,0,7558,46030
20151118,1780,1777,1780,1783,1760,1762,1770,-15,-7,12668,44794
20151119,1762,1770,1760,1765,1723,1731,1740,-39,-30,14134,44052
20151120,1731,1740,1732,1740,1725,1729,1731,-11,-9,6130,44186
20151123,1729,1731,1729,1729,1687,1705,1705,-26,-26,14728,43070
20151124,1705,1705,1705,1733,1697,1729,1713,24,8,16484,41932
20151125,1729,1713,1732,1767,1723,1744,1739,31,26,16912,36892
20151126,1744,1739,1736,1774,1732,1745,1749,6,10,14944,33252
20151127,1745,1749,1745,1747,1705,1720,1724,-29,-25,10110,31442
20151130,1720,1724,1720,1720,1691,1691,1702,-33,-22,8392,30312
hc1602,20150216,2698,2698,,,,2722,2722,24,24,0,0
20150217,2722,2722,,,,2690,2690,-32,-32,0,0
20150225,2690,2690,,,,2666,2666,-24,-24,0,0
20150226,2666,2666,,,,2638,2638,-28,-28,0,0
20150227,2638,2638,,,,2640,2640,2,2,0,0
20150302,2640,2640,,,,2640,2640,0,0,0,0
20150303,2640,2640,,,,2640,2640,0,0,0,0
20150304,2640,2640,,,,2640,2640,0,0,0,0
20150305,2640,2640,,,,2640,2640,0,0,0,0
20150306,2640,2640,,,,2628,2628,-12,-12,0,0
20150309,2628,2628,,,,2628,2628,0,0,0,0
20150310,2628,2628,,,,2628,2628,0,0,0,0
20150311,2628,2628,,,,2628,2628,0,0,0,0
20150312,2628,2628,,,,2628,2628,0,0,0,0
20150313,2628,2628,,,,2624,2624,-4,-4,0,0
20150316,2624,2624,,,,2624,2624,0,0,0,0
20150317,2624,2624,,,,2630,2630,6,6,0,0
20150318,2630,2630,,,,2622,2622,-8,-8,0,0
20150319,2622,2622,,,,2608,2608,-14,-14,0,0
20150320,2608,2608,,,,2608,2608,0,0,0,0
20150323,2608,2608,,,,2608,2608,0,0,0,0
20150324,2608,2608,,,,2608,2608,0,0,0,0
20150325,2608,2608,,,,2592,2592,-16,-16,0,0
20150326,2592,2592,,,,2592,2592,0,0,0,0
20150327,2592,2592,,,,2592,2592,0,0,0,0
20150330,2592,2592,,,,2592,2592,0,0,0,0
20150331,2592,2592,,,,2592,2592,0,0,0,0
20150401,2592,2592,,,,2592,2592,0,0,0,0
20150402,2592,2592,,,,2556,2556,-36,-36,0,0
20150403,2556,2556,,,,2556,2556,0,0,0,0
20150407,2556,2556,,,,2430,2430,-126,-126,0,0
20150408,2430,2430,,,,2430,2430,0,0,0,0
20150409,2430,2430,,,,2424,2424,-6,-6,0,0
20150410,2424,2424,,,,2424,2424,0,0,0,0
20150413,2424,2424,,,,2424,2424,0,0,0,0
20150414,2424,2424,,,,2472,2472,48,48,0,0
20150415,2472,2472,,,,2472,2472,0,0,0,0
20150416,2472,2472,,,,2468,2468,-4,-4,0,0
20150417,2468,2468,,,,2468,2468,0,0,0,0
20150420,2468,2468,,,,2468,2468,0,0,0,0
20150421,2468,2468,,,,2454,2454,-14,-14,0,0
20150422,2454,2454,,,,2490,2490,36,36,0,0
20150423,2490,2490,,,,2520,2520,30,30,0,0
20150424,2520,2520,,,,2564,2564,44,44,0,0
20150427,2564,2564,,,,2674,2674,110,110,0,0
20150428,2674,2674,,,,2664,2664,-10,-10,0,0
20150429,2664,2664,,,,2633,2633,-31,-31,0,0
20150430,2633,2633,,,,2623,2623,-10,-10,0,0
20150504,2623,2623,,,,2665,2665,42,42,0,0
20150505,2665,2665,,,,2665,2665,0,0,0,0
20150506,2665,2665,,,,2663,2663,-2,-2,0,0
20150507,2663,2663,,,,2644,2644,-19,-19,0,0
20150508,2644,2644,,,,2649,2649,5,5,0,0
20150511,2649,2649,,,,2649,2649,0,0,0,0
20150512,2649,2649,,,,2628,2628,-21,-21,0,0
20150513,2628,2628,2632,2632,2473,2473,2552,-155,-76,4,2
20150514,2473,2552,2510,2510,2510,2510,2510,-42,-42,2,0
20150515,2510,2510,,,,2543,2543,33,33,0,0
20150518,2543,2543,2542,2542,2542,2542,2542,-1,-1,2,2
20150519,2542,2542,,,,2542,2542,0,0,0,2
20150520,2542,2542,,,,2542,2542,0,0,0,2
20150521,2542,2542,,,,2542,2542,0,0,0,2
20150522,2542,2542,2570,2570,2570,2570,2570,28,28,2,4
20150525,2570,2570,,,,2570,2570,0,0,0,4
20150526,2570,2570,,,,2610,2610,40,40,0,4
20150527,2610,2610,,,,2610,2610,0,0,0,4
20150528,2610,2610,,,,2604,2604,-6,-6,0,4
20150529,2604,2604,,,,2604,2604,0,0,0,4
20150601,2604,2604,,,,2615,2615,11,11,0,4
20150602,2615,2615,,,,2620,2620,5,5,0,4
20150603,2620,2620,,,,2585,2585,-35,-35,0,4
20150604,2585,2585,,,,2572,2572,-13,-13,0,4
20150605,2572,2572,,,,2570,2570,-2,-2,0,4
20150608,2570,2570,,,,2548,2548,-22,-22,0,4
20150609,2548,2548,,,,2560,2560,12,12,0,4
20150610,2560,2560,,,,2560,2560,0,0,0,4
20150611,2560,2560,,,,2568,2568,8,8,0,4
20150612,2568,2568,2456,2549,2456,2490,2510,-78,-58,14,6
20150615,2490,2510,,,,2478,2478,-32,-32,0,6
20150616,2478,2478,,,,2471,2471,-7,-7,0,6
20150617,2471,2471,2471,2471,2471,2471,2471,0,0,2,6
20150618,2471,2471,2399,2399,2399,2399,2399,-72,-72,2,4
20150619,2399,2399,,,,2415,2415,16,16,0,4
20150623,2415,2415,,,,2395,2395,-20,-20,0,4
20150624,2395,2395,,,,2395,2395,0,0,0,4
20150625,2395,2395,,,,2395,2395,0,0,0,4
20150626,2395,2395,2300,2440,2300,2334,2364,-61,-31,22,6
20150629,2334,2364,,,,2355,2355,-9,-9,0,6
20150630,2355,2355,2241,2241,2241,2241,2241,-114,-114,2,4
20150701,2241,2241,,,,2225,2225,-16,-16,0,4
20150702,2225,2225,2333,2333,2195,2300,2257,75,32,8,4
20150703,2300,2257,,,,2266,2266,9,9,0,4
20150706,2266,2266,2266,2266,2266,2266,2266,0,0,4,4
20150707,2266,2266,,,,2198,2198,-68,-68,0,4
20150708,2198,2198,2089,2089,2089,2089,2089,-109,-109,4,0
20150709,2089,2089,,,,2093,2093,4,4,0,0
20150710,2093,2093,,,,2170,2170,77,77,0,0
20150713,2170,2170,,,,2129,2129,-41,-41,0,0
20150714,2129,2129,,,,2121,2121,-8,-8,0,0
20150715,2121,2121,,,,2112,2112,-9,-9,0,0
20150716,2112,2112,,,,2106,2106,-6,-6,0,0
20150717,2106,2106,,,,2105,2105,-1,-1,0,0
20150720,2105,2105,,,,2154,2154,49,49,0,0
20150721,2154,2154,,,,2155,2155,1,1,0,0
20150722,2155,2155,,,,2113,2113,-42,-42,0,0
20150723,2113,2113,,,,2097,2097,-16,-16,0,0
20150724,2097,2097,,,,2106,2106,9,9,0,0
20150727,2106,2106,,,,2129,2129,23,23,0,0
20150728,2129,2129,,,,2122,2122,-7,-7,0,0
20150729,2122,2122,,,,2137,2137,15,15,0,0
20150730,2137,2137,,,,2128,2128,-9,-9,0,0
20150731,2128,2128,,,,2102,2102,-26,-26,0,0
20150803,2102,2102,,,,2124,2124,22,22,0,0
20150804,2124,2124,,,,2127,2127,3,3,0,0
20150805,2127,2127,,,,2143,2143,16,16,0,0
20150806,2143,2143,,,,2145,2145,2,2,0,0
20150807,2145,2145,,,,2125,2125,-20,-20,0,0
20150810,2125,2125,,,,2113,2113,-12,-12,0,0
20150811,2113,2113,,,,2124,2124,11,11,0,0
20150812,2124,2124,,,,2112,2112,-12,-12,0,0
20150813,2112,2112,,,,2141,2141,29,29,0,0
20150814,2141,2141,,,,2138,2138,-3,-3,0,0
20150817,2138,2138,,,,2136,2136,-2,-2,0,0
20150818,2136,2136,,,,2121,2121,-15,-15,0,0
20150819,2121,2121,,,,2103,2103,-18,-18,0,0
20150820,2103,2103,,,,2086,2086,-17,-17,0,0
20150821,2086,2086,,,,2082,2082,-4,-4,0,0
20150824,2082,2082,,,,2028,2028,-54,-54,0,0
20150825,2028,2028,,,,1991,1991,-37,-37,0,0
20150826,1991,1991,,,,2005,2005,14,14,0,0
20150827,2005,2005,,,,2007,2007,2,2,0,0
20150828,2007,2007,,,,2027,2027,20,20,0,0
20150831,2027,2027,,,,2009,2009,-18,-18,0,0
20150901,2009,2009,,,,2004,2004,-5,-5,0,0
20150902,2004,2004,,,,2004,2004,0,0,0,0
20150907,2004,2004,,,,1980,1980,-24,-24,0,0
20150908,1980,1980,,,,1977,1977,-3,-3,0,0
20150909,1977,1977,,,,2010,2010,33,33,0,0
20150910,2010,2010,,,,2002,2002,-8,-8,0,0
20150911,2002,2002,,,,2008,2008,6,6,0,0
20150914,2008,2008,,,,1991,1991,-17,-17,0,0
20150915,1991,1991,,,,1972,1972,-19,-19,0,0
20150916,1972,1972,,,,1973,1973,1,1,0,0
20150917,1973,1973,2023,2024,2023,2024,2023,51,50,4,4
20150918,2024,2023,,,,2017,2017,-6,-6,0,4
20150921,2017,2017,,,,2003,2003,-14,-14,0,4
20150922,2003,2003,,,,1989,1989,-14,-14,0,4
20150923,1989,1989,,,,1991,1991,2,2,0,4
20150924,1991,1991,,,,1996,1996,5,5,0,4
20150925,1996,1996,,,,1998,1998,2,2,0,4
20150928,1998,1998,,,,1974,1974,-24,-24,0,4
20150929,1974,1974,,,,1952,1952,-22,-22,0,4
20150930,1952,1952,,,,1945,1945,-7,-7,0,4
20151008,1945,1945,,,,1946,1946,1,1,0,4
20151009,1946,1946,,,,1956,1956,10,10,0,4
20151012,1956,1956,,,,1968,1968,12,12,0,4
20151013,1968,1968,,,,1954,1954,-14,-14,0,4
20151014,1954,1954,,,,1961,1961,7,7,0,4
20151015,1961,1961,,,,1962,1962,1,1,0,4
20151016,1962,1962,,,,1954,1954,-8,-8,0,4
20151019,1954,1954,,,,1938,1938,-16,-16,0,4
20151020,1938,1938,,,,1931,1931,-7,-7,0,4
20151021,1931,1931,,,,1931,1931,0,0,0,4
20151022,1931,1931,,,,1935,1935,4,4,0,4
20151023,1935,1935,,,,1921,1921,-14,-14,0,4
20151026,1921,1921,,,,1921,1921,0,0,0,4
20151027,1921,1921,,,,1912,1912,-9,-9,0,4
20151028,1912,1912,,,,1884,1884,-28,-28,0,4
20151029,1884,1884,,,,1883,1883,-1,-1,0,4
20151030,1883,1883,,,,1881,1881,-2,-2,0,4
20151102,1881,1881,,,,1885,1885,4,4,0,4
20151103,1885,1885,,,,1866,1866,-19,-19,0,4
20151104,1866,1866,,,,1852,1852,-14,-14,0,4
20151105,1852,1852,,,,1843,1843,-9,-9,0,4
20151106,1843,1843,,,,1832,1832,-11,-11,0,4
20151109,1832,1832,,,,1832,1832,0,0,0,4
20151110,1832,1832,1851,1851,1741,1782,1791,-50,-41,6,4
20151111,1782,1791,,,,1778,1778,-13,-13,0,4
20151112,1778,1778,,,,1775,1775,-3,-3,0,4
20151113,1775,1775,,,,1775,1775,0,0,0,4
20151116,1775,1775,,,,1775,1775,0,0,0,4
20151117,1775,1775,,,,1775,1775,0,0,0,4
20151118,1775,1775,,,,1775,1775,0,0,0,4
20151119,1775,1775,,,,1745,1745,-30,-30,0,4
20151120,1745,1745,1701,1719,1701,1719,1710,-26,-35,8,2
20151123,1719,1710,,,,1684,1684,-26,-26,0,2
20151124,1684,1684,,,,1684,1684,0,0,0,2
20151125,1684,1684,,,,1709,1709,25,25,0,2
20151126,1709,1709,,,,1719,1719,10,10,0,2
20151127,1719,1719,,,,1719,1719,0,0,0,2
20151130,1719,1719,,,,1697,1697,-22,-22,0,2
hc1603,20150317,2624,2624,,,,2630,2630,6,6,0,0
20150318,2630,2630,,,,2622,2622,-8,-8,0,0
20150319,2622,2622,,,,2608,2608,-14,-14,0,0
20150320,2608,2608,,,,2608,2608,0,0,0,0
20150323,2608,2608,,,,2608,2608,0,0,0,0
20150324,2608,2608,,,,2608,2608,0,0,0,0
20150325,2608,2608,,,,2592,2592,-16,-16,0,0
20150326,2592,2592,,,,2592,2592,0,0,0,0
20150327,2592,2592,,,,2592,2592,0,0,0,0
20150330,2592,2592,,,,2594,2594,2,2,0,0
20150331,2594,2594,,,,2582,2582,-12,-12,0,0
20150401,2582,2582,,,,2554,2554,-28,-28,0,0
20150402,2554,2554,,,,2520,2520,-34,-34,0,0
20150403,2520,2520,,,,2520,2520,0,0,0,0
20150407,2520,2520,,,,2396,2396,-124,-124,0,0
20150408,2396,2396,,,,2396,2396,0,0,0,0
20150409,2396,2396,,,,2396,2396,0,0,0,0
20150410,2396,2396,,,,2396,2396,0,0,0,0
20150413,2396,2396,,,,2396,2396,0,0,0,0
20150414,2396,2396,,,,2442,2442,46,46,0,0
20150415,2442,2442,,,,2442,2442,0,0,0,0
20150416,2442,2442,,,,2438,2438,-4,-4,0,0
20150417,2438,2438,,,,2438,2438,0,0,0,0
20150420,2438,2438,,,,2438,2438,0,0,0,0
20150421,2438,2438,,,,2424,2424,-14,-14,0,0
20150422,2424,2424,,,,2460,2460,36,36,0,0
20150423,2460,2460,2564,2564,2564,2564,2564,104,104,20,20
20150424,2564,2564,,,,2610,2610,46,46,0,20
20150427,2610,2610,,,,2722,2722,112,112,0,20
20150428,2722,2722,,,,2712,2712,-10,-10,0,20
20150429,2712,2712,,,,2680,2680,-32,-32,0,20
20150430,2680,2680,,,,2670,2670,-10,-10,0,20
20150504,2670,2670,,,,2713,2713,43,43,0,20
20150505,2713,2713,,,,2700,2700,-13,-13,0,20
20150506,2700,2700,,,,2698,2698,-2,-2,0,20
20150507,2698,2698,,,,2679,2679,-19,-19,0,20
20150508,2679,2679,,,,2684,2684,5,5,0,20
20150511,2684,2684,,,,2684,2684,0,0,0,20
20150512,2684,2684,2644,2644,2644,2644,2644,-40,-40,2,22
20150513,2644,2644,,,,2568,2568,-76,-76,0,22
20150514,2568,2568,,,,2525,2525,-43,-43,0,22
20150515,2525,2525,2451,2451,2451,2451,2451,-74,-74,2,22
20150518,2451,2451,2530,2530,2530,2530,2530,79,79,2,20
20150519,2530,2530,,,,2515,2515,-15,-15,0,20
20150520,2515,2515,2460,2460,2460,2460,2460,-55,-55,2,20
20150521,2460,2460,,,,2463,2463,3,3,0,20
20150522,2463,2463,,,,2490,2490,27,27,0,20
20150525,2490,2490,,,,2495,2495,5,5,0,20
20150526,2495,2495,,,,2534,2534,39,39,0,20
20150527,2534,2534,,,,2510,2510,-24,-24,0,20
20150528,2510,2510,,,,2504,2504,-6,-6,0,20
20150529,2504,2504,,,,2501,2501,-3,-3,0,20
20150601,2501,2501,,,,2512,2512,11,11,0,20
20150602,2512,2512,,,,2516,2516,4,4,0,20
20150603,2516,2516,,,,2507,2507,-9,-9,0,20
20150604,2507,2507,,,,2495,2495,-12,-12,0,20
20150605,2495,2495,,,,2488,2488,-7,-7,0,20
20150608,2488,2488,,,,2467,2467,-21,-21,0,20
20150609,2467,2467,,,,2479,2479,12,12,0,20
20150610,2479,2479,,,,2482,2482,3,3,0,20
20150611,2482,2482,,,,2490,2490,8,8,0,20
20150612,2490,2490,,,,2434,2434,-56,-56,0,20
20150615,2434,2434,,,,2403,2403,-31,-31,0,20
20150616,2403,2403,,,,2410,2410,7,7,0,20
20150617,2410,2410,,,,2410,2410,0,0,0,20
20150618,2410,2410,2400,2400,2400,2400,2400,-10,-10,20,0
20150619,2400,2400,2340,2508,2332,2337,2410,-63,10,14,6
20150623,2337,2410,,,,2390,2390,-20,-20,0,6
20150624,2390,2390,2487,2487,2412,2412,2449,22,59,4,4
20150625,2412,2449,,,,2413,2413,-36,-36,0,4
20150626,2413,2413,2375,2448,2375,2376,2400,-37,-13,10,4
20150629,2376,2400,,,,2400,2400,0,0,0,4
20150630,2400,2400,,,,2371,2371,-29,-29,0,4
20150701,2371,2371,,,,2370,2370,-1,-1,0,4
20150702,2370,2370,,,,2345,2345,-25,-25,0,4
20150703,2345,2345,2299,2299,2299,2299,2299,-46,-46,2,2
20150706,2299,2299,,,,2299,2299,0,0,0,2
20150707,2299,2299,,,,2230,2230,-69,-69,0,2
20150708,2230,2230,,,,2119,2119,-111,-111,0,2
20150709,2119,2119,2036,2222,2036,2113,2119,-6,0,10,2
20150710,2113,2119,,,,2119,2119,0,0,0,2
20150713,2119,2119,2109,2109,2109,2109,2109,-10,-10,2,0
20150714,2109,2109,,,,2101,2101,-8,-8,0,0
20150715,2101,2101,,,,2092,2092,-9,-9,0,0
20150716,2092,2092,,,,2086,2086,-6,-6,0,0
20150717,2086,2086,,,,2085,2085,-1,-1,0,0
20150720,2085,2085,,,,2134,2134,49,49,0,0
20150721,2134,2134,,,,2135,2135,1,1,0,0
20150722,2135,2135,,,,2093,2093,-42,-42,0,0
20150723,2093,2093,,,,2077,2077,-16,-16,0,0
20150724,2077,2077,,,,2086,2086,9,9,0,0
20150727,2086,2086,,,,2108,2108,22,22,0,0
20150728,2108,2108,,,,2101,2101,-7,-7,0,0
20150729,2101,2101,,,,2115,2115,14,14,0,0
20150730,2115,2115,,,,2107,2107,-8,-8,0,0
20150731,2107,2107,,,,2081,2081,-26,-26,0,0
20150803,2081,2081,,,,2103,2103,22,22,0,0
20150804,2103,2103,,,,2106,2106,3,3,0,0
20150805,2106,2106,,,,2122,2122,16,16,0,0
20150806,2122,2122,,,,2124,2124,2,2,0,0
20150807,2124,2124,,,,2104,2104,-20,-20,0,0
20150810,2104,2104,,,,2092,2092,-12,-12,0,0
20150811,2092,2092,,,,2103,2103,11,11,0,0
20150812,2103,2103,,,,2091,2091,-12,-12,0,0
20150813,2091,2091,,,,2119,2119,28,28,0,0
20150814,2119,2119,,,,2116,2116,-3,-3,0,0
20150817,2116,2116,,,,2114,2114,-2,-2,0,0
20150818,2114,2114,,,,2099,2099,-15,-15,0,0
20150819,2099,2099,,,,2081,2081,-18,-18,0,0
20150820,2081,2081,,,,2064,2064,-17,-17,0,0
20150821,2064,2064,,,,2060,2060,-4,-4,0,0
20150824,2060,2060,,,,2007,2007,-53,-53,0,0
20150825,2007,2007,,,,1971,1971,-36,-36,0,0
20150826,1971,1971,,,,1985,1985,14,14,0,0
20150827,1985,1985,,,,1987,1987,2,2,0,0
20150828,1987,1987,,,,2007,2007,20,20,0,0
20150831,2007,2007,,,,1989,1989,-18,-18,0,0
20150901,1989,1989,,,,1984,1984,-5,-5,0,0
20150902,1984,1984,,,,1984,1984,0,0,0,0
20150907,1984,1984,,,,1960,1960,-24,-24,0,0
20150908,1960,1960,,,,1957,1957,-3,-3,0,0
20150909,1957,1957,,,,1990,1990,33,33,0,0
20150910,1990,1990,,,,1983,1983,-7,-7,0,0
20150911,1983,1983,,,,1989,1989,6,6,0,0
20150914,1989,1989,,,,1973,1973,-16,-16,0,0
20150915,1973,1973,,,,1954,1954,-19,-19,0,0
20150916,1954,1954,,,,1954,1954,0,0,0,0
20150917,1954,1954,,,,2004,2004,50,50,0,0
20150918,2004,2004,,,,1998,1998,-6,-6,0,0
20150921,1998,1998,,,,1984,1984,-14,-14,0,0
20150922,1984,1984,,,,1970,1970,-14,-14,0,0
20150923,1970,1970,,,,1972,1972,2,2,0,0
20150924,1972,1972,,,,1977,1977,5,5,0,0
20150925,1977,1977,,,,1979,1979,2,2,0,0
20150928,1979,1979,,,,1955,1955,-24,-24,0,0
20150929,1955,1955,,,,1926,1926,-29,-29,0,0
20150930,1926,1926,,,,1920,1920,-6,-6,0,0
20151008,1920,1920,,,,1921,1921,1,1,0,0
20151009,1921,1921,,,,1931,1931,10,10,0,0
20151012,1931,1931,,,,1943,1943,12,12,0,0
20151013,1943,1943,,,,1929,1929,-14,-14,0,0
20151014,1929,1929,,,,1936,1936,7,7,0,0
20151015,1936,1936,,,,1937,1937,1,1,0,0
20151016,1937,1937,,,,1929,1929,-8,-8,0,0
20151019,1929,1929,,,,1913,1913,-16,-16,0,0
20151020,1913,1913,,,,1906,1906,-7,-7,0,0
20151021,1906,1906,,,,1906,1906,0,0,0,0
20151022,1906,1906,,,,1910,1910,4,4,0,0
20151023,1910,1910,1910,1910,1816,1816,1863,-94,-47,4,0
20151026,1816,1863,,,,1863,1863,0,0,0,0
20151027,1863,1863,,,,1855,1855,-8,-8,0,0
20151028,1855,1855,1800,1800,1800,1800,1800,-55,-55,2,2
20151029,1800,1800,,,,1800,1800,0,0,0,2
20151030,1800,1800,1866,1866,1866,1866,1866,66,66,2,0
20151102,1866,1866,,,,1870,1870,4,4,0,0
20151103,1870,1870,,,,1851,1851,-19,-19,0,0
20151104,1851,1851,,,,1837,1837,-14,-14,0,0
20151105,1837,1837,,,,1828,1828,-9,-9,0,0
20151106,1828,1828,,,,1817,1817,-11,-11,0,0
20151109,1817,1817,,,,1828,1828,11,11,0,0
20151110,1828,1828,1851,1851,1744,1744,1797,-84,-31,4,0
20151111,1744,1797,,,,1784,1784,-13,-13,0,0
20151112,1784,1784,,,,1781,1781,-3,-3,0,0
20151113,1781,1781,,,,1790,1790,9,9,0,0
20151116,1790,1790,,,,1788,1788,-2,-2,0,0
20151117,1788,1788,,,,1788,1788,0,0,0,0
20151118,1788,1788,,,,1781,1781,-7,-7,0,0
20151119,1781,1781,,,,1751,1751,-30,-30,0,0
20151120,1751,1751,,,,1715,1715,-36,-36,0,0
20151123,1715,1715,,,,1689,1689,-26,-26,0,0
20151124,1689,1689,,,,1696,1696,7,7,0,0
20151125,1696,1696,,,,1722,1722,26,26,0,0
20151126,1722,1722,,,,1732,1732,10,10,0,0
20151127,1732,1732,,,,1708,1708,-24,-24,0,0
20151130,1708,1708,,,,1686,1686,-22,-22,0,0
hc1604,20150416,2442,2442,,,,2438,2438,-4,-4,0,0
20150417,2438,2438,,,,2444,2444,6,6,0,0
20150420,2444,2444,,,,2408,2408,-36,-36,0,0
20150421,2408,2408,2486,2486,2486,2486,2486,78,78,2,2
20150422,2486,2486,,,,2522,2522,36,36,0,2
20150423,2522,2522,2564,2566,2564,2566,2564,44,42,6,6
20150424,2566,2564,,,,2610,2610,46,46,0,6
20150427,2610,2610,,,,2722,2722,112,112,0,6
20150428,2722,2722,,,,2712,2712,-10,-10,0,6
20150429,2712,2712,,,,2680,2680,-32,-32,0,6
20150430,2680,2680,,,,2670,2670,-10,-10,0,6
20150504,2670,2670,,,,2713,2713,43,43,0,6
20150505,2713,2713,,,,2700,2700,-13,-13,0,6
20150506,2700,2700,2566,2566,2566,2566,2566,-134,-134,2,4
20150507,2566,2566,,,,2548,2548,-18,-18,0,4
20150508,2548,2548,,,,2553,2553,5,5,0,4
20150511,2553,2553,,,,2553,2553,0,0,0,4
20150512,2553,2553,,,,2514,2514,-39,-39,0,4
20150513,2514,2514,,,,2441,2441,-73,-73,0,4
20150514,2441,2441,,,,2400,2400,-41,-41,0,4
20150515,2400,2400,,,,2329,2329,-71,-71,0,4
20150518,2329,2329,,,,2445,2445,116,116,0,4
20150519,2445,2445,,,,2431,2431,-14,-14,0,4
20150520,2431,2431,,,,2377,2377,-54,-54,0,4
20150521,2377,2377,,,,2380,2380,3,3,0,4
20150522,2380,2380,,,,2406,2406,26,26,0,4
20150525,2406,2406,,,,2411,2411,5,5,0,4
20150526,2411,2411,,,,2449,2449,38,38,0,4
20150527,2449,2449,,,,2426,2426,-23,-23,0,4
20150528,2426,2426,,,,2420,2420,-6,-6,0,4
20150529,2420,2420,2540,2540,2540,2540,2540,120,120,4,2
20150601,2540,2540,,,,2551,2551,11,11,0,2
20150602,2551,2551,,,,2556,2556,5,5,0,2
20150603,2556,2556,,,,2547,2547,-9,-9,0,2
20150604,2547,2547,,,,2534,2534,-13,-13,0,2
20150605,2534,2534,,,,2527,2527,-7,-7,0,2
20150608,2527,2527,2553,2553,2553,2553,2553,26,26,2,2
20150609,2553,2553,,,,2565,2565,12,12,0,2
20150610,2565,2565,,,,2569,2569,4,4,0,2
20150611,2569,2569,,,,2569,2569,0,0,0,2
20150612,2569,2569,,,,2511,2511,-58,-58,0,2
20150615,2511,2511,,,,2479,2479,-32,-32,0,2
20150616,2479,2479,,,,2472,2472,-7,-7,0,2
20150617,2472,2472,,,,2472,2472,0,0,0,2
20150618,2472,2472,2370,2370,2370,2370,2370,-102,-102,2,0
20150619,2370,2370,,,,2380,2380,10,10,0,0
20150623,2380,2380,,,,2361,2361,-19,-19,0,0
20150624,2361,2361,,,,2419,2419,58,58,0,0
20150625,2419,2419,,,,2384,2384,-35,-35,0,0
20150626,2384,2384,,,,2371,2371,-13,-13,0,0
20150629,2371,2371,,,,2362,2362,-9,-9,0,0
20150630,2362,2362,,,,2247,2247,-115,-115,0,0
20150701,2247,2247,,,,2231,2231,-16,-16,0,0
20150702,2231,2231,,,,2263,2263,32,32,0,0
20150703,2263,2263,,,,2218,2218,-45,-45,0,0
20150706,2218,2218,,,,2218,2218,0,0,0,0
20150707,2218,2218,,,,2151,2151,-67,-67,0,0
20150708,2151,2151,,,,2044,2044,-107,-107,0,0
20150709,2044,2044,,,,2044,2044,0,0,0,0
20150710,2044,2044,,,,2119,2119,75,75,0,0
20150713,2119,2119,,,,2109,2109,-10,-10,0,0
20150714,2109,2109,,,,2101,2101,-8,-8,0,0
20150715,2101,2101,2193,2193,2193,2193,2193,92,92,2,2
20150716,2193,2193,,,,2187,2187,-6,-6,0,2
20150717,2187,2187,,,,2185,2185,-2,-2,0,2
20150720,2185,2185,,,,2185,2185,0,0,0,2
20150721,2185,2185,,,,2186,2186,1,1,0,2
20150722,2186,2186,,,,2143,2143,-43,-43,0,2
20150723,2143,2143,,,,2127,2127,-16,-16,0,2
20150724,2127,2127,,,,2136,2136,9,9,0,2
20150727,2136,2136,,,,2159,2159,23,23,0,2
20150728,2159,2159,,,,2159,2159,0,0,0,2
20150729,2159,2159,,,,2174,2174,15,15,0,2
20150730,2174,2174,,,,2165,2165,-9,-9,0,2
20150731,2165,2165,,,,2138,2138,-27,-27,0,2
20150803,2138,2138,,,,2161,2161,23,23,0,2
20150804,2161,2161,,,,2164,2164,3,3,0,2
20150805,2164,2164,,,,2181,2181,17,17,0,2
20150806,2181,2181,,,,2183,2183,2,2,0,2
20150807,2183,2183,,,,2162,2162,-21,-21,0,2
20150810,2162,2162,,,,2150,2150,-12,-12,0,2
20150811,2150,2150,,,,2161,2161,11,11,0,2
20150812,2161,2161,,,,2149,2149,-12,-12,0,2
20150813,2149,2149,,,,2178,2178,29,29,0,2
20150814,2178,2178,,,,2175,2175,-3,-3,0,2
20150817,2175,2175,,,,2173,2173,-2,-2,0,2
20150818,2173,2173,,,,2158,2158,-15,-15,0,2
20150819,2158,2158,,,,2140,2140,-18,-18,0,2
20150820,2140,2140,,,,2123,2123,-17,-17,0,2
20150821,2123,2123,,,,2119,2119,-4,-4,0,2
20150824,2119,2119,,,,2064,2064,-55,-55,0,2
20150825,2064,2064,1961,1961,1961,1961,1961,-103,-103,2,0
20150826,1961,1961,,,,1975,1975,14,14,0,0
20150827,1975,1975,,,,1977,1977,2,2,0,0
20150828,1977,1977,,,,1997,1997,20,20,0,0
20150831,1997,1997,,,,1980,1980,-17,-17,0,0
20150901,1980,1980,,,,1975,1975,-5,-5,0,0
20150902,1975,1975,,,,1975,1975,0,0,0,0
20150907,1975,1975,,,,1951,1951,-24,-24,0,0
20150908,1951,1951,,,,1948,1948,-3,-3,0,0
20150909,1948,1948,,,,1981,1981,33,33,0,0
20150910,1981,1981,,,,1974,1974,-7,-7,0,0
20150911,1974,1974,,,,1980,1980,6,6,0,0
20150914,1980,1980,,,,1964,1964,-16,-16,0,0
20150915,1964,1964,,,,1946,1946,-18,-18,0,0
20150916,1946,1946,,,,1946,1946,0,0,0,0
20150917,1946,1946,,,,1995,1995,49,49,0,0
20150918,1995,1995,,,,1989,1989,-6,-6,0,0
20150921,1989,1989,,,,1975,1975,-14,-14,0,0
20150922,1975,1975,,,,1961,1961,-14,-14,0,0
20150923,1961,1961,,,,1963,1963,2,2,0,0
20150924,1963,1963,,,,1968,1968,5,5,0,0
20150925,1968,1968,,,,1970,1970,2,2,0,0
20150928,1970,1970,,,,1946,1946,-24,-24,0,0
20150929,1946,1946,,,,1917,1917,-29,-29,0,0
20150930,1917,1917,,,,1911,1911,-6,-6,0,0
20151008,1911,1911,,,,1912,1912,1,1,0,0
20151009,1912,1912,,,,1922,1922,10,10,0,0
20151012,1922,1922,,,,1934,1934,12,12,0,0
20151013,1934,1934,,,,1920,1920,-14,-14,0,0
20151014,1920,1920,,,,1927,1927,7,7,0,0
20151015,1927,1927,,,,1928,1928,1,1,0,0
20151016,1928,1928,,,,1920,1920,-8,-8,0,0
20151019,1920,1920,,,,1904,1904,-16,-16,0,0
20151020,1904,1904,,,,1897,1897,-7,-7,0,0
20151021,1897,1897,,,,1897,1897,0,0,0,0
20151022,1897,1897,,,,1901,1901,4,4,0,0
20151023,1901,1901,,,,1854,1854,-47,-47,0,0
20151026,1854,1854,,,,1854,1854,0,0,0,0
20151027,1854,1854,,,,1846,1846,-8,-8,0,0
20151028,1846,1846,,,,1791,1791,-55,-55,0,0
20151029,1791,1791,,,,1789,1789,-2,-2,0,0
20151030,1789,1789,,,,1854,1854,65,65,0,0
20151102,1854,1854,,,,1858,1858,4,4,0,0
20151103,1858,1858,,,,1839,1839,-19,-19,0,0
20151104,1839,1839,,,,1825,1825,-14,-14,0,0
20151105,1825,1825,,,,1816,1816,-9,-9,0,0
20151106,1816,1816,,,,1806,1806,-10,-10,0,0
20151109,1806,1806,,,,1817,1817,11,11,0,0
20151110,1817,1817,,,,1786,1786,-31,-31,0,0
20151111,1786,1786,,,,1773,1773,-13,-13,0,0
20151112,1773,1773,,,,1770,1770,-3,-3,0,0
20151113,1770,1770,,,,1779,1779,9,9,0,0
20151116,1779,1779,,,,1777,1777,-2,-2,0,0
20151117,1777,1777,,,,1777,1777,0,0,0,0
20151118,1777,1777,1730,1838,1730,1788,1785,11,8,6,0
20151119,1788,1785,1787,1787,1701,1735,1741,-50,-44,6,0
20151120,1735,1741,,,,1706,1706,-35,-35,0,0
20151123,1706,1706,,,,1680,1680,-26,-26,0,0
20151124,1680,1680,,,,1687,1687,7,7,0,0
20151125,1687,1687,,,,1712,1712,25,25,0,0
20151126,1712,1712,,,,1722,1722,10,10,0,0
20151127,1722,1722,,,,1698,1698,-24,-24,0,0
20151130,1698,1698,,,,1676,1676,-22,-22,0,0
hc1605,20150518,2329,2329,2542,2561,2491,2551,2543,222,214,18,8
20150519,2551,2543,2600,2600,2547,2599,2582,56,39,6,8
20150520,2599,2582,2470,2559,2470,2559,2514,-23,-68,40,8
20150521,2559,2514,2560,2560,2560,2560,2560,46,46,2,8
20150522,2560,2560,2511,2602,2511,2560,2557,0,-3,6,8
20150525,2560,2557,,,,2557,2557,0,0,0,8
20150526,2557,2557,,,,2557,2557,0,0,0,8
20150527,2557,2557,2610,2610,2500,2590,2577,33,20,8,4
20150528,2590,2577,,,,2577,2577,0,0,0,4
20150529,2577,2577,2471,2622,2471,2622,2566,45,-11,8,6
20150601,2622,2566,2627,2628,2560,2560,2593,-6,27,8,6
20150602,2560,2593,2598,2598,2598,2598,2598,5,5,2,6
20150603,2598,2598,,,,2598,2598,0,0,0,6
20150604,2598,2598,2598,2598,2598,2598,2598,0,0,2,6
20150605,2598,2598,,,,2590,2590,-8,-8,0,6
20150608,2590,2590,,,,2616,2616,26,26,0,6
20150609,2616,2616,2620,2620,2492,2534,2554,-82,-62,48,6
20150610,2534,2554,2597,2597,2520,2530,2558,-24,4,36,8
20150611,2530,2558,2585,2585,2582,2582,2583,24,25,4,6
20150612,2582,2583,2560,2560,2560,2560,2560,-23,-23,2,6
20150615,2560,2560,,,,2560,2560,0,0,0,6
20150616,2560,2560,2560,2560,2450,2460,2501,-100,-59,38,16
20150617,2460,2501,,,,2501,2501,0,0,0,16
20150618,2501,2501,2428,2455,2428,2455,2441,-46,-60,4,14
20150619,2455,2441,,,,2441,2441,0,0,0,14
20150623,2441,2441,,,,2441,2441,0,0,0,14
20150624,2441,2441,2519,2519,2440,2440,2476,-1,35,10,16
20150625,2440,2476,2485,2485,2485,2485,2485,9,9,4,16
20150626,2485,2485,2469,2469,2431,2444,2449,-41,-36,42,18
20150629,2444,2449,,,,2449,2449,0,0,0,18
20150630,2449,2449,2369,2376,2356,2376,2364,-73,-85,8,18
20150701,2376,2364,2370,2372,2350,2350,2360,-14,-4,8,16
20150702,2350,2360,2356,2369,2356,2369,2361,9,1,10,22
20150703,2369,2361,2397,2447,2350,2350,2384,-11,23,16,18
20150706,2350,2384,2264,2264,2264,2264,2264,-120,-120,10,12
20150707,2264,2264,2195,2202,2180,2180,2185,-84,-79,42,48
20150708,2180,2185,2190,2190,2076,2076,2088,-109,-97,48,46
20150709,2076,2088,2165,2190,2081,2172,2170,84,82,20,46
20150710,2172,2170,2190,2242,2176,2181,2206,11,36,32,40
20150713,2181,2206,2119,2215,2119,2140,2178,-66,-28,24,50
20150714,2140,2178,,,,2178,2178,0,0,0,50
20150715,2178,2178,2207,2207,2143,2143,2183,-35,5,8,56
20150716,2143,2183,,,,2183,2183,0,0,0,56
20150717,2183,2183,,,,2183,2183,0,0,0,56
20150720,2183,2183,,,,2183,2183,0,0,0,56
20150721,2183,2183,,,,2183,2183,0,0,0,56
20150722,2183,2183,2131,2134,2131,2131,2132,-52,-51,6,54
20150723,2131,2132,,,,2116,2116,-16,-16,0,54
20150724,2116,2116,2187,2187,2175,2175,2181,59,65,4,54
20150727,2175,2181,,,,2205,2205,24,24,0,54
20150728,2205,2205,,,,2190,2190,-15,-15,0,54
20150729,2190,2190,,,,2190,2190,0,0,0,54
20150730,2190,2190,,,,2190,2190,0,0,0,54
20150731,2190,2190,2098,2202,2098,2155,2151,-35,-39,24,54
20150803,2155,2151,2108,2108,2108,2108,2108,-43,-43,2,54
20150804,2108,2108,,,,2108,2108,0,0,0,54
20150805,2108,2108,,,,2108,2108,0,0,0,54
20150806,2108,2108,,,,2110,2110,2,2,0,54
20150807,2110,2110,,,,2110,2110,0,0,0,54
20150810,2110,2110,,,,2110,2110,0,0,0,54
20150811,2110,2110,2159,2159,2124,2124,2133,14,23,8,54
20150812,2124,2133,2143,2143,2125,2128,2127,-5,-6,218,252
20150813,2128,2127,2148,2159,2131,2131,2143,4,16,12,254
20150814,2131,2143,,,,2143,2143,0,0,0,254
20150817,2143,2143,,,,2143,2143,0,0,0,254
20150818,2143,2143,,,,2143,2143,0,0,0,254
20150819,2143,2143,,,,2143,2143,0,0,0,254
20150820,2143,2143,,,,2126,2126,-17,-17,0,254
20150821,2126,2126,,,,2126,2126,0,0,0,254
20150824,2126,2126,2050,2050,2019,2020,2019,-106,-107,238,454
20150825,2020,2019,2020,2020,1990,1990,2016,-29,-3,72,500
20150826,1990,2016,2059,2059,2001,2001,2019,-15,3,266,604
20150827,2001,2019,2001,2023,2001,2023,2012,4,-7,12,608
20150828,2023,2012,2025,2080,2014,2014,2034,2,22,64,654
20150831,2014,2034,2004,2015,1998,1998,1999,-36,-35,170,778
20150901,1998,1999,1988,2002,1988,1990,1995,-9,-4,150,864
20150902,1990,1995,,,,1995,1995,0,0,0,864
20150907,1995,1995,,,,1995,1995,0,0,0,864
20150908,1995,1995,1990,1995,1990,1995,1990,0,-5,118,978
20150909,1995,1990,2010,2025,2003,2003,2012,13,22,104,1028
20150910,2003,2012,1990,2005,1990,1999,1995,-13,-17,494,1484
20150911,1999,1995,1996,2012,1996,2000,2003,5,8,94,1522
20150914,2000,2003,1992,1994,1981,1993,1985,-10,-18,186,1610
20150915,1993,1985,1990,1990,1970,1970,1988,-15,3,128,1704
20150916,1970,1988,1981,1985,1980,1983,1980,-5,-8,402,2054
20150917,1983,1980,1992,1992,1970,1990,1985,10,5,106,2064
20150918,1990,1985,,,,1985,1985,0,0,0,2064
20150921,1985,1985,1960,1960,1958,1960,1959,-25,-26,28,2068
20150922,1960,1959,1877,1972,1877,1941,1952,-18,-7,104,2116
20150923,1941,1952,1928,1953,1928,1944,1943,-8,-9,88,2146
20150924,1944,1943,1941,1941,1940,1940,1940,-3,-3,10,2152
20150925,1940,1940,1954,1954,1947,1950,1951,10,11,22,2138
20150928,1950,1951,1920,1926,1903,1903,1918,-48,-33,40,2170
20150929,1903,1918,1914,1925,1891,1891,1909,-27,-9,748,2140
20150930,1891,1909,1869,1899,1869,1899,1885,-10,-24,18,2146
20151008,1899,1885,1897,1897,1881,1881,1890,-4,5,10,2146
20151009,1881,1890,1888,1938,1888,1901,1898,11,8,190,2278
20151012,1901,1898,1982,1982,1893,1913,1908,15,10,744,2234
20151013,1913,1908,1948,1948,1895,1902,1898,-6,-10,634,2332
20151014,1902,1898,1875,1924,1875,1909,1898,11,0,156,2372
20151015,1909,1898,1903,1915,1902,1910,1908,12,10,112,2298
20151016,1910,1908,1903,1910,1903,1910,1903,2,-5,16,2310
20151019,1910,1903,1912,1912,1893,1893,1899,-10,-4,84,2318
20151020,1893,1899,1892,1899,1874,1878,1883,-21,-16,452,2380
20151021,1878,1883,1877,1887,1870,1880,1875,-3,-8,210,2390
20151022,1880,1875,1889,1889,1873,1884,1882,9,7,52,2410
20151023,1884,1882,1891,1891,1852,1876,1866,-6,-16,228,2600
20151026,1876,1866,1915,1915,1842,1865,1864,-1,-2,96,2656
20151027,1865,1864,1860,1867,1840,1865,1859,1,-5,330,2834
20151028,1865,1859,1856,1860,1842,1842,1847,-17,-12,156,2862
20151029,1842,1847,1845,1856,1831,1850,1843,3,-4,292,3028
20151030,1850,1843,1835,1850,1831,1847,1846,4,3,130,3128
20151102,1847,1846,1848,1856,1844,1846,1850,0,4,482,3598
20151103,1846,1850,1851,1853,1819,1819,1836,-31,-14,402,3884
20151104,1819,1836,1821,1828,1805,1806,1816,-30,-20,1588,4748
20151105,1806,1816,1805,1812,1787,1789,1796,-27,-20,1240,4946
20151106,1789,1796,1786,1802,1786,1791,1792,-5,-4,450,5200
20151109,1791,1792,1789,1806,1777,1804,1796,12,4,2772,6644
20151110,1804,1796,1806,1807,1791,1797,1801,1,5,1512,7526
20151111,1797,1801,1793,1795,1780,1780,1787,-21,-14,2194,8298
20151112,1780,1787,1777,1780,1770,1775,1773,-12,-14,2490,8590
20151113,1775,1773,1777,1786,1775,1775,1780,2,7,2018,9390
20151116,1775,1780,1775,1790,1770,1778,1780,-2,0,3096,11390
20151117,1778,1780,1776,1782,1775,1779,1777,-1,-3,3326,13368
20151118,1779,1777,1787,1787,1759,1762,1768,-15,-9,4814,16548
20151119,1762,1768,1760,1766,1723,1733,1735,-35,-33,6946,18902
20151120,1733,1735,1731,1739,1724,1727,1729,-8,-6,4948,19710
20151123,1727,1729,1726,1728,1685,1695,1701,-34,-28,8694,22428
20151124,1695,1701,1694,1718,1688,1718,1698,17,-3,8540,25554
20151125,1718,1698,1718,1782,1708,1728,1727,30,29,13692,30172
20151126,1728,1727,1727,1773,1719,1741,1744,14,17,11348,31108
20151127,1741,1744,1737,1740,1708,1710,1719,-34,-25,6832,30866
20151130,1710,1719,1710,1710,1677,1679,1690,-40,-29,9620,33598
hc1606,20150616,2560,2560,,,,2501,2501,-59,-59,0,0
20150617,2501,2501,,,,2501,2501,0,0,0,0
20150618,2501,2501,,,,2441,2441,-60,-60,0,0
20150619,2441,2441,,,,2451,2451,10,10,0,0
20150623,2451,2451,,,,2431,2431,-20,-20,0,0
20150624,2431,2431,,,,2466,2466,35,35,0,0
20150625,2466,2466,,,,2474,2474,8,8,0,0
20150626,2474,2474,,,,2438,2438,-36,-36,0,0
20150629,2438,2438,,,,2429,2429,-9,-9,0,0
20150630,2429,2429,,,,2345,2345,-84,-84,0,0
20150701,2345,2345,2449,2449,2312,2312,2380,-33,35,8,2
20150702,2312,2380,,,,2381,2381,1,1,0,2
20150703,2381,2381,2388,2397,2388,2397,2392,16,11,4,0
20150706,2397,2392,,,,2272,2272,-120,-120,0,0
20150707,2272,2272,,,,2193,2193,-79,-79,0,0
20150708,2193,2193,,,,2096,2096,-97,-97,0,0
20150709,2096,2096,,,,2178,2178,82,82,0,0
20150710,2178,2178,,,,2214,2214,36,36,0,0
20150713,2214,2214,,,,2186,2186,-28,-28,0,0
20150714,2186,2186,,,,2178,2178,-8,-8,0,0
20150715,2178,2178,2216,2216,2216,2216,2216,38,38,2,2
20150716,2216,2216,2229,2229,2152,2152,2190,-64,-26,4,2
20150717,2152,2190,,,,2188,2188,-2,-2,0,2
20150720,2188,2188,,,,2188,2188,0,0,0,2
20150721,2188,2188,,,,2189,2189,1,1,0,2
20150722,2189,2189,,,,2137,2137,-52,-52,0,2
20150723,2137,2137,,,,2137,2137,0,0,0,2
20150724,2137,2137,,,,2202,2202,65,65,0,2
20150727,2202,2202,,,,2226,2226,24,24,0,2
20150728,2226,2226,,,,2219,2219,-7,-7,0,2
20150729,2219,2219,,,,2234,2234,15,15,0,2
20150730,2234,2234,,,,2225,2225,-9,-9,0,2
20150731,2225,2225,,,,2185,2185,-40,-40,0,2
20150803,2185,2185,,,,2141,2141,-44,-44,0,2
20150804,2141,2141,,,,2144,2144,3,3,0,2
20150805,2144,2144,,,,2160,2160,16,16,0,2
20150806,2160,2160,,,,2162,2162,2,2,0,2
20150807,2162,2162,,,,2142,2142,-20,-20,0,2
20150810,2142,2142,,,,2130,2130,-12,-12,0,2
20150811,2130,2130,2089,2230,2089,2150,2175,20,45,40,2
20150812,2150,2175,,,,2168,2168,-7,-7,0,2
20150813,2168,2168,,,,2184,2184,16,16,0,2
20150814,2184,2184,,,,2184,2184,0,0,0,2
20150817,2184,2184,,,,2182,2182,-2,-2,0,2
20150818,2182,2182,,,,2167,2167,-15,-15,0,2
20150819,2167,2167,,,,2149,2149,-18,-18,0,2
20150820,2149,2149,,,,2132,2132,-17,-17,0,2
20150821,2132,2132,,,,2128,2128,-4,-4,0,2
20150824,2128,2128,,,,2021,2021,-107,-107,0,2
20150825,2021,2021,,,,2018,2018,-3,-3,0,2
20150826,2018,2018,1967,1967,1967,1967,1967,-51,-51,2,0
20150827,1967,1967,1943,1943,1943,1943,1943,-24,-24,2,2
20150828,1943,1943,,,,1964,1964,21,21,0,2
20150831,1964,1964,2062,2062,1985,2026,2010,62,46,10,2
20150901,2026,2010,,,,2010,2010,0,0,0,2
20150902,2010,2010,,,,2010,2010,0,0,0,2
20150907,2010,2010,,,,2010,2010,0,0,0,2
20150908,2010,2010,,,,2005,2005,-5,-5,0,2
20150909,2005,2005,,,,2005,2005,0,0,0,2
20150910,2005,2005,,,,1988,1988,-17,-17,0,2
20150911,1988,1988,,,,1995,1995,7,7,0,2
20150914,1995,1995,,,,1977,1977,-18,-18,0,2
20150915,1977,1977,,,,1980,1980,3,3,0,2
20150916,1980,1980,,,,1972,1972,-8,-8,0,2
20150917,1972,1972,,,,1972,1972,0,0,0,2
20150918,1972,1972,,,,1972,1972,0,0,0,2
20150921,1972,1972,,,,1972,1972,0,0,0,2
20150922,1972,1972,,,,1965,1965,-7,-7,0,2
20150923,1965,1965,,,,1956,1956,-9,-9,0,2
20150924,1956,1956,,,,1956,1956,0,0,0,2
20150925,1956,1956,1930,1930,1930,1930,1930,-26,-26,2,0
20150928,1930,1930,,,,1898,1898,-32,-32,0,0
20150929,1898,1898,,,,1889,1889,-9,-9,0,0
20150930,1889,1889,,,,1865,1865,-24,-24,0,0
20151008,1865,1865,,,,1870,1870,5,5,0,0
20151009,1870,1870,,,,1878,1878,8,8,0,0
20151012,1878,1878,,,,1888,1888,10,10,0,0
20151013,1888,1888,,,,1878,1878,-10,-10,0,0
20151014,1878,1878,,,,1878,1878,0,0,0,0
20151015,1878,1878,,,,1888,1888,10,10,0,0
20151016,1888,1888,,,,1883,1883,-5,-5,0,0
20151019,1883,1883,,,,1879,1879,-4,-4,0,0
20151020,1879,1879,,,,1863,1863,-16,-16,0,0
20151021,1863,1863,,,,1856,1856,-7,-7,0,0
20151022,1856,1856,,,,1863,1863,7,7,0,0
20151023,1863,1863,,,,1847,1847,-16,-16,0,0
20151026,1847,1847,,,,1845,1845,-2,-2,0,0
20151027,1845,1845,,,,1840,1840,-5,-5,0,0
20151028,1840,1840,,,,1828,1828,-12,-12,0,0
20151029,1828,1828,,,,1825,1825,-3,-3,0,0
20151030,1825,1825,,,,1828,1828,3,3,0,0
20151102,1828,1828,,,,1832,1832,4,4,0,0
20151103,1832,1832,,,,1818,1818,-14,-14,0,0
20151104,1818,1818,,,,1798,1798,-20,-20,0,0
20151105,1798,1798,,,,1779,1779,-19,-19,0,0
20151106,1779,1779,,,,1775,1775,-4,-4,0,0
20151109,1775,1775,,,,1779,1779,4,4,0,0
20151110,1779,1779,,,,1784,1784,5,5,0,0
20151111,1784,1784,,,,1771,1771,-13,-13,0,0
20151112,1771,1771,,,,1757,1757,-14,-14,0,0
20151113,1757,1757,,,,1764,1764,7,7,0,0
20151116,1764,1764,,,,1764,1764,0,0,0,0
20151117,1764,1764,,,,1761,1761,-3,-3,0,0
20151118,1761,1761,,,,1752,1752,-9,-9,0,0
20151119,1752,1752,,,,1720,1720,-32,-32,0,0
20151120,1720,1720,,,,1714,1714,-6,-6,0,0
20151123,1714,1714,,,,1687,1687,-27,-27,0,0
20151124,1687,1687,,,,1684,1684,-3,-3,0,0
20151125,1684,1684,,,,1713,1713,29,29,0,0
20151126,1713,1713,,,,1730,1730,17,17,0,0
20151127,1730,1730,,,,1705,1705,-25,-25,0,0
20151130,1705,1705,,,,1677,1677,-28,-28,0,0
hc1607,20150716,2216,2216,,,,2190,2190,-26,-26,0,0
20150717,2190,2190,,,,2188,2188,-2,-2,0,0
20150720,2188,2188,,,,2239,2239,51,51,0,0
20150721,2239,2239,,,,2240,2240,1,1,0,0
20150722,2240,2240,,,,2187,2187,-53,-53,0,0
20150723,2187,2187,,,,2170,2170,-17,-17,0,0
20150724,2170,2170,,,,2236,2236,66,66,0,0
20150727,2236,2236,,,,2260,2260,24,24,0,0
20150728,2260,2260,,,,2253,2253,-7,-7,0,0
20150729,2253,2253,,,,2268,2268,15,15,0,0
20150730,2268,2268,,,,2259,2259,-9,-9,0,0
20150731,2259,2259,,,,2222,2222,-37,-37,0,0
20150803,2222,2222,,,,2177,2177,-45,-45,0,0
20150804,2177,2177,,,,2180,2180,3,3,0,0
20150805,2180,2180,,,,2197,2197,17,17,0,0
20150806,2197,2197,,,,2199,2199,2,2,0,0
20150807,2199,2199,,,,2178,2178,-21,-21,0,0
20150810,2178,2178,,,,2166,2166,-12,-12,0,0
20150811,2166,2166,,,,2211,2211,45,45,0,0
20150812,2211,2211,,,,2204,2204,-7,-7,0,0
20150813,2204,2204,,,,2221,2221,17,17,0,0
20150814,2221,2221,,,,2218,2218,-3,-3,0,0
20150817,2218,2218,,,,2216,2216,-2,-2,0,0
20150818,2216,2216,,,,2200,2200,-16,-16,0,0
20150819,2200,2200,,,,2181,2181,-19,-19,0,0
20150820,2181,2181,,,,2164,2164,-17,-17,0,0
20150821,2164,2164,,,,2160,2160,-4,-4,0,0
20150824,2160,2160,2160,2160,2160,2160,2160,0,0,2,2
20150825,2160,2160,,,,2157,2157,-3,-3,0,2
20150826,2157,2157,,,,2102,2102,-55,-55,0,2
20150827,2102,2102,1997,1997,1997,1997,1997,-105,-105,2,0
20150828,1997,1997,,,,2019,2019,22,22,0,0
20150831,2019,2019,,,,2066,2066,47,47,0,0
20150901,2066,2066,,,,2062,2062,-4,-4,0,0
20150902,2062,2062,,,,2062,2062,0,0,0,0
20150907,2062,2062,,,,2037,2037,-25,-25,0,0
20150908,2037,2037,,,,2032,2032,-5,-5,0,0
20150909,2032,2032,,,,2054,2054,22,22,0,0
20150910,2054,2054,,,,2037,2037,-17,-17,0,0
20150911,2037,2037,,,,2045,2045,8,8,0,0
20150914,2045,2045,,,,2027,2027,-18,-18,0,0
20150915,2027,2027,,,,2030,2030,3,3,0,0
20150916,2030,2030,,,,2022,2022,-8,-8,0,0
20150917,2022,2022,,,,2027,2027,5,5,0,0
20150918,2027,2027,,,,2021,2021,-6,-6,0,0
20150921,2021,2021,,,,1995,1995,-26,-26,0,0
20150922,1995,1995,,,,1988,1988,-7,-7,0,0
20150923,1988,1988,,,,1979,1979,-9,-9,0,0
20150924,1979,1979,,,,1976,1976,-3,-3,0,0
20150925,1976,1976,,,,1949,1949,-27,-27,0,0
20150928,1949,1949,,,,1916,1916,-33,-33,0,0
20150929,1916,1916,,,,1907,1907,-9,-9,0,0
20150930,1907,1907,,,,1883,1883,-24,-24,0,0
20151008,1883,1883,,,,1888,1888,5,5,0,0
20151009,1888,1888,,,,1896,1896,8,8,0,0
20151012,1896,1896,,,,1906,1906,10,10,0,0
20151013,1906,1906,,,,1896,1896,-10,-10,0,0
20151014,1896,1896,,,,1896,1896,0,0,0,0
20151015,1896,1896,,,,1906,1906,10,10,0,0
20151016,1906,1906,,,,1901,1901,-5,-5,0,0
20151019,1901,1901,,,,1897,1897,-4,-4,0,0
20151020,1897,1897,,,,1881,1881,-16,-16,0,0
20151021,1881,1881,,,,1873,1873,-8,-8,0,0
20151022,1873,1873,,,,1880,1880,7,7,0,0
20151023,1880,1880,,,,1864,1864,-16,-16,0,0
20151026,1864,1864,,,,1862,1862,-2,-2,0,0
20151027,1862,1862,,,,1857,1857,-5,-5,0,0
20151028,1857,1857,,,,1845,1845,-12,-12,0,0
20151029,1845,1845,,,,1841,1841,-4,-4,0,0
20151030,1841,1841,,,,1844,1844,3,3,0,0
20151102,1844,1844,,,,1848,1848,4,4,0,0
20151103,1848,1848,,,,1834,1834,-14,-14,0,0
20151104,1834,1834,,,,1814,1814,-20,-20,0,0
20151105,1814,1814,,,,1794,1794,-20,-20,0,0
20151106,1794,1794,,,,1790,1790,-4,-4,0,0
20151109,1790,1790,,,,1794,1794,4,4,0,0
20151110,1794,1794,,,,1799,1799,5,5,0,0
20151111,1799,1799,,,,1785,1785,-14,-14,0,0
20151112,1785,1785,,,,1771,1771,-14,-14,0,0
20151113,1771,1771,,,,1778,1778,7,7,0,0
20151116,1778,1778,,,,1778,1778,0,0,0,0
20151117,1778,1778,,,,1775,1775,-3,-3,0,0
20151118,1775,1775,,,,1766,1766,-9,-9,0,0
20151119,1766,1766,,,,1733,1733,-33,-33,0,0
20151120,1733,1733,,,,1727,1727,-6,-6,0,0
20151123,1727,1727,,,,1699,1699,-28,-28,0,0
20151124,1699,1699,,,,1696,1696,-3,-3,0,0
20151125,1696,1696,,,,1725,1725,29,29,0,0
20151126,1725,1725,,,,1742,1742,17,17,0,0
20151127,1742,1742,1698,1796,1698,1766,1753,24,11,6,0
20151130,1766,1753,,,,1724,1724,-29,-29,0,0
hc1608,20150818,2216,2216,,,,2200,2200,-16,-16,0,0
20150819,2200,2200,,,,2181,2181,-19,-19,0,0
20150820,2181,2181,,,,2164,2164,-17,-17,0,0
20150821,2164,2164,,,,2160,2160,-4,-4,0,0
20150824,2160,2160,,,,2090,2090,-70,-70,0,0
20150825,2090,2090,1950,2059,1950,2020,2006,-70,-84,14,2
20150826,2020,2006,,,,2006,2006,0,0,0,2
20150827,2006,2006,,,,2006,2006,0,0,0,2
20150828,2006,2006,,,,2006,2006,0,0,0,2
20150831,2006,2006,,,,2006,2006,0,0,0,2
20150901,2006,2006,,,,2006,2006,0,0,0,2
20150902,2006,2006,,,,2006,2006,0,0,0,2
20150907,2006,2006,2055,2055,2055,2055,2055,49,49,2,2
20150908,2055,2055,,,,2050,2050,-5,-5,0,2
20150909,2050,2050,,,,2055,2055,5,5,0,2
20150910,2055,2055,,,,2038,2038,-17,-17,0,2
20150911,2038,2038,,,,2046,2046,8,8,0,2
20150914,2046,2046,,,,2028,2028,-18,-18,0,2
20150915,2028,2028,,,,2031,2031,3,3,0,2
20150916,2031,2031,,,,2023,2023,-8,-8,0,2
20150917,2023,2023,,,,2028,2028,5,5,0,2
20150918,2028,2028,,,,2022,2022,-6,-6,0,2
20150921,2022,2022,,,,2022,2022,0,0,0,2
20150922,2022,2022,,,,2022,2022,0,0,0,2
20150923,2022,2022,,,,2022,2022,0,0,0,2
20150924,2022,2022,,,,2022,2022,0,0,0,2
20150925,2022,2022,,,,2022,2022,0,0,0,2
20150928,2022,2022,,,,2022,2022,0,0,0,2
20150929,2022,2022,,,,1996,1996,-26,-26,0,2
20150930,1996,1996,,,,1971,1971,-25,-25,0,2
20151008,1971,1971,,,,1971,1971,0,0,0,2
20151009,1971,1971,,,,1979,1979,8,8,0,2
20151012,1979,1979,,,,1979,1979,0,0,0,2
20151013,1979,1979,,,,1979,1979,0,0,0,2
20151014,1979,1979,,,,1979,1979,0,0,0,2
20151015,1979,1979,,,,1979,1979,0,0,0,2
20151016,1979,1979,,,,1979,1979,0,0,0,2
20151019,1979,1979,,,,1979,1979,0,0,0,2
20151020,1979,1979,,,,1979,1979,0,0,0,2
20151021,1979,1979,,,,1979,1979,0,0,0,2
20151022,1979,1979,,,,1979,1979,0,0,0,2
20151023,1979,1979,,,,1979,1979,0,0,0,2
20151026,1979,1979,,,,1971,1971,-8,-8,0,2
20151027,1971,1971,,,,1963,1963,-8,-8,0,2
20151028,1963,1963,,,,1953,1953,-10,-10,0,2
20151029,1953,1953,,,,1953,1953,0,0,0,2
20151030,1953,1953,,,,1953,1953,0,0,0,2
20151102,1953,1953,,,,1958,1958,5,5,0,2
20151103,1958,1958,,,,1943,1943,-15,-15,0,2
20151104,1943,1943,1871,1871,1871,1871,1871,-72,-72,2,2
20151105,1871,1871,,,,1851,1851,-20,-20,0,2
20151106,1851,1851,,,,1851,1851,0,0,0,2
20151109,1851,1851,,,,1851,1851,0,0,0,2
20151110,1851,1851,,,,1856,1856,5,5,0,2
20151111,1856,1856,,,,1856,1856,0,0,0,2
20151112,1856,1856,,,,1842,1842,-14,-14,0,2
20151113,1842,1842,,,,1842,1842,0,0,0,2
20151116,1842,1842,,,,1842,1842,0,0,0,2
20151117,1842,1842,,,,1842,1842,0,0,0,2
20151118,1842,1842,1767,1778,1767,1778,1772,-64,-70,4,0
20151119,1778,1772,,,,1739,1739,-33,-33,0,0
20151120,1739,1739,1800,1800,1700,1700,1750,-39,11,680,0
20151123,1700,1750,,,,1722,1722,-28,-28,0,0
20151124,1722,1722,,,,1719,1719,-3,-3,0,0
20151125,1719,1719,,,,1749,1749,30,30,0,0
20151126,1749,1749,,,,1766,1766,17,17,0,0
20151127,1766,1766,1766,1799,1701,1701,1755,-65,-11,6,0
20151130,1701,1755,1748,1748,1748,1748,1748,-7,-7,2,2
hc1609,20150916,2031,2031,2075,2075,2020,2020,2047,-11,16,8,4
20150917,2020,2047,,,,2047,2047,0,0,0,4
20150918,2047,2047,2000,2020,2000,2020,2006,-27,-41,6,4
20150921,2020,2006,2063,2063,2056,2056,2059,50,53,8,4
20150922,2056,2059,2045,2045,2045,2045,2045,-14,-14,4,0
20150923,2045,2045,,,,2045,2045,0,0,0,0
20150924,2045,2045,,,,2042,2042,-3,-3,0,0
20150925,2042,2042,,,,2014,2014,-28,-28,0,0
20150928,2014,2014,,,,1980,1980,-34,-34,0,0
20150929,1980,1980,,,,1980,1980,0,0,0,0
20150930,1980,1980,,,,1955,1955,-25,-25,0,0
20151008,1955,1955,,,,1960,1960,5,5,0,0
20151009,1960,1960,,,,1968,1968,8,8,0,0
20151012,1968,1968,,,,1978,1978,10,10,0,0
20151013,1978,1978,2020,2020,2020,2020,2020,42,42,2,2
20151014,2020,2020,,,,2020,2020,0,0,0,2
20151015,2020,2020,,,,2020,2020,0,0,0,2
20151016,2020,2020,,,,2020,2020,0,0,0,2
20151019,2020,2020,,,,2020,2020,0,0,0,2
20151020,2020,2020,,,,2020,2020,0,0,0,2
20151021,2020,2020,,,,2020,2020,0,0,0,2
20151022,2020,2020,,,,2019,2019,-1,-1,0,2
20151023,2019,2019,,,,2019,2019,0,0,0,2
20151026,2019,2019,,,,1991,1991,-28,-28,0,2
20151027,1991,1991,,,,1983,1983,-8,-8,0,2
20151028,1983,1983,,,,1973,1973,-10,-10,0,2
20151029,1973,1973,1920,1920,1920,1920,1920,-53,-53,2,2
20151030,1920,1920,,,,1920,1920,0,0,0,2
20151102,1920,1920,,,,1924,1924,4,4,0,2
20151103,1924,1924,,,,1909,1909,-15,-15,0,2
20151104,1909,1909,,,,1838,1838,-71,-71,0,2
20151105,1838,1838,,,,1818,1818,-20,-20,0,2
20151106,1818,1818,,,,1818,1818,0,0,0,2
20151109,1818,1818,1897,1897,1887,1887,1892,69,74,4,2
20151110,1887,1892,,,,1897,1897,5,5,0,2
20151111,1897,1897,,,,1883,1883,-14,-14,0,2
20151112,1883,1883,1788,1788,1788,1788,1788,-95,-95,2,0
20151113,1788,1788,,,,1795,1795,7,7,0,0
20151116,1795,1795,,,,1795,1795,0,0,0,0
20151117,1795,1795,,,,1792,1792,-3,-3,0,0
20151118,1792,1792,1737,1834,1737,1760,1767,-32,-25,8,2
20151119,1760,1767,1761,1761,1761,1761,1761,-6,-6,2,2
20151120,1761,1761,,,,1761,1761,0,0,0,2
20151123,1761,1761,,,,1761,1761,0,0,0,2
20151124,1761,1761,,,,1761,1761,0,0,0,2
20151125,1761,1761,,,,1761,1761,0,0,0,2
20151126,1761,1761,1810,1810,1810,1810,1810,49,49,2,0
20151127,1810,1810,,,,1799,1799,-11,-11,0,0
20151130,1799,1799,,,,1791,1791,-8,-8,0,0
hc1610,20151016,2020,2020,1955,1955,1955,1955,1955,-65,-65,2,2
20151019,1955,1955,,,,1955,1955,0,0,0,2
20151020,1955,1955,,,,1938,1938,-17,-17,0,2
20151021,1938,1938,,,,1938,1938,0,0,0,2
20151022,1938,1938,,,,1938,1938,0,0,0,2
20151023,1938,1938,,,,1938,1938,0,0,0,2
20151026,1938,1938,,,,1917,1917,-21,-21,0,2
20151027,1917,1917,,,,1917,1917,0,0,0,2
20151028,1917,1917,1885,1897,1883,1883,1888,-34,-29,6,4
20151029,1883,1888,,,,1888,1888,0,0,0,4
20151030,1888,1888,,,,1888,1888,0,0,0,4
20151102,1888,1888,1872,1872,1872,1872,1872,-16,-16,2,6
20151103,1872,1872,1847,1847,1847,1847,1847,-25,-25,2,8
20151104,1847,1847,,,,1847,1847,0,0,0,8
20151105,1847,1847,,,,1844,1844,-3,-3,0,8
20151106,1844,1844,,,,1844,1844,0,0,0,8
20151109,1844,1844,,,,1844,1844,0,0,0,8
20151110,1844,1844,,,,1844,1844,0,0,0,8
20151111,1844,1844,1847,1847,1847,1847,1847,3,3,4,12
20151112,1847,1847,1862,1871,1800,1800,1831,-47,-16,18,18
20151113,1800,1831,1781,1797,1781,1781,1783,-50,-48,16,14
20151116,1781,1783,1778,1778,1778,1778,1778,-5,-5,2,14
20151117,1778,1778,1815,1815,1810,1810,1814,32,36,42,52
20151118,1810,1814,,,,1808,1808,-6,-6,0,52
20151119,1808,1808,1748,1784,1719,1784,1749,-24,-59,26,60
20151120,1784,1749,,,,1749,1749,0,0,0,60
20151123,1749,1749,1705,1705,1705,1705,1705,-44,-44,6,60
20151124,1705,1705,,,,1705,1705,0,0,0,60
20151125,1705,1705,1762,1762,1719,1759,1746,54,41,6,62
20151126,1759,1746,1751,1751,1751,1751,1751,5,5,6,62
20151127,1751,1751,1733,1733,1717,1717,1727,-34,-24,6,60
20151130,1717,1727,,,,1727,1727,0,0,0,60
hc1611,20151117,1778,1778,,,,1778,1778,0,0,0,0
20151118,1778,1778,,,,1778,1778,0,0,0,0
20151119,1778,1778,,,,1720,1720,-58,-58,0,0
20151120,1720,1720,,,,1730,1730,10,10,0,0
20151123,1730,1730,,,,1730,1730,0,0,0,0
20151124,1730,1730,,,,1730,1730,0,0,0,0
20151125,1730,1730,,,,1730,1730,0,0,0,0
20151126,1730,1730,,,,1730,1730,0,0,0,0
20151127,1730,1730,1818,1818,1740,1740,1767,10,37,6,0
20151130,1740,1767,1750,1750,1750,1750,1750,-17,-17,2,2
ni1507,20150327,102070,102070,101870,102710,100650,101080,101180,-990,-890,28860,14364
20150330,101080,101180,99010,100000,96820,98430,98390,-2750,-2790,66684,34186
20150331,98430,98390,98000,98200,93840,95040,95950,-3350,-2440,105600,54888
20150401,95040,95950,93940,94130,91270,92500,92870,-3450,-3080,158952,70960
20150402,92500,92870,92870,96600,92550,96160,94320,3290,1450,202848,80724
20150403,96160,94320,96000,97800,95660,97300,96530,2980,2210,150282,80998
20150407,97300,96530,97500,97980,95950,96420,96790,-110,260,75688,83542
20150408,96420,96790,94500,95630,93300,93950,94450,-2840,-2340,183088,95102
20150409,93950,94450,94450,95260,93880,94300,94500,-150,50,160974,99084
20150410,94300,94500,94500,94970,93180,94540,94080,40,-420,137722,105628
20150413,94540,94080,94280,95670,93700,95230,94720,1150,640,180214,112858
20150414,95230,94720,94780,95070,92810,93100,93740,-1620,-980,199150,127690
20150415,93100,93740,92700,95000,92640,94730,93970,990,230,220106,132258
20150416,94730,93970,94610,95900,94260,95400,95090,1430,1120,195920,131624
20150417,95400,95090,96280,96660,95010,95850,95900,760,810,168702,127284
20150420,95850,95900,95980,96550,95200,95410,95910,-490,10,148104,116410
20150421,95410,95910,95330,96800,94900,95880,95910,-30,0,140930,110552
20150422,95880,95910,95910,96720,95750,96330,96260,420,350,123902,110516
20150423,96330,96260,96120,96500,95600,95860,96140,-400,-120,101066,110646
20150424,95860,96140,95840,97900,95700,97830,96660,1690,520,118180,113816
20150427,97830,96660,98000,101490,97990,101490,100090,4830,3430,241904,116290
20150428,101490,100090,102490,104530,101420,102650,103110,2560,3020,285722,111958
20150429,102650,103110,102350,104400,100500,101020,102440,-2090,-670,317634,111334
20150430,101020,102440,101190,106980,101160,106010,104070,3570,1630,552750,125970
20150504,106010,104070,106010,108900,105450,107580,107000,3510,2930,278844,128702
20150505,107580,107000,107850,109230,106160,107960,107990,960,990,518266,133626
20150506,107960,107990,110000,113380,109690,113380,112100,5390,4110,609024,134182
20150507,113380,112100,114580,115300,111050,112500,112960,400,860,969052,123678
20150508,112500,112960,113700,114100,110000,112300,111810,-660,-1150,878416,118556
20150511,112300,111810,111810,114430,111060,113880,112550,2070,740,728054,128054
20150512,113880,112550,113300,115060,111270,111600,113270,-950,720,871696,126536
20150513,111600,113270,112280,113650,110780,111750,112190,-1520,-1080,752614,123868
20150514,111750,112190,112100,112100,107060,109400,109780,-2790,-2410,760542,121384
20150515,109400,109780,108980,110960,108540,110210,109450,430,-330,609290,130696
20150518,110210,109450,109390,109690,108200,108610,109160,-840,-290,544094,121292
20150519,108610,109160,108300,108890,106160,106430,107730,-2730,-1430,467078,116362
20150520,106430,107730,105500,105990,102340,102340,103570,-5390,-4160,318956,107676
20150521,102340,103570,100490,102550,100170,101070,101470,-2500,-2100,480198,106184
20150522,101070,101470,100960,103370,96710,100070,101630,-1400,160,741862,109808
20150525,100070,101630,98900,100580,98110,99480,99660,-2150,-1970,610232,114898
20150526,99480,99660,99670,101900,99660,100010,101060,350,1400,550278,115194
20150527,100010,101060,99990,101180,99200,100670,100470,-390,-590,406048,119564
20150528,100670,100470,100420,102040,100400,101130,101220,660,750,545222,116488
20150529,101130,101220,101000,101680,97740,99200,99860,-2020,-1360,462924,116460
20150601,99200,99860,98860,99290,97800,98040,98560,-1820,-1300,245968,108666
20150602,98040,98560,98350,100600,98120,100480,99740,1920,1180,274378,85598
20150603,100480,99740,100510,101000,99250,99280,100320,-460,580,107274,72596
20150604,99280,100320,99980,99980,97740,98650,99120,-1670,-1200,71564,68476
20150605,98650,99120,98680,99380,98130,98550,98940,-570,-180,49526,64814
20150608,98550,98940,98780,100570,98410,100570,99370,1630,430,63534,58322
20150609,100570,99370,101000,102100,100860,101020,101560,1650,2190,62398,52110
20150610,101020,101560,101560,102000,100700,101390,101380,-170,-180,25860,50888
20150611,101390,101380,101820,102250,101320,101450,101770,70,390,20214,49176
20150612,101450,101770,101520,101630,98100,98500,99900,-3270,-1870,28838,46906
20150615,98500,99900,98170,98990,97520,97550,98250,-2350,-1650,20514,44182
20150616,97550,98250,97380,98060,95400,95670,96900,-2580,-1350,24814,41062
20150617,95670,96900,96000,96100,94610,95170,95490,-1730,-1410,27268,34370
20150618,95170,95490,96000,96620,95700,96050,96100,560,610,21950,29142
20150619,96050,96100,95650,95910,93930,94390,95020,-1710,-1080,20550,22630
20150623,94390,95020,93890,94780,93510,94400,94300,-620,-720,7580,21288
20150624,94400,94300,94980,95880,94680,95520,95180,1220,880,12102,19158
20150625,95520,95180,95310,95350,94170,94220,94720,-960,-460,8484,17080
20150626,94220,94720,94100,94630,89980,93220,93540,-1500,-1180,10680,14014
20150629,93220,93540,93160,93200,88860,89600,91160,-3940,-2380,9718,11594
20150630,89600,91160,89000,89000,86600,86600,87090,-4560,-4070,5854,10880
20150701,86600,87090,84520,88600,80510,87700,87040,610,-50,2984,9348
20150702,87700,87040,87750,89000,87000,88600,88310,1560,1270,480,9048
20150703,88600,88310,89300,89800,87800,88250,88650,-60,340,1164,8256
20150706,88250,88650,86760,86760,84210,85700,86020,-2950,-2630,504,7872
20150707,85700,86020,84580,87000,83510,83510,85280,-2510,-740,552,7740
20150708,83510,85280,81010,81010,81010,81010,81010,-4270,-4270,60,7740
20150709,81010,81010,77000,86000,74520,83000,79790,1990,-1220,1104,6972
20150710,83000,79790,82330,83770,82330,83770,83650,3980,3860,144,6876
20150713,83770,83650,81300,82000,81000,81100,81600,-2550,-2050,756,6348
20150714,81100,81600,85650,85680,84900,85400,85590,3800,3990,276,6072
20150715,85400,85590,85500,87500,85500,87500,86330,1910,740,240,5940
ni1508,20150327,102070,102070,102710,102710,100040,101210,101270,-860,-800,742,534
20150330,101210,101270,99200,105990,97010,98520,98380,-2750,-2890,796,952
20150331,98520,98380,97170,98110,94100,94900,95420,-3480,-2960,2070,2190
20150401,94900,95420,93840,94090,91600,92700,92910,-2720,-2510,1256,2406
20150402,92700,92910,93090,96150,92500,96000,94220,3090,1310,1456,2008
20150403,96000,94220,95550,97800,95500,96900,96390,2680,2170,318,2072
20150407,96900,96390,97220,97580,95500,96070,96450,-320,60,1222,2716
20150408,96070,96450,94410,95150,93100,93550,94280,-2900,-2170,1618,3076
20150409,93550,94280,94100,94810,93560,93840,94010,-440,-270,710,3136
20150410,93840,94010,94150,94490,92950,94240,93630,230,-380,512,3194
20150413,94240,93630,94240,95180,93290,94830,94180,1200,550,1188,3648
20150414,94830,94180,94170,94420,92400,92730,93180,-1450,-1000,1904,4202
20150415,92730,93180,92200,94100,92200,93800,93470,620,290,1610,5288
20150416,93800,93470,93800,95260,93350,94550,94360,1080,890,1534,5392
20150417,94550,94360,95350,95610,94170,94700,94790,340,430,1794,5776
20150420,94700,94790,94750,96290,94180,94260,95250,-530,460,4026,5724
20150421,94260,95250,94200,95530,93900,94800,94710,-450,-540,1670,5874
20150422,94800,94710,94960,95530,94840,95250,95210,540,500,1912,6026
20150423,95250,95210,95270,95500,94840,94990,95200,-220,-10,1450,6198
20150424,94990,95200,95130,96800,94880,96800,95790,1600,590,2740,6828
20150427,96800,95790,97900,100570,96950,100570,99490,4780,3700,4124,6670
20150428,100570,99490,102000,103230,100200,101380,101620,1890,2130,4506,6968
20150429,101380,101620,101250,103310,99370,100000,101330,-1620,-290,3562,7380
20150430,100000,101330,100350,105540,98910,104750,102710,3420,1380,3406,7556
20150504,104750,102710,104700,107230,104520,106770,105890,4060,3180,2482,7502
20150505,106770,105890,106440,107800,104760,106130,106410,240,520,4458,7548
20150506,106130,106410,107170,111730,107010,109450,109300,3040,2890,11382,11052
20150507,109450,109300,111000,111000,105400,106040,107790,-3260,-1510,7378,10300
20150508,106040,107790,107170,109320,106000,109200,107590,1410,-200,7394,7662
20150511,109200,107590,108590,111680,108110,111030,109660,3440,2070,5012,6948
20150512,111030,109660,111030,111030,107010,107710,109320,-1950,-340,3162,6706
20150513,107710,109320,108180,110000,107480,108580,108410,-740,-910,3004,6556
20150514,108580,108410,108380,108490,105120,106410,106770,-2000,-1640,2340,6418
20150515,106410,106770,106080,107610,105740,106960,106720,190,-50,1848,6258
20150518,106960,106720,105760,106560,105600,105830,106090,-890,-630,1112,6162
20150519,105830,106090,105610,106010,103750,103910,104880,-2180,-1210,1272,6044
20150520,103910,104880,103550,103550,99630,99630,100600,-5250,-4280,1144,6030
20150521,99630,100600,98500,100510,98500,99680,99690,-920,-910,1218,5698
20150522,99680,99690,99380,101270,97530,98780,99730,-910,40,2634,4210
20150525,98780,99730,97500,98820,96980,98200,98140,-1530,-1590,746,4232
20150526,98200,98140,98530,99750,98530,98560,99240,420,1100,830,4432
20150527,98560,99240,97960,98850,97580,98680,98380,-560,-860,1068,4934
20150528,98680,98380,98360,100320,98270,99810,99640,1430,1260,996,4658
20150529,99810,99640,99850,100030,96890,97680,98030,-1960,-1610,664,4876
20150601,97680,98030,97460,97890,96800,97000,97200,-1030,-830,384,5020
20150602,97000,97200,97550,100360,97550,100100,99210,2900,2010,1084,4850
20150603,100100,99210,100000,100910,99260,99300,100330,90,1120,1452,4416
20150604,99300,100330,100400,100400,97880,98640,98850,-1690,-1480,194,4400
20150605,98640,98850,99180,99300,98110,98400,98570,-450,-280,514,4228
20150608,98400,98570,98570,100400,98500,100400,99040,1830,470,190,4200
20150609,100400,99040,100690,101900,100660,100920,101340,1880,2300,444,4048
20150610,100920,101340,101210,101490,100530,100870,101090,-470,-250,266,4034
20150611,100870,101090,101850,101850,101030,101260,101500,170,410,196,3980
20150612,101260,101500,101210,101210,97840,98000,99150,-3500,-2350,114,3952
20150615,98000,99150,97950,98560,97320,97450,97930,-1700,-1220,100,3954
20150616,97450,97930,96940,97710,95200,95650,96670,-2280,-1260,212,3966
20150617,95650,96670,95970,96200,94420,95100,95450,-1570,-1220,364,3858
20150618,95100,95450,96080,96290,95030,96140,96070,690,620,206,3894
20150619,96140,96070,95700,95700,94360,94360,95320,-1710,-750,156,3806
20150623,94360,95320,94360,94870,94190,94430,94480,-890,-840,386,3644
20150624,94430,94480,95200,96380,94860,95880,95690,1400,1210,448,3604
20150625,95880,95690,95600,95600,94410,94520,95080,-1170,-610,132,3590
20150626,94520,95080,94140,94710,92860,93580,93630,-1500,-1450,116,3570
20150629,93580,93630,93270,93270,88940,89640,90680,-3990,-2950,556,3606
20150630,89640,90680,88000,88650,86140,86140,86930,-4540,-3750,552,3574
20150701,86140,86930,86630,89430,86350,87960,87850,1030,920,388,3450
20150702,87960,87850,88070,89440,87910,89150,88590,1300,740,88,3412
20150703,89150,88590,89540,90120,88160,88800,89090,210,500,322,3272
20150706,88800,89090,88770,88770,84810,85600,86480,-3490,-2610,416,3146
20150707,85600,86480,85270,85880,84870,84990,85610,-1490,-870,120,3142
20150708,84990,85610,81320,81320,81320,81320,81320,-4290,-4290,12,3152
20150709,81320,81320,78000,84600,74810,83810,80930,2490,-390,850,3148
20150710,83810,80930,83500,84970,83500,84400,84600,3470,3670,172,3132
20150713,84400,84600,83900,83900,80370,81120,81380,-3480,-3220,184,3088
20150714,81120,81380,83700,85200,82890,84000,84680,2620,3300,380,3012
20150715,84000,84680,88740,88760,80660,86050,85340,1370,660,420,3022
20150716,86050,85340,85030,85200,83650,84740,84620,-600,-720,54,3004
20150717,84740,84620,84710,84920,84710,84920,84800,300,180,12,3004
20150720,84920,84800,83600,87150,82680,84770,84950,-30,150,448,3002
20150721,84770,84950,85950,87100,85940,87100,86260,2150,1310,112,2916
20150722,87100,86260,86620,86770,84560,85350,86090,-910,-170,470,2888
20150723,85350,86090,84710,84860,83880,84230,84220,-1860,-1870,82,2880
20150724,84230,84220,84160,84530,82860,83200,83660,-1020,-560,210,2830
20150727,83200,83660,83490,84200,83220,83240,83770,-420,110,1538,1952
20150728,83240,83770,81370,82550,81130,82450,82150,-1320,-1620,784,1894
20150729,82450,82150,83570,84230,83020,84000,83670,1850,1520,220,1842
20150730,84000,83670,82750,83800,82300,82300,83310,-1370,-360,124,1816
20150731,82300,83310,82260,82760,79610,81500,82210,-1810,-1100,504,1680
20150803,81500,82210,81660,81660,80010,80010,80850,-2200,-1360,96,1632
20150804,80010,80850,80700,80700,79900,80500,80270,-350,-580,276,1644
20150805,80500,80270,80400,80820,80300,80820,80530,550,260,60,1644
20150806,80820,80530,80450,80820,80350,80350,80540,-180,10,48,1608
20150807,80350,80540,80000,80300,80000,80300,80190,-240,-350,84,1572
20150810,80300,80190,80400,81680,80400,81680,80910,1490,720,180,1548
20150811,81680,80910,81930,83200,81930,82500,82630,1590,1720,192,1560
20150812,82500,82630,81100,81100,81100,81100,81100,-1530,-1530,12,1560
20150813,81100,81100,84000,84000,84000,84000,84000,2900,2900,72,1488
20150814,84000,84000,,,,82500,82500,-1500,-1500,0,1488
20150817,82500,82500,81400,81550,81400,81400,81420,-1100,-1080,408,1488
ni1509,20150327,102070,102070,102500,103000,100260,101000,101420,-1070,-650,392,156
20150330,101000,101420,100100,100100,97140,98730,98800,-2690,-2620,574,386
20150331,98730,98800,98530,98530,94480,94940,95920,-3860,-2880,1550,930
20150401,94940,95920,93840,94000,91530,92460,92990,-3460,-2930,1116,1394
20150402,92460,92990,93160,96150,92390,95910,94090,2920,1100,1772,1632
20150403,95910,94090,95720,97210,95450,96840,96140,2750,2050,492,1682
20150407,96840,96140,96990,97600,95300,96100,96610,-40,470,1258,2312
20150408,96100,96610,94800,95230,93050,93580,94000,-3030,-2610,3328,3436
20150409,93580,94000,94060,94760,93400,93700,94040,-300,40,1838,3808
20150410,93700,94040,93960,94480,92900,94140,93820,100,-220,1078,4020
20150413,94140,93820,94500,94900,93300,94560,94110,740,290,3312,4370
20150414,94560,94110,94020,94390,92320,92680,93140,-1430,-970,7562,7394
20150415,92680,93140,92250,94140,92200,93790,93600,650,460,5028,8198
20150416,93790,93600,93810,94580,93240,94340,93990,740,390,4902,8914
20150417,94340,93990,95470,95470,93840,94220,94430,230,440,5200,10060
20150420,94220,94430,94120,94770,93670,93700,94120,-730,-310,4350,10574
20150421,93700,94120,93850,94920,93510,94140,94270,20,150,4148,9624
20150422,94140,94270,94370,95000,94350,94860,94630,590,360,1644,9592
20150423,94860,94630,94700,95160,94580,94700,94930,70,300,2640,10398
20150424,94700,94930,94880,96210,94670,96190,95590,1260,660,6740,12750
20150427,96190,95590,96570,100360,96430,100360,99310,4770,3720,21326,18366
20150428,100360,99310,101190,102900,99800,101040,101300,1730,1990,16910,20692
20150429,101040,101300,101110,103090,99060,99810,101000,-1490,-300,18452,23212
20150430,99810,101000,99860,105600,99850,104490,102780,3490,1780,27204,29610
20150504,104490,102780,104390,107010,104110,106200,105670,3420,2890,15322,31522
20150505,106200,105670,106500,107690,104600,106020,106230,350,560,32176,36638
20150506,106020,106230,106700,111520,106700,109600,109310,3370,3080,78406,51896
20150507,109600,109310,110030,110490,105500,106090,107350,-3220,-1960,83700,61698
20150508,106090,107350,106980,109220,106060,109200,107630,1850,280,107406,62370
20150511,109200,107630,108590,111630,107950,111020,109860,3390,2230,102212,73844
20150512,111020,109860,110000,110660,107000,107600,108940,-2260,-920,120400,76566
20150513,107600,108940,108000,110000,107330,108550,108520,-390,-420,122478,76186
20150514,108550,108520,108330,108550,105000,106420,106830,-2100,-1690,96596,80046
20150515,106420,106830,106130,107600,105660,106810,106610,-20,-220,77404,86348
20150518,106810,106610,105500,106600,105420,105760,106090,-850,-520,59744,92066
20150519,105760,106090,105600,105920,103700,103820,104730,-2270,-1360,74838,96714
20150520,103820,104730,103000,103000,99490,99490,100810,-5240,-3920,83294,98506
20150521,99490,100810,98500,100480,98400,99700,99640,-1110,-1170,95444,95934
20150522,99700,99640,99500,101280,97130,98480,99580,-1160,-60,117658,96198
20150525,98480,99580,97280,98580,96710,97930,97710,-1650,-1870,87724,105020
20150526,97930,97710,97930,99400,97900,98060,98960,350,1250,99040,111284
20150527,98060,98960,97290,98380,97280,98110,97890,-850,-1070,86754,121918
20150528,98110,97890,97780,100100,97740,99470,99140,1580,1250,211690,144198
20150529,99470,99140,99140,99670,96250,97600,97970,-1540,-1170,196314,144488
20150601,97600,97970,97500,97800,96360,96810,97110,-1160,-860,171826,156872
20150602,96810,97110,97190,100500,97020,100280,99080,3170,1970,428588,179364
20150603,100280,99080,100380,101100,99040,99060,100230,-20,1150,409252,191776
20150604,99060,100230,99200,99940,97690,98530,99000,-1700,-1230,373158,193186
20150605,98530,99000,98650,99480,98060,98390,98820,-610,-180,349670,203496
20150608,98390,98820,98750,100600,98330,100570,99400,1750,580,493720,217446
20150609,100570,99400,100850,102180,100660,100910,101450,1510,2050,602556,214594
20150610,100910,101450,101360,101770,100570,101330,101250,-120,-200,398440,210380
20150611,101330,101250,101850,102200,101300,101500,101690,250,440,323762,201518
20150612,101500,101690,101600,101640,97800,98070,99690,-3620,-2000,485268,199864
20150615,98070,99690,98400,98880,97400,97580,98180,-2110,-1510,314750,206642
20150616,97580,98180,97400,98050,95340,95700,96960,-2480,-1220,386062,213938
20150617,95700,96960,96000,96360,94700,95280,95540,-1680,-1420,399972,212964
20150618,95280,95540,96300,96810,95830,96300,96260,760,720,327414,203154
20150619,96300,96260,96020,96180,94440,94610,95560,-1650,-700,314640,215276
20150623,94610,95560,94280,95330,94100,95050,94850,-510,-710,157974,218968
20150624,95050,94850,95510,96700,95350,96390,95980,1540,1130,335618,215434
20150625,96390,95980,96010,96220,94800,94850,95490,-1130,-490,333244,220876
20150626,94850,95490,94760,95170,93020,93850,94230,-1640,-1260,506474,222276
20150629,93850,94230,93650,93680,89510,90360,91930,-3870,-2300,618386,231122
20150630,90360,91930,88880,89410,87330,87330,88040,-4600,-3890,479454,235210
20150701,87330,88040,87330,89980,86680,88360,88450,320,410,711488,216384
20150702,88360,88450,88000,89880,87570,89450,88830,1000,380,651868,206510
20150703,89450,88830,89850,90670,88080,89240,89750,410,920,530356,192048
20150706,89240,89750,89100,89340,85260,85530,87390,-4220,-2360,497774,193608
20150707,85530,87390,85750,87360,84050,84220,85930,-3170,-1460,563222,194898
20150708,84220,85930,82400,82400,81630,81630,81780,-4300,-4150,25018,190228
20150709,81630,81780,75230,86050,75230,83600,81120,1820,-660,1040716,168800
20150710,83600,81120,84100,85170,82950,84570,84200,3450,3080,552370,180276
20150713,84570,84200,84040,84170,80600,82250,82590,-1950,-1610,771510,189886
20150714,82250,82590,84510,85800,83680,84500,84820,1910,2230,831348,186378
20150715,84500,84820,84880,87120,84330,86970,85840,2150,1020,859920,187520
20150716,86970,85840,86850,87240,83630,85430,85220,-410,-620,949108,182376
20150717,85430,85220,84680,85760,84620,85600,85210,380,-10,589592,182418
20150720,85600,85210,84800,85660,84450,85320,85100,110,-110,574774,188630
20150721,85320,85100,85480,87950,85260,87870,86360,2770,1260,608876,195552
20150722,87870,86360,87670,87880,84530,85220,86630,-1140,270,737564,183214
20150723,85220,86630,85300,85620,83700,84410,84800,-2220,-1830,701378,185200
20150724,84410,84800,84190,84880,82900,83360,84040,-1440,-760,696550,186720
20150727,83360,84040,83290,84950,82620,82650,83790,-1390,-250,631090,188830
20150728,82650,83790,81300,83420,81150,82740,82120,-1050,-1670,594918,177788
20150729,82740,82120,83300,84770,83110,84330,83920,2210,1800,519938,162950
20150730,84330,83920,83590,84420,82500,82620,83620,-1300,-300,564582,170372
20150731,82620,83620,82000,83000,81720,81780,82450,-1840,-1170,480272,177058
20150803,81780,82450,82200,83180,80160,80340,81790,-2110,-660,516712,175340
20150804,80340,81790,80350,81220,79800,81100,80500,-690,-1290,441778,160924
20150805,81100,80500,81300,81800,80290,81190,81060,690,560,319588,152420
20150806,81190,81060,81500,81640,80500,80780,81020,-280,-40,329536,147734
20150807,80780,81020,80700,81130,79930,80700,80540,-320,-480,364892,148768
20150810,80700,80540,80620,82490,80280,82200,81040,1660,500,337824,139708
20150811,82200,81040,82190,84300,81980,82370,83050,1330,2010,514684,123886
20150812,82370,83050,81240,82840,80050,82690,81750,-360,-1300,506474,116000
20150813,82690,81750,82700,83500,81750,82690,82750,940,1000,349908,112150
20150814,82690,82750,82300,82630,81400,81570,82040,-1180,-710,262984,112550
20150817,81570,82040,81950,82430,81530,82100,82000,60,-40,195836,105418
20150818,82100,82000,82150,82480,80310,80400,81840,-1600,-160,172078,101358
20150819,80400,81840,80500,81130,79960,81080,80490,-760,-1350,163224,86788
20150820,81080,80490,80900,81300,79090,79900,80290,-590,-200,103876,78428
20150821,79900,80290,80530,80680,79540,79600,80100,-690,-190,60154,72220
20150824,79600,80100,79180,79300,76090,76090,77860,-4010,-2240,71246,68954
20150825,76090,77860,73800,75750,72250,72850,74380,-5010,-3480,103170,54514
20150826,72850,74380,75000,75440,73330,73350,74240,-1030,-140,69174,43872
20150827,73350,74240,73200,74720,73070,74640,74010,400,-230,53290,39362
20150828,74640,74010,75100,77400,74880,76820,76370,2810,2360,55936,33844
20150831,76820,76370,76500,77400,74600,75190,76170,-1180,-200,28736,29474
20150901,75190,76170,76180,76180,73690,74200,74870,-1970,-1300,3950,28596
20150902,74200,74870,74370,75610,74250,74900,74600,30,-270,3000,27888
20150907,74900,74600,74600,75630,74600,75500,75270,900,670,3300,27564
20150908,75500,75270,75280,75450,73800,74450,74560,-820,-710,996,27312
20150909,74450,74560,75000,77200,73970,76500,76230,1940,1670,3156,26952
20150910,76500,76230,76500,78440,75520,77000,76110,770,-120,1044,26544
20150911,77000,76110,77450,78300,77450,78000,77990,1890,1880,2112,25296
20150914,78000,77990,78000,78120,76800,76800,77970,-1190,-20,3288,22308
20150915,76800,77970,76090,76350,75550,75550,75950,-2420,-2020,2688,23472
ni1510,20150327,102070,102070,102800,102800,99520,101970,101200,-100,-870,20,8
20150330,101970,101200,99070,99070,96970,98650,98490,-2550,-2710,18,20
20150331,98650,98490,95580,95580,95580,95580,95580,-2910,-2910,2,20
20150401,95580,95580,93430,93630,93430,93480,93510,-2100,-2070,6,24
20150402,93480,93510,94870,94870,94060,94140,94440,630,930,40,36
20150403,94140,94440,97260,97260,97260,97260,97260,2820,2820,2,36
20150407,97260,97260,98340,98340,96020,96020,97630,-1240,370,58,54
20150408,96020,97630,94870,94870,93830,93830,94250,-3800,-3380,8,58
20150409,93830,94250,95460,95460,94270,94450,94570,200,320,18,58
20150410,94450,94570,,,,94350,94350,-220,-220,0,58
20150413,94350,94350,93280,94930,93280,94930,93780,580,-570,42,70
20150414,94930,93780,89090,95990,89090,93280,93440,-500,-340,26,62
20150415,93280,93440,,,,93440,93440,0,0,0,62
20150416,93440,93440,,,,93440,93440,0,0,0,62
20150417,93440,93440,95010,95010,93170,93800,94360,360,920,56,104
20150420,93800,94360,93750,93750,93690,93690,93720,-670,-640,4,100
20150421,93690,93720,93810,93810,93810,93810,93810,90,90,4,100
20150422,93810,93810,,,,94170,94170,360,360,0,100
20150423,94170,94170,93890,93890,93890,93890,93890,-280,-280,2,98
20150424,93890,93890,94410,95240,94410,95240,94770,1350,880,36,102
20150427,95240,94770,97040,99500,97000,99500,98840,4730,4070,82,106
20150428,99500,98840,99500,103490,99500,100470,101050,1630,2210,64,98
20150429,100470,101050,100870,101740,99120,101520,100200,470,-850,46,102
20150430,101520,100200,99730,104370,99730,103840,102280,3640,2080,100,100
20150504,103840,102280,104860,106660,104400,105490,105720,3210,3440,30,112
20150505,105490,105720,106580,107950,105550,106290,106500,570,780,24,106
20150506,106290,106500,107590,111810,107590,110300,109410,3800,2910,92,130
20150507,110300,109410,109600,109600,104530,105500,105980,-3910,-3430,38,112
20150508,105500,105980,106050,107380,105600,107380,106310,1400,330,20,104
20150511,107380,106310,108640,111480,107370,108910,109190,2600,2880,54,106
20150512,108910,109190,110050,111460,107580,108800,109570,-390,380,78,112
20150513,108800,109570,108610,109790,107600,109790,108840,220,-730,20,112
20150514,109790,108840,106170,106860,105100,105550,106090,-3290,-2750,228,186
20150515,105550,106090,,,,106090,106090,0,0,0,186
20150518,106090,106090,,,,106090,106090,0,0,0,186
20150519,106090,106090,,,,106090,106090,0,0,0,186
20150520,106090,106090,,,,100780,100780,-5310,-5310,0,186
20150521,100780,100780,99510,99990,99500,99990,99700,-790,-1080,90,130
20150522,99990,99700,101200,101990,98160,98950,100090,-750,390,20,136
20150525,98950,100090,97170,98830,97170,97400,97570,-2690,-2520,38,146
20150526,97400,97570,98470,99000,98470,99000,98920,1430,1350,30,142
20150527,99000,98920,97780,99490,97500,97970,98170,-950,-750,22,142
20150528,97970,98170,99080,100160,99080,100160,99620,1990,1450,4,144
20150529,100160,99620,98550,100110,94650,97310,98110,-2310,-1510,32,142
20150601,97310,98110,96720,97600,96710,97100,96980,-1010,-1130,12,144
20150602,97100,96980,99210,100200,98750,100100,99210,3120,2230,22,132
20150603,100100,99210,100220,100890,99410,99520,99940,310,730,26,134
20150604,99520,99940,95010,100410,95010,99570,99410,-370,-530,46,138
20150605,99570,99410,99200,99380,98580,98580,98980,-830,-430,36,138
20150608,98580,98980,99170,100550,97530,100550,99450,1570,470,18,126
20150609,100550,99450,101970,102990,101230,101750,101890,2300,2440,62,130
20150610,101750,101890,102390,103020,101100,101460,101670,-430,-220,92,160
20150611,101460,101670,102000,102000,101920,102000,101980,330,310,8,162
20150612,102000,101980,101510,101510,98320,99260,99460,-2720,-2520,74,220
20150615,99260,99460,98820,98950,97740,97740,98730,-1720,-730,98,222
20150616,97740,98730,97760,97980,95750,95750,97160,-2980,-1570,8,222
20150617,95750,97160,96070,96070,95300,95400,95480,-1760,-1680,14,218
20150618,95400,95480,96460,96470,96220,96470,96370,990,890,28,218
20150619,96470,96370,95950,95950,95000,95000,95310,-1370,-1060,24,228
20150623,95000,95310,94930,95350,94930,95350,95170,40,-140,6,228
20150624,95350,95170,95750,96720,95750,96720,96070,1550,900,10,230
20150625,96720,96070,95890,95890,95890,95890,95890,-180,-180,2,230
20150626,95890,95890,94580,95460,93330,93330,94440,-2560,-1450,68,234
20150629,93330,94440,92750,92990,89710,91000,90950,-3440,-3490,90,234
20150630,91000,90950,88890,89550,86400,86430,87980,-4520,-2970,456,356
20150701,86430,87980,87260,89890,86970,88290,88530,310,550,250,360
20150702,88290,88530,88180,90000,87800,89700,89170,1170,640,164,420
20150703,89700,89170,90490,93380,88750,89470,90250,300,1080,116,436
20150706,89470,90250,89320,89510,85730,86490,86770,-3760,-3480,316,510
20150707,86490,86770,86500,87000,84740,84990,86460,-1780,-310,50,484
20150708,84990,86460,82200,83260,82130,82130,82270,-4330,-4190,18,486
20150709,82130,82270,75680,85960,75680,84730,81730,2460,-540,422,510
20150710,84730,81730,84930,85810,83600,85030,84950,3300,3220,132,518
20150713,85030,84950,84250,84250,81100,81500,82360,-3450,-2590,202,560
20150714,81500,82360,84870,86060,84080,85180,85450,2820,3090,234,638
20150715,85180,85450,85290,87400,85160,87400,86000,1950,550,376,786
20150716,87400,86000,87110,87110,84700,85670,85620,-330,-380,100,824
20150717,85670,85620,85620,85810,85450,85730,85560,110,-60,42,844
20150720,85730,85560,85400,85800,85190,85780,85560,220,0,76,838
20150721,85780,85560,86190,87780,86190,87500,86920,1940,1360,250,778
20150722,87500,86920,87500,87500,85770,86100,86790,-820,-130,42,792
20150723,86100,86790,85210,85430,84190,84990,84900,-1800,-1890,148,834
20150724,84990,84900,84690,84690,82350,83790,83820,-1110,-1080,148,788
20150727,83790,83820,83630,84280,83130,83130,83680,-690,-140,52,778
20150728,83130,83680,81430,83510,81370,82820,81930,-860,-1750,102,774
20150729,82820,81930,84140,84840,83950,84250,84460,2320,2530,230,844
20150730,84250,84460,83910,84700,83030,83030,83910,-1430,-550,152,878
20150731,83030,83910,83090,83190,80710,82330,82350,-1580,-1560,82,900
20150803,82330,82350,83110,83210,80710,80740,82170,-1610,-180,210,896
20150804,80740,82170,80990,81260,80300,81140,80880,-1030,-1290,260,1026
20150805,81140,80880,81640,81840,80750,81000,81320,120,440,204,960
20150806,81000,81320,81640,81670,81000,81000,81290,-320,-30,82,970
20150807,81000,81290,80950,80980,80240,80860,80560,-430,-730,176,1020
20150810,80860,80560,80860,82460,80770,82400,81500,1840,940,138,1040
20150811,82400,81500,83000,85500,82300,82420,83190,920,1690,590,1040
20150812,82420,83190,81490,83190,80000,83020,81850,-170,-1340,702,972
20150813,83020,81850,83200,83650,82190,82900,83140,1050,1290,558,958
20150814,82900,83140,82870,82870,81710,81800,82150,-1340,-990,366,1078
20150817,81800,82150,82480,82520,81970,82240,82270,90,120,96,1078
20150818,82240,82270,82300,82600,81160,81170,81940,-1100,-330,198,1100
20150819,81170,81940,80550,81200,80210,81200,80710,-740,-1230,358,1130
20150820,81200,80710,81010,81090,79460,80140,80280,-570,-430,436,1162
20150821,80140,80280,80650,80650,79610,79610,80080,-670,-200,90,1152
20150824,79610,80080,79260,79260,76070,76070,77370,-4010,-2710,460,1242
20150825,76070,77370,71220,75740,71180,72900,74610,-4470,-2760,888,1182
20150826,72900,74610,74800,76640,73550,73570,74510,-1040,-100,426,1174
20150827,73570,74510,74100,74910,73450,74900,74380,390,-130,398,1282
20150828,74900,74380,75590,77500,75330,77320,76630,2940,2250,518,1280
20150831,77320,76630,76640,77300,74840,75840,76300,-790,-330,684,1308
20150901,75840,76300,75190,76540,74390,74390,75270,-1910,-1030,360,1310
20150902,74390,75270,74660,76070,73890,75240,74980,-30,-290,930,1448
20150907,75240,74980,74380,76650,74380,75640,75630,660,650,362,1366
20150908,75640,75630,75530,75600,74270,75130,74960,-500,-670,302,1372
20150909,75130,74960,76390,77460,75650,76690,76690,1730,1730,758,1324
20150910,76690,76690,76840,77460,75950,77460,76630,770,-60,198,1308
20150911,77460,76630,78490,79000,77670,78070,78180,1440,1550,1076,1278
20150914,78070,78180,77810,78500,74270,76970,77830,-1210,-350,330,1254
20150915,76970,77830,76120,76770,75720,75720,76380,-2110,-1450,288,1224
20150916,75720,76380,76500,77860,76280,77710,76790,1330,410,364,1354
20150917,77710,76790,77450,78010,77110,77410,77520,620,730,772,1572
20150918,77410,77520,77070,77280,76630,76740,76890,-780,-630,618,1694
20150921,76740,76890,76210,76900,75240,76900,76080,10,-810,474,1760
20150922,76900,76080,76660,76730,75780,75880,76170,-200,90,648,1832
20150923,75880,76170,75550,76660,75170,75750,75540,-420,-630,548,1738
20150924,75750,75540,75940,76080,74000,75790,75730,250,190,354,1594
20150925,75790,75730,76650,79510,71940,76130,76270,400,540,488,1502
20150928,76130,76270,76400,76630,76210,76380,76520,110,250,384,1380
20150929,76380,76520,76150,76300,74240,74410,74960,-2110,-1560,242,1382
20150930,74410,74960,75120,77450,74880,75510,75400,550,440,286,1368
20151008,75510,75400,76000,76600,76000,76100,76230,700,830,36,1356
20151009,76100,76230,76670,78300,76670,78300,77450,2070,1220,228,1500
20151012,78300,77450,78800,79100,78800,79100,79010,1650,1560,276,1560
20151013,79100,79010,,,,79010,79010,0,0,0,1560
20151014,79010,79010,77900,78100,77900,78100,77930,-910,-1080,72,1536
20151015,78100,77930,78600,78600,78600,78600,78600,670,670,12,1548
ni1511,20150327,102070,102070,103500,103500,100820,101260,101690,-810,-380,20,16
20150330,101260,101690,97150,97350,97150,97300,97260,-4390,-4430,6,14
20150331,97300,97260,97960,97960,95000,96040,96460,-1220,-800,64,30
20150401,96040,96460,94540,94540,92810,92850,93550,-3610,-2910,76,46
20150402,92850,93550,94340,96310,94340,96310,95030,2760,1480,60,56
20150403,96310,95030,,,,96360,96360,1330,1330,0,56
20150407,96360,96360,97640,97640,97640,97640,97640,1280,1280,2,56
20150408,97640,97640,94770,95190,93950,94340,94490,-3300,-3150,24,56
20150409,94340,94490,94980,94980,94720,94720,94850,230,360,4,56
20150410,94720,94850,93710,93710,93710,93710,93710,-1140,-1140,6,54
20150413,93710,93710,94460,94460,94460,94460,94460,750,750,8,54
20150414,94460,94460,94210,94230,94190,94190,94210,-270,-250,6,50
20150415,94190,94210,92740,92740,92740,92740,92740,-1470,-1470,2,50
20150416,92740,92740,94330,95310,94330,95310,94980,2570,2240,6,50
20150417,95310,94980,95790,95790,94500,94500,95140,-480,160,4,50
20150420,94500,95140,,,,94490,94490,-650,-650,0,50
20150421,94490,94490,93330,95370,93330,94290,93950,-200,-540,28,56
20150422,94290,93950,94340,94500,94340,94500,94400,550,450,10,56
20150423,94500,94400,94730,94730,94440,94440,94510,40,110,8,62
20150424,94440,94510,95060,95790,95060,95790,95250,1280,740,8,58
20150427,95790,95250,96930,100000,96930,99900,99310,4650,4060,74,66
20150428,99900,99310,102200,102440,99010,100030,101630,720,2320,42,64
20150429,100030,101630,100740,101380,100550,100550,100820,-1080,-810,24,66
20150430,100550,100820,99730,104630,99730,103920,103270,3100,2450,32,64
20150504,103920,103270,104110,107230,104110,107230,105880,3960,2610,8,68
20150505,107230,105880,107360,109510,104700,105900,106790,20,910,58,88
20150506,105900,106790,107580,111100,107290,111100,108160,4310,1370,70,78
20150507,111100,108160,108270,109520,104860,104860,107750,-3300,-410,20,74
20150508,104860,107750,105980,107510,105980,107510,106750,-240,-1000,8,74
20150511,107510,106750,109160,111310,108040,108900,109140,2150,2390,18,74
20150512,108900,109140,107930,107930,107930,107930,107930,-1210,-1210,2,74
20150513,107930,107930,,,,107210,107210,-720,-720,0,74
20150514,107210,107210,105660,105660,105330,105330,105490,-1880,-1720,8,70
20150515,105330,105490,105660,105660,105660,105660,105660,170,170,2,70
20150518,105660,105660,106370,106370,106210,106210,106270,550,610,6,74
20150519,106210,106270,104760,104760,103950,103950,104350,-2320,-1920,4,74
20150520,103950,104350,99290,99290,99290,99290,99290,-5060,-5060,2,76
20150521,99290,99290,98550,99660,98550,99580,99220,290,-70,32,66
20150522,99580,99220,100500,101000,97500,97500,99660,-1720,440,6,66
20150525,97500,99660,,,,98850,98850,-810,-810,0,66
20150526,98850,98850,99460,99460,99180,99180,99320,330,470,4,70
20150527,99180,99320,,,,99320,99320,0,0,0,70
20150528,99320,99320,,,,99320,99320,0,0,0,70
20150529,99320,99320,97370,97370,97370,97370,97370,-1950,-1950,6,70
20150601,97370,97370,,,,96250,96250,-1120,-1120,0,70
20150602,96250,96250,98590,99980,97930,99970,98700,3720,2450,56,60
20150603,99970,98700,103000,103000,100190,100190,100700,1490,2000,16,56
20150604,100190,100700,,,,100160,100160,-540,-540,0,56
20150605,100160,100160,,,,100160,100160,0,0,0,56
20150608,100160,100160,99050,99430,99050,99430,99280,-730,-880,6,60
20150609,99430,99280,101530,101820,100990,101500,101460,2220,2180,8,58
20150610,101500,101460,100900,101460,100330,101460,100900,0,-560,8,62
20150611,101460,100900,102040,102040,102040,102040,102040,1140,1140,2,62
20150612,102040,102040,99610,99610,98450,98450,99320,-3590,-2720,8,56
20150615,98450,99320,,,,99050,99050,-270,-270,0,56
20150616,99050,99050,97360,97360,97360,97360,97360,-1690,-1690,2,54
20150617,97360,97360,98700,98700,95500,95670,96560,-1690,-800,8,62
20150618,95670,96560,96400,96400,96400,96400,96400,-160,-160,2,60
20150619,96400,96400,,,,96400,96400,0,0,0,60
20150623,96400,96400,,,,96400,96400,0,0,0,60
20150624,96400,96400,,,,96400,96400,0,0,0,60
20150625,96400,96400,,,,96210,96210,-190,-190,0,60
20150626,96210,96210,,,,94760,94760,-1450,-1450,0,60
20150629,94760,94760,92390,92390,90190,91400,91370,-3360,-3390,54,78
20150630,91400,91370,88580,88600,86800,86810,87770,-4560,-3600,62,64
20150701,86810,87770,86390,89810,86390,89420,88130,1650,360,20,64
20150702,89420,88130,89670,89670,89670,89670,89670,1540,1540,2,64
20150703,89670,89670,90540,90810,89630,90270,90540,600,870,22,78
20150706,90270,90540,89070,89770,86330,86330,88200,-4210,-2340,10,76
20150707,86330,88200,86860,86860,85960,85960,86620,-2240,-1580,50,72
20150708,85960,86620,82280,82280,82280,82280,82280,-4340,-4340,4,72
20150709,82280,82280,80000,85490,75690,85450,80480,3170,-1800,62,68
20150710,85450,80480,84500,84500,84190,84500,84440,4020,3960,12,66
20150713,84500,84440,84900,84900,80570,81600,82140,-2840,-2300,18,64
20150714,81600,82140,85440,86240,84580,85100,84800,2960,2660,68,108
20150715,85100,84800,86200,86790,85930,86780,86340,1980,1540,18,110
20150716,86780,86340,87690,87690,84530,85660,86400,-680,60,30,104
20150717,85660,86400,85910,87280,83650,86450,86350,50,-50,110,88
20150720,86450,86350,,,,86350,86350,0,0,0,88
20150721,86350,86350,87000,87330,86450,87330,86990,980,640,90,154
20150722,87330,86990,87330,89120,86780,86780,87440,-210,450,16,156
20150723,86780,87440,85350,85710,84840,84990,85350,-2450,-2090,20,164
20150724,84990,85350,83970,83970,83970,83970,83970,-1380,-1380,2,162
20150727,83970,83970,84530,84530,84300,84300,84360,330,390,8,160
20150728,84300,84360,81770,84680,81770,83270,82400,-1090,-1960,14,154
20150729,83270,82400,84510,85040,83900,85040,84620,2640,2220,16,158
20150730,85040,84620,83990,83990,83990,83990,83990,-630,-630,2,156
20150731,83990,83990,82810,83930,82810,83930,83650,-60,-340,22,172
20150803,83930,83650,83350,83600,80340,81370,83060,-2280,-590,270,394
20150804,81370,83060,81510,81510,81330,81330,81420,-1730,-1640,4,394
20150805,81330,81420,82000,82000,80920,81320,81480,-100,60,10,394
20150806,81320,81480,,,,81450,81450,-30,-30,0,394
20150807,81450,81450,80800,81060,80800,81060,80980,-390,-470,14,406
20150810,81060,80980,82630,82630,82630,82630,82630,1650,1650,2,406
20150811,82630,82630,83930,84510,81560,82700,82920,70,290,128,402
20150812,82700,82920,81870,83130,80050,83130,82360,210,-560,268,410
20150813,83130,82360,84350,84350,82380,82800,83040,440,680,98,440
20150814,82800,83040,82790,82790,81850,81850,82600,-1190,-440,24,434
20150817,81850,82600,,,,82600,82600,0,0,0,434
20150818,82600,82600,82490,82490,80760,80760,81540,-1840,-1060,22,434
20150819,80760,81540,80550,81560,80290,81560,80900,20,-640,98,470
20150820,81560,80900,81330,81330,78440,80250,80320,-650,-580,90,512
20150821,80250,80320,80570,80680,79770,79770,80280,-550,-40,40,504
20150824,79770,80280,78730,78730,76260,76260,77280,-4020,-3000,72,520
20150825,76260,77280,73980,75870,73410,73590,74390,-3690,-2890,68,540
20150826,73590,74390,74960,75710,73880,74000,74710,-390,320,128,562
20150827,74000,74710,74130,75400,73760,75160,74670,450,-40,144,618
20150828,75160,74670,75950,77920,75570,77670,76970,3000,2300,192,672
20150831,77670,76970,76600,77950,75890,75890,76980,-1080,10,114,686
20150901,75890,76980,75430,76260,75200,75200,75680,-1780,-1300,108,690
20150902,75200,75680,75140,75820,75010,75700,75330,20,-350,220,706
20150907,75700,75330,76150,76220,75800,76200,76060,870,730,34,718
20150908,76200,76060,75600,75720,74710,75360,75210,-700,-850,44,730
20150909,75360,75210,76170,77750,76000,77130,77220,1920,2010,290,734
20150910,77130,77220,76940,77790,76390,77790,77110,570,-110,132,758
20150911,77790,77110,78500,79800,77950,78600,78650,1490,1540,362,788
20150914,78600,78650,78390,78900,77260,77260,78120,-1390,-530,194,780
20150915,77260,78120,76700,77090,76450,76450,76650,-1670,-1470,54,758
20150916,76450,76650,77780,78160,76980,78160,77590,1510,940,112,760
20150917,78160,77590,77660,78220,77540,78000,77960,410,370,362,824
20150918,78000,77960,77100,77560,77100,77200,77200,-760,-760,138,800
20150921,77200,77200,77370,77370,75710,77250,76210,50,-990,372,868
20150922,77250,76210,77120,77230,76120,76300,76790,90,580,424,892
20150923,76300,76790,75620,75880,74350,75660,75650,-1130,-1140,150,858
20150924,75660,75650,76950,76950,74660,75820,75390,170,-260,1200,990
20150925,75820,75390,75890,77100,75890,76490,76530,1100,1140,632,962
20150928,76490,76530,76830,76950,76580,76690,76760,160,230,348,978
20150929,76690,76760,76400,76580,74760,74910,75660,-1850,-1100,636,1078
20150930,74910,75660,75610,76280,75360,76200,75700,540,40,178,1060
20151008,76200,75700,77210,77210,76640,76640,76970,940,1270,232,1052
20151009,76640,76970,76920,78660,76830,78660,77670,1690,700,290,1166
20151012,78660,77670,79550,79710,78490,79430,78940,1760,1270,110,1144
20151013,79430,78940,78970,78970,78080,78700,78390,-240,-550,156,1160
20151014,78700,78390,78630,79350,78460,78500,78830,110,440,140,1132
20151015,78500,78830,78730,79850,78730,79840,79480,1010,650,298,1244
20151016,79840,79480,79330,80130,79160,79500,79590,20,110,340,1496
20151019,79500,79590,79620,79920,78550,78550,78990,-1040,-600,116,1476
20151020,78550,78990,78350,78350,77500,77760,77720,-1230,-1270,116,1454
20151021,77760,77720,77400,77690,77230,77690,77560,-30,-160,26,1452
20151022,77690,77560,77180,78300,77130,78300,78100,740,540,116,1450
20151023,78300,78100,78160,78980,77170,78980,78170,880,70,120,1460
20151026,78980,78170,78500,78870,77730,78030,78350,-140,180,172,1464
20151027,78030,78350,78070,78650,77520,78610,78080,260,-270,426,1446
20151028,78610,78080,78300,79610,78190,78470,78460,390,380,498,1650
20151029,78470,78460,78220,79270,78170,78450,78410,-10,-50,154,1684
20151030,78450,78410,78550,78550,75770,76750,77480,-1660,-930,464,1692
20151102,76750,77480,,,,77000,77000,-480,-480,0,1692
20151103,77000,77000,76000,76000,76000,76000,76000,-1000,-1000,84,1680
20151104,76000,76000,,,,76000,76000,0,0,0,1680
20151105,76000,76000,,,,76000,76000,0,0,0,1680
20151106,76000,76000,74000,74000,74000,74000,74000,-2000,-2000,84,1680
20151109,74000,74000,74000,74000,74000,74000,74000,0,0,12,1668
20151110,74000,74000,72500,72900,72500,72900,72700,-1100,-1300,24,1668
20151111,72900,72700,,,,72700,72700,0,0,0,1668
20151112,72700,72700,71800,72600,71800,72600,72100,-100,-600,48,1668
20151113,72600,72100,72500,72500,72500,72500,72500,400,400,12,1668
20151116,72500,72500,72000,72700,72000,72700,72650,200,150,180,1524
ni1512,20150327,102070,102070,106660,106660,100680,101000,101870,-1070,-200,12,8
20150330,101000,101870,99170,99490,98320,99170,99310,-2700,-2560,64,72
20150331,99170,99310,98360,98560,95280,96220,97160,-3090,-2150,92,50
20150401,96220,97160,93660,93660,93240,93240,93460,-3920,-3700,6,50
20150402,93240,93460,93870,96280,93740,96040,95450,2580,1990,120,108
20150403,96040,95450,96180,96520,96180,96520,96220,1070,770,14,108
20150407,96520,96220,97930,97930,96380,96380,96970,160,750,20,118
20150408,96380,96970,95110,95910,94720,94720,95210,-2250,-1760,8,120
20150409,94720,95210,95000,95000,94990,94990,94990,-220,-220,4,116
20150410,94990,94990,94400,94400,94000,94000,94260,-990,-730,10,110
20150413,94000,94260,94000,94000,94000,94000,94000,-260,-260,2,110
20150414,94000,94000,94720,94720,91750,91750,92640,-2250,-1360,16,120
20150415,91750,92640,92900,94200,92840,94200,93120,1560,480,10,120
20150416,94200,93120,95000,95000,94050,94050,94520,930,1400,4,120
20150417,94050,94520,96340,96340,93060,94470,94770,-50,250,18,122
20150420,94470,94770,,,,94770,94770,0,0,0,122
20150421,94770,94770,92910,96940,92910,94200,94910,-570,140,10,124
20150422,94200,94910,96190,96190,93530,93530,94690,-1380,-220,8,124
20150423,93530,94690,94710,95190,94190,94950,95060,260,370,72,146
20150424,94950,95060,94650,95600,94460,95600,94680,540,-380,14,142
20150427,95600,94680,97390,99400,96770,99360,97640,4680,2960,92,124
20150428,99360,97640,99560,102470,99560,100780,101510,3140,3870,268,270
20150429,100780,101510,100860,101550,99600,99600,100170,-1910,-1340,210,244
20150430,99600,100170,99890,104400,99890,103700,102940,3530,2770,128,244
20150504,103700,102940,105310,105830,104520,105830,105210,2890,2270,32,252
20150505,105830,105210,106890,108560,103210,105400,106280,190,1070,68,226
20150506,105400,106280,107570,111580,107570,109000,109140,2720,2860,136,218
20150507,109000,109140,114520,114520,105020,105120,106950,-4020,-2190,96,218
20150508,105120,106950,105950,108220,105270,108220,106530,1270,-420,28,214
20150511,108220,106530,109000,110000,107520,110000,108670,3470,2140,46,212
20150512,110000,108670,111590,111590,106270,106270,108370,-2400,-300,36,220
20150513,106270,108370,107660,107930,106700,106700,107010,-1670,-1360,14,212
20150514,106700,107010,106800,106800,104110,105880,105810,-1130,-1200,82,234
20150515,105880,105810,105570,106930,105570,106930,105940,1120,130,30,206
20150518,106930,105940,105790,106090,105450,105500,105650,-440,-290,20,204
20150519,105500,105650,,,,105650,105650,0,0,0,204
20150520,105650,105650,100360,100360,100360,100360,100360,-5290,-5290,10,204
20150521,100360,100360,98810,101170,98810,101090,99740,730,-620,24,210
20150522,101090,99740,100120,100990,97460,97460,99870,-2280,130,28,208
20150525,97460,99870,98980,100000,97000,97280,98330,-2590,-1540,466,226
20150526,97280,98330,99080,99090,97270,98200,98540,-130,210,56,206
20150527,98200,98540,97650,98990,97650,98990,98240,450,-300,10,210
20150528,98990,98240,99110,99110,98270,98790,98720,550,480,6,206
20150529,98790,98720,99290,99290,97400,97400,98100,-1320,-620,30,218
20150601,97400,98100,97560,97740,97000,97190,97330,-910,-770,14,220
20150602,97190,97330,99490,99900,97660,99900,98840,2570,1510,38,200
20150603,99900,98840,100220,101240,99730,99730,100440,890,1600,24,212
20150604,99730,100440,98710,98710,98710,98710,98710,-1730,-1730,2,214
20150605,98710,98710,97370,101590,97370,98540,98840,-170,130,70,214
20150608,98540,98840,99340,100500,99270,100120,99620,1280,780,36,194
20150609,100120,99620,101680,102000,100740,102000,101670,2380,2050,32,182
20150610,102000,101670,101210,101220,101210,101220,101210,-450,-460,4,180
20150611,101220,101210,102030,102030,101690,101790,101760,580,550,14,176
20150612,101790,101760,100920,100920,99890,99890,100390,-1870,-1370,12,178
20150615,99890,100390,98000,98710,97950,97950,98240,-2440,-2150,20,174
20150616,97950,98240,97620,98190,96000,96000,97640,-2240,-600,28,184
20150617,96000,97640,96330,96330,95500,95950,95750,-1690,-1890,16,184
20150618,95950,95750,96490,96490,96490,96490,96490,740,740,2,184
20150619,96490,96490,95500,95500,95500,95500,95500,-990,-990,2,184
20150623,95500,95500,95460,95460,94200,94820,95150,-680,-350,18,184
20150624,94820,95150,96230,96390,96230,96390,96310,1240,1160,4,184
20150625,96390,96310,96260,96260,95400,95510,95790,-800,-520,16,184
20150626,95510,95790,94530,94920,94530,94730,94730,-1060,-1060,12,192
20150629,94730,94730,94730,94730,91230,91420,92010,-3310,-2720,36,174
20150630,91420,92010,89370,89970,87400,87400,88450,-4610,-3560,66,184
20150701,87400,88450,87280,89500,87280,88820,88540,370,90,24,182
20150702,88820,88540,87570,91210,87570,89280,89810,740,1270,26,184
20150703,89280,89810,89140,89140,89140,89140,89140,-670,-670,2,182
20150706,89140,89140,87780,88000,86450,86780,87170,-2360,-1970,40,166
20150707,86780,87170,85760,86540,85760,86540,86280,-630,-890,30,182
20150708,86540,86280,82010,82010,81960,81960,81990,-4320,-4290,6,182
20150709,81960,81990,76390,84950,75440,84950,78970,2960,-3020,74,134
20150710,84950,78970,,,,82910,82910,3940,3940,0,134
20150713,82910,82910,82910,82910,81900,81900,82250,-1010,-660,36,130
20150714,81900,82250,86360,86360,85330,85610,85990,3360,3740,48,126
20150715,85610,85990,86350,88000,86350,87670,87680,1680,1690,80,108
20150716,87670,87680,87010,87280,84940,86610,86300,-1070,-1380,28,108
20150717,86610,86300,86900,86900,86900,86900,86900,600,600,2,108
20150720,86900,86900,86240,86260,86210,86260,86230,-640,-670,12,108
20150721,86260,86230,86300,88000,86300,88000,86550,1770,320,58,130
20150722,88000,86550,88160,88340,86790,86960,87410,410,860,48,116
20150723,86960,87410,85070,85220,84510,85220,84870,-2190,-2540,46,116
20150724,85220,84870,,,,84870,84870,0,0,0,116
20150727,84870,84870,83580,85640,83570,83910,84010,-960,-860,18,112
20150728,83910,84010,82580,83500,82580,83500,83040,-510,-970,4,110
20150729,83500,83040,,,,85270,85270,2230,2230,0,110
20150730,85270,85270,,,,85270,85270,0,0,0,110
20150731,85270,85270,83000,83000,83000,83000,83000,-2270,-2270,2,110
20150803,83000,83000,83190,83190,81100,81100,82000,-1900,-1000,14,114
20150804,81100,82000,81110,81110,81110,81110,81110,-890,-890,10,112
20150805,81110,81110,,,,81170,81170,60,60,0,112
20150806,81170,81170,,,,81140,81140,-30,-30,0,112
20150807,81140,81140,82030,82030,80010,80010,81040,-1130,-100,28,122
20150810,80010,81040,81200,83000,81200,82700,81910,1660,870,20,110
20150811,82700,81910,82890,84130,82660,83530,83560,1620,1650,152,96
20150812,83530,83560,82570,82570,80700,82230,81810,-1330,-1750,26,84
20150813,82230,81810,83900,83900,82680,82680,83180,870,1370,14,78
20150814,82680,83180,82470,82470,82470,82470,82470,-710,-710,2,76
20150817,82470,82470,82790,83090,82420,82530,82700,60,230,8,74
20150818,82530,82700,,,,82700,82700,0,0,0,74
20150819,82700,82700,,,,82050,82050,-650,-650,0,74
20150820,82050,82050,83060,83060,81790,81790,82630,-260,580,6,78
20150821,81790,82630,,,,81790,81790,-840,-840,0,78
20150824,81790,81790,80010,80010,77700,77700,78820,-4090,-2970,10,80
20150825,77700,78820,74600,75700,73500,73520,74880,-5300,-3940,1000,322
20150826,73520,74880,75740,75750,74300,74600,75120,-280,240,394,362
20150827,74600,75120,74600,75710,74410,75650,75330,530,210,334,142
20150828,75650,75330,76490,78240,76460,78100,77330,2770,2000,46,148
20150831,78100,77330,78630,78630,75510,75510,77040,-1820,-290,100,158
20150901,75510,77040,76110,76650,75600,75600,76120,-1440,-920,90,180
20150902,75600,76120,75840,76260,75500,76050,75770,-70,-350,308,292
20150907,76050,75770,75670,76770,75670,76580,76590,810,820,54,320
20150908,76580,76590,76320,76390,75370,75900,75890,-690,-700,46,326
20150909,75900,75890,76710,78540,76710,77120,77330,1230,1440,766,360
20150910,77120,77330,77410,78160,76550,78160,77250,830,-80,784,338
20150911,78160,77250,78470,79690,78280,78810,79060,1560,1810,412,340
20150914,78810,79060,78630,79300,78230,78230,78820,-830,-240,62,344
20150915,78230,78820,77200,77520,76230,76850,77090,-1970,-1730,34,342
20150916,76850,77090,77230,78210,77230,78210,77570,1120,480,28,340
20150917,78210,77570,79280,79290,77990,78700,78670,1130,1100,26,338
20150918,78700,78670,77500,77500,77470,77470,77480,-1200,-1190,4,336
20150921,77470,77480,76820,77030,75980,76680,76690,-800,-790,48,332
20150922,76680,76690,78620,78620,75860,77190,77220,500,530,68,348
20150923,77190,77220,76320,76320,75740,75860,75890,-1360,-1330,116,352
20150924,75860,75890,76640,77130,75900,76080,76470,190,580,306,392
20150925,76080,76470,76550,76980,76530,76950,76680,480,210,12,390
20150928,76950,76680,,,,76910,76910,230,230,0,390
20150929,76910,76910,76300,76300,75500,75500,76060,-1410,-850,8,390
20150930,75500,76060,75760,76470,75700,76470,75900,410,-160,34,390
20151008,76470,75900,77360,77370,77000,77000,77190,1100,1290,134,418
20151009,77000,77190,77110,78940,77090,78880,77520,1690,330,144,488
20151012,78880,77520,79320,80050,78660,79890,79360,2370,1840,178,496
20151013,79890,79360,79520,79780,78530,79140,79110,-220,-250,138,502
20151014,79140,79110,79090,79540,78650,79350,79210,240,100,116,476
20151015,79350,79210,79190,80170,78860,79740,79270,530,60,116,482
20151016,79740,79270,79640,80450,79580,80050,79950,780,680,74,492
20151019,80050,79950,80000,80000,78630,78900,79260,-1050,-690,518,490
20151020,78900,79260,78900,78900,76840,78060,78130,-1200,-1130,704,518
20151021,78060,78130,78100,78360,77540,77780,78090,-350,-40,280,540
20151022,77780,78090,77850,79290,77030,78410,78080,320,-10,616,638
20151023,78410,78080,78480,79600,78240,79600,78750,1520,670,1022,708
20151026,79600,78750,80020,80020,74020,78180,79010,-570,260,756,676
20151027,78180,79010,78360,79000,77940,78750,78370,-260,-640,550,756
20151028,78750,78370,78740,79140,78310,78690,78710,320,340,286,750
20151029,78690,78710,78360,79340,78350,78760,78860,50,150,326,778
20151030,78760,78860,78650,78980,76830,77040,78020,-1820,-840,632,798
20151102,77040,78020,76780,77010,76260,76260,76650,-1760,-1370,412,950
20151103,76260,76650,76330,77090,76180,76300,76460,-350,-190,100,972
20151104,76300,76460,75960,76340,75540,76280,75850,-180,-610,154,978
20151105,76280,75850,76020,76550,74730,74740,75600,-1110,-250,168,1006
20151106,74740,75600,74590,74870,74330,74770,74540,-830,-1060,184,1032
20151109,74770,74540,74690,74790,73660,73750,74440,-790,-100,176,1044
20151110,73750,74440,73740,73800,72130,73490,72940,-950,-1500,268,1046
20151111,73490,72940,73140,73610,72420,72420,73000,-520,60,116,1046
20151112,72420,73000,72630,73150,72210,72940,72740,-60,-260,144,1054
20151113,72940,72740,72300,73130,72150,72600,72690,-140,-50,176,1076
20151116,72600,72690,72690,73060,72690,72860,72970,170,280,24,1082
20151117,72860,72970,72950,72960,70440,70550,72240,-2420,-730,212,1080
20151118,70550,72240,71220,71220,69880,70880,70340,-1360,-1900,88,1092
20151119,70880,70340,70320,70320,68910,69410,69370,-930,-970,282,1200
20151120,69410,69370,68990,69430,68350,68480,68770,-890,-600,156,1212
20151123,68480,68770,69990,69990,64640,65440,65960,-3330,-2810,188,1316
20151124,65440,65960,63540,65760,63070,65050,63960,-910,-2000,302,1266
20151125,65050,63960,65300,67760,65100,67760,67190,3800,3230,186,1160
20151126,67760,67190,67170,71220,67170,70170,70450,2980,3260,184,1242
20151127,70170,70450,70410,72680,68120,68950,70220,-1500,-230,336,1216
20151130,68950,70220,68200,69510,66810,67500,67830,-2720,-2390,352,1440
ni1601,20150327,102070,102070,107800,107800,100500,101240,101360,-830,-710,120,96
20150330,101240,101360,99810,99860,97890,98610,98860,-2750,-2500,276,140
20150331,98610,98860,98810,99130,96120,96530,97260,-2330,-1600,154,192
20150401,96530,97260,95000,95000,93160,93760,94080,-3500,-3180,192,198
20150402,93760,94080,94490,96590,94280,95740,95870,1660,1790,246,256
20150403,95740,95870,95570,97440,95570,97380,96360,1510,490,42,252
20150407,97380,96360,98340,98340,96300,96460,97420,100,1060,52,278
20150408,96460,97420,95240,95950,93330,94190,94440,-3230,-2980,316,422
20150409,94190,94440,94670,95230,93190,94170,94060,-270,-380,148,422
20150410,94170,94060,94400,94570,93080,94340,93700,280,-360,108,442
20150413,94340,93700,94240,95350,93720,95350,94470,1650,770,310,556
20150414,95350,94470,95150,95190,93110,93400,93630,-1070,-840,400,744
20150415,93400,93630,93050,94860,93050,94860,94060,1230,430,232,750
20150416,94860,94060,94550,94770,93810,94230,94400,170,340,502,1062
20150417,94230,94400,95000,95320,93860,94190,94460,-210,60,292,1142
20150420,94190,94460,94790,94790,93970,93970,94320,-490,-140,154,1146
20150421,93970,94320,93950,95010,93730,94860,94270,540,-50,172,1166
20150422,94860,94270,94780,95000,93760,94960,94610,690,340,222,1192
20150423,94960,94610,96500,96500,94240,94570,94810,-40,200,206,1250
20150424,94570,94810,94780,96100,94400,96100,95040,1290,230,454,1402
20150427,96100,95040,96680,99790,96310,99790,98870,4750,3830,324,1476
20150428,99790,98870,100790,103250,99290,100820,101110,1950,2240,1588,2426
20150429,100820,101110,100500,102500,99190,99650,100580,-1460,-530,528,2512
20150430,99650,100580,100030,105230,100020,104770,102830,4190,2250,852,2484
20150504,104770,102830,102720,107330,102720,106380,105680,3550,2850,482,2560
20150505,106380,105680,107030,107570,105010,106100,106210,420,530,746,2722
20150506,106100,106210,108360,111500,107060,110080,109030,3870,2820,1324,2862
20150507,110080,109030,109760,111280,104460,105710,107210,-3320,-1820,1342,3438
20150508,105710,107210,106500,107900,105600,107850,106770,640,-440,760,3296
20150511,107850,106770,107740,110350,107060,109880,108720,3110,1950,642,3312
20150512,109880,108720,108720,110410,106070,106440,107700,-2280,-1020,1026,3500
20150513,106440,107700,107200,108870,106460,108100,107710,400,10,816,3690
20150514,108100,107710,107820,108070,105000,105870,106710,-1840,-1000,1364,4090
20150515,105870,106710,106430,107100,105500,106400,106300,-310,-410,514,4222
20150518,106400,106300,105500,106070,105200,105330,105630,-970,-670,836,4548
20150519,105330,105630,105410,105840,103230,103370,104370,-2260,-1260,832,4854
20150520,103370,104370,102680,102680,99150,99150,100470,-5220,-3900,1700,5230
20150521,99150,100470,98500,100060,97830,99200,99080,-1270,-1390,4090,6274
20150522,99200,99080,99080,100860,96690,97910,99140,-1170,60,5178,7706
20150525,97910,99140,96900,98040,96180,97380,97180,-1760,-1960,1968,7898
20150526,97380,97180,97720,99220,97720,97880,98510,700,1330,2234,8356
20150527,97880,98510,97500,98270,97060,97580,97540,-930,-970,2534,9034
20150528,97580,97540,97520,99700,97490,98950,98660,1410,1120,3376,9544
20150529,98950,98660,98880,99240,94770,97200,97450,-1460,-1210,3384,9896
20150601,97200,97450,97230,97350,96090,96550,96720,-900,-730,3994,10298
20150602,96550,96720,97000,99900,96810,99690,98480,2970,1760,5888,10494
20150603,99690,98480,99750,100340,98800,98820,99620,340,1140,5204,11114
20150604,98820,99620,99090,99510,97500,98390,98570,-1230,-1050,5302,13094
20150605,98390,98570,98500,99220,97440,97930,98400,-640,-170,7344,13832
20150608,97930,98400,97900,100150,97890,100150,98940,1750,540,6346,15442
20150609,100150,98940,100500,101880,100360,100890,101100,1950,2160,6190,16168
20150610,100890,101100,101090,101570,100620,101260,101130,160,30,5044,16432
20150611,101260,101130,101700,102040,101230,101480,101640,350,510,3812,16488
20150612,101480,101640,101480,101600,98000,98070,99380,-3570,-2260,7566,17300
20150615,98070,99380,98080,98980,97000,97520,98090,-1860,-1290,4268,17986
20150616,97520,98090,97300,98000,95500,95780,96860,-2310,-1230,7524,19922
20150617,95780,96860,96200,96420,94810,95350,95530,-1510,-1330,4780,20766
20150618,95350,95530,96450,96740,95860,96210,96320,680,790,4012,20774
20150619,96210,96320,96210,96210,94590,95030,95490,-1290,-830,4560,21890
20150623,95030,95490,94560,95290,94280,95050,94850,-440,-640,3984,22674
20150624,95050,94850,95500,96690,95410,96490,95990,1640,1140,4104,23038
20150625,96490,95990,96100,96290,94900,95220,95520,-770,-470,6286,25556
20150626,95220,95520,95000,95530,93560,94150,94510,-1370,-1010,10148,26350
20150629,94150,94510,94150,94150,90010,90850,92210,-3660,-2300,18878,30040
20150630,90850,92210,89500,89770,87590,87590,88510,-4620,-3700,24514,32090
20150701,87590,88510,87500,90240,87360,88940,88890,430,380,24430,32160
20150702,88940,88890,88950,90450,88250,90110,89510,1220,620,24442,31170
20150703,90110,89510,90460,91470,88880,89890,90420,380,910,24618,31868
20150706,89890,90420,89900,90020,86000,86450,87960,-3970,-2460,27532,30740
20150707,86450,87960,86950,88190,84930,84930,86590,-3030,-1370,27900,30644
20150708,84930,86590,82360,82930,82260,82260,82300,-4330,-4290,3162,30588
20150709,82260,82300,75760,86480,75710,84180,81040,1880,-1260,57450,27620
20150710,84180,81040,84740,85090,83710,85090,84620,4050,3580,17898,27786
20150713,85090,84620,84520,84980,81260,82740,83170,-1880,-1450,50144,31482
20150714,82740,83170,85220,86280,84160,85000,85300,1830,2130,37158,31848
20150715,85000,85300,85110,87450,84810,87370,86400,2070,1100,36334,33612
20150716,87370,86400,87600,87600,84200,85880,85690,-520,-710,43650,33878
20150717,85880,85690,85160,86250,85150,86040,85730,350,40,36590,35264
20150720,86040,85730,85200,86160,84770,85820,85620,90,-110,26212,36256
20150721,85820,85620,85720,88190,85720,88180,86810,2560,1190,34534,41612
20150722,88180,86810,87880,88150,85020,85580,86920,-1230,110,35830,44300
20150723,85580,86920,85570,86000,84050,84830,85110,-2090,-1810,36092,45646
20150724,84830,85110,84700,85330,83310,83760,84380,-1350,-730,34228,46688
20150727,83760,84380,83400,85220,83300,83300,84170,-1080,-210,38870,49102
20150728,83300,84170,81750,83860,81750,83340,82690,-830,-1480,44558,50836
20150729,83340,82690,84400,85340,83670,84880,84500,2190,1810,36946,53726
20150730,84880,84500,84260,84950,83100,83190,84120,-1310,-380,40874,58280
20150731,83190,84120,82600,83560,82350,82350,82950,-1770,-1170,37844,64594
20150803,82350,82950,83110,83750,80850,80900,82070,-2050,-880,77968,68768
20150804,80900,82070,81000,81830,80520,81720,81100,-350,-970,59052,71940
20150805,81720,81100,81880,82300,81000,81950,81770,850,670,59454,82024
20150806,81950,81770,82300,82450,81260,81540,81750,-230,-20,50796,84198
20150807,81540,81750,81480,81900,80700,81410,81250,-340,-500,59544,87986
20150810,81410,81250,81410,83330,81000,83030,81950,1780,700,73152,91124
20150811,83030,81950,83000,85070,82820,83120,83850,1170,1900,143590,102934
20150812,83120,83850,82100,83600,80910,83400,82490,-450,-1360,202804,104360
20150813,83400,82490,83600,84340,82600,83490,83530,1000,1040,168638,113984
20150814,83490,83530,83350,83430,82200,82300,82790,-1230,-740,135632,124732
20150817,82300,82790,82800,83200,82230,82880,82730,90,-60,132144,126786
20150818,82880,82730,82880,83250,81100,81130,82470,-1600,-260,180354,142650
20150819,81130,82470,81090,81950,80620,81860,81270,-610,-1200,286466,154028
20150820,81860,81270,81600,81850,79800,80650,80960,-620,-310,379502,176056
20150821,80650,80960,81550,81560,80300,80370,80850,-590,-110,311620,186596
20150824,80370,80850,80000,80100,76800,76800,78490,-4050,-2360,370194,217706
20150825,76800,78490,74200,76730,73050,73600,75190,-4890,-3300,648246,232104
20150826,73600,75190,75750,76230,74200,74360,75190,-830,0,575928,242488
20150827,74360,75190,74300,76200,74100,76160,75150,970,-40,472478,227150
20150828,76160,75150,76400,78900,76360,78610,77940,3460,2790,624826,204962
20150831,78610,77940,78200,79300,76790,76810,77850,-1130,-90,674872,207056
20150901,76810,77850,76460,77370,75800,75810,76540,-2040,-1310,458718,217478
20150902,75810,76540,76000,76690,75560,76510,76150,-30,-390,475672,209048
20150907,76510,76150,76200,77200,76190,77000,76860,850,710,293244,209890
20150908,77000,76860,76870,76940,75300,76190,76070,-670,-790,595808,248922
20150909,76190,76070,77090,78870,76730,77790,77990,1720,1920,1253336,237720
20150910,77790,77990,78210,78720,77120,78710,77790,720,-200,1047802,251158
20150911,78710,77790,79400,80220,78750,79410,79530,1620,1740,1420664,245130
20150914,79410,79530,79100,79900,78230,78260,79060,-1270,-470,1062540,240600
20150915,78260,79060,77480,78060,76860,76960,77520,-2100,-1540,1094660,249360
20150916,76960,77520,77320,79380,77270,78950,78130,1430,610,1478896,247710
20150917,78950,78130,78800,79330,78300,78590,78760,460,630,1678798,251738
20150918,78590,78760,78110,78580,77810,77890,78170,-870,-590,1444806,268762
20150921,77890,78170,77200,78190,76320,78110,77110,-60,-1060,1442658,293284
20150922,78110,77110,77790,77970,76940,77090,77400,-20,290,1253948,293870
20150923,77090,77400,76780,76980,76030,76740,76440,-660,-960,1147082,302684
20150924,76740,76440,76940,77110,76300,76760,76680,320,240,779346,304598
20150925,76760,76680,76680,77850,76600,77100,77350,420,670,979700,280362
20150928,77100,77350,77300,77800,77220,77410,77520,60,170,384820,280330
20150929,77410,77520,77210,77420,75500,75540,76260,-1980,-1260,646524,280048
20150930,75540,76260,76260,77110,75950,77100,76420,840,160,479410,248998
20151008,77100,76420,78200,78530,77300,77450,77660,1030,1240,244958,253152
20151009,77450,77660,77510,79470,77360,79450,78530,1790,870,663132,260084
20151012,79450,78530,81000,81000,79000,80310,79770,1780,1240,786262,244502
20151013,80310,79770,80370,80380,78820,79620,79370,-150,-400,632286,240428
20151014,79620,79370,79300,79880,78970,79270,79410,-100,40,676222,241670
20151015,79270,79410,79400,80700,79200,80340,80040,930,630,875794,286750
20151016,80340,80040,80230,80900,79900,80390,80370,350,330,820446,285266
20151019,80390,80370,80280,80650,79110,79150,79920,-1220,-450,675768,270082
20151020,79150,79920,79150,79290,78050,78320,78480,-1600,-1440,673374,252482
20151021,78320,78480,78450,78690,77900,78130,78320,-350,-160,563356,255076
20151022,78130,78320,78100,79600,77710,78660,78510,340,190,546592,234838
20151023,78660,78510,78960,80010,78590,79980,79090,1470,580,669468,248752
20151026,79980,79090,79980,79980,78450,78590,79250,-500,160,679910,247344
20151027,78590,79250,78720,79280,78270,79150,78830,-100,-420,535496,242420
20151028,79150,78830,79200,79580,78800,79160,79110,330,280,562956,236902
20151029,79160,79110,79080,79900,78650,79130,79230,20,120,599260,236182
20151030,79130,79230,79000,79350,77130,77150,78140,-2080,-1090,743688,306602
20151102,77150,78140,77100,77390,76460,76590,76960,-1550,-1180,598726,335360
20151103,76590,76960,76700,77250,76190,76330,76700,-630,-260,547810,346974
20151104,76330,76700,76200,76680,75720,76510,76210,-190,-490,710650,362628
20151105,76510,76210,76190,76970,74780,74820,75830,-1390,-380,754986,406972
20151106,74820,75830,75800,75800,74560,74990,74950,-840,-880,702012,393540
20151109,74990,74950,74800,75200,73760,73990,74560,-960,-390,731148,432832
20151110,73990,74560,74100,74220,72430,73890,73320,-670,-1240,741658,431638
20151111,73890,73320,73450,73680,72750,72930,73200,-390,-120,779414,456998
20151112,72930,73200,73000,73750,72550,73290,73110,90,-90,669322,448788
20151113,73290,73110,72700,73640,72270,72930,73030,-180,-80,846614,466212
20151116,72930,73030,72830,73600,72700,73180,73120,150,90,558036,447322
20151117,73180,73120,73350,73350,70530,71240,71880,-1880,-1240,851516,446728
20151118,71240,71880,71450,71740,70110,70950,70980,-930,-900,666046,445772
20151119,70950,70980,70700,71020,69220,69770,70080,-1210,-900,701690,435448
20151120,69770,70080,69600,69790,68500,68740,69130,-1340,-950,860638,445614
20151123,68740,69130,69000,69200,64980,64980,67380,-4150,-1750,837472,446362
20151124,64980,67380,64180,65730,63310,64970,64390,-2410,-2990,1145120,413958
20151125,64970,64390,64800,68250,64550,68250,66960,3860,2570,1195734,378610
20151126,68250,66960,67900,72780,67360,70800,69970,3840,3010,1870082,367254
20151127,70800,69970,70790,72160,69010,69370,70550,-600,580,1643298,340084
20151130,69370,70550,68760,69150,67680,69100,68360,-1450,-2190,1294326,322532
ni1602,20150327,102070,102070,111190,111190,100530,100900,101260,-1170,-810,114,72
20150330,100900,101260,98730,99150,98100,98100,98710,-3160,-2550,18,78
20150331,98100,98710,99180,99180,96000,97000,97940,-1710,-770,30,90
20150401,97000,97940,,,,97940,97940,0,0,0,90
20150402,97940,97940,96600,96600,96600,96600,96600,-1340,-1340,12,80
20150403,96600,96600,96510,96510,96510,96510,96510,-90,-90,4,82
20150407,96510,96510,97800,97800,96600,96600,97060,90,550,12,90
20150408,96600,97060,95300,95300,93720,94600,94040,-2460,-3020,30,94
20150409,94600,94040,,,,93660,93660,-380,-380,0,94
20150410,93660,93660,94130,94130,93790,93790,94030,130,370,8,102
20150413,93790,94030,,,,94800,94800,770,770,0,102
20150414,94800,94800,94220,94220,93850,93850,94120,-950,-680,8,100
20150415,93850,94120,,,,94550,94550,430,430,0,100
20150416,94550,94550,94720,94960,94720,94960,94870,410,320,16,112
20150417,94960,94870,94830,94830,94760,94760,94790,-110,-80,4,112
20150420,94760,94790,95400,95400,94650,94700,94730,-90,-60,24,106
20150421,94700,94730,93840,94930,93840,94060,94280,-670,-450,16,108
20150422,94060,94280,,,,94620,94620,340,340,0,108
20150423,94620,94620,95100,95100,94600,94600,94750,-20,130,28,106
20150424,94600,94750,,,,94980,94980,230,230,0,106
20150427,94980,94980,,,,98810,98810,3830,3830,0,106
20150428,98810,98810,,,,101050,101050,2240,2240,0,106
20150429,101050,101050,,,,100520,100520,-530,-530,0,106
20150430,100520,100520,,,,100520,100520,0,0,0,106
20150504,100520,100520,,,,105540,105540,5020,5020,0,106
20150505,105540,105540,107130,107130,107130,107130,107130,1590,1590,2,106
20150506,107130,107130,110660,110680,109560,109560,110390,2430,3260,8,108
20150507,109560,110390,106270,106990,104900,105260,106680,-5130,-3710,122,176
20150508,105260,106680,109970,109970,106510,106510,106640,-170,-40,88,166
20150511,106510,106640,,,,106860,106860,220,220,0,166
20150512,106860,106860,107560,109360,107560,108120,108650,1260,1790,34,178
20150513,108120,108650,108200,108500,105610,106520,107230,-2130,-1420,26,170
20150514,106520,107230,107740,107740,105710,105710,107000,-1520,-230,46,176
20150515,105710,107000,106050,106960,105230,106960,106000,-40,-1000,26,166
20150518,106960,106000,106510,106510,105670,105670,105890,-330,-110,8,164
20150519,105670,105890,106100,106100,103890,103890,105360,-2000,-530,6,160
20150520,103890,105360,,,,100090,100090,-5270,-5270,0,160
20150521,100090,100090,,,,100090,100090,0,0,0,160
20150522,100090,100090,99500,99690,97730,97730,98780,-2360,-1310,10,162
20150525,97730,98780,,,,98130,98130,-650,-650,0,162
20150526,98130,98130,98810,98810,98060,98060,98390,-70,260,6,162
20150527,98060,98390,,,,98390,98390,0,0,0,162
20150528,98390,98390,98270,99430,98270,99400,98980,1010,590,16,164
20150529,99400,98980,97260,97260,96540,96540,96720,-2440,-2260,32,164
20150601,96540,96720,95550,95550,95550,95550,95550,-1170,-1170,2,164
20150602,95550,95550,97270,99550,97270,99200,97960,3650,2410,30,158
20150603,99200,97960,99900,99910,98710,98710,99560,750,1600,38,158
20150604,98710,99560,,,,99320,99320,-240,-240,0,158
20150605,99320,99320,,,,99320,99320,0,0,0,158
20150608,99320,99320,99740,99790,99740,99790,99760,470,440,4,158
20150609,99790,99760,101110,102670,100780,101200,101030,1440,1270,26,168
20150610,101200,101030,101540,101560,100750,101560,101150,530,120,12,174
20150611,101560,101150,101470,101990,101170,101230,101290,80,140,22,162
20150612,101230,101290,99600,99600,98050,98050,99270,-3240,-2020,14,166
20150615,98050,99270,98250,99770,98080,99710,99460,440,190,22,182
20150616,99710,99460,97050,97570,97050,97570,97390,-1890,-2070,6,188
20150617,97570,97390,,,,97390,97390,0,0,0,188
20150618,97390,97390,96890,96890,96560,96880,96740,-510,-650,10,182
20150619,96880,96740,,,,96740,96740,0,0,0,182
20150623,96740,96740,,,,96090,96090,-650,-650,0,182
20150624,96090,96090,,,,96090,96090,0,0,0,182
20150625,96090,96090,96440,98490,96000,96000,96330,-90,240,72,170
20150626,96000,96330,95270,95900,94090,94090,95640,-2240,-690,28,186
20150629,94090,95640,94190,94210,90850,91650,92210,-3990,-3430,18,184
20150630,91650,92210,89850,90420,87590,88120,88350,-4090,-3860,76,176
20150701,88120,88350,90580,91490,89000,89570,90130,1220,1780,54,178
20150702,89570,90130,89130,90040,89130,90040,89430,-90,-700,14,178
20150703,90040,89430,91650,91650,89420,90450,90830,1020,1400,18,182
20150706,90450,90830,88760,90120,86460,86800,87900,-4030,-2930,70,166
20150707,86800,87900,86800,86860,86660,86750,86730,-1150,-1170,28,170
20150708,86750,86730,82390,82410,82390,82410,82390,-4320,-4340,22,160
20150709,82410,82390,78280,86500,78270,85450,80640,3060,-1750,92,136
20150710,85450,80640,84660,84670,84660,84670,84660,4030,4020,4,134
20150713,84670,84660,83910,84440,82390,82390,83460,-2270,-1200,10,136
20150714,82390,83460,86330,86330,84860,84860,85820,1400,2360,6,132
20150715,84860,85820,86160,86440,86160,86440,86300,620,480,4,130
20150716,86440,86300,,,,85590,85590,-710,-710,0,130
20150717,85590,85590,,,,85630,85630,40,40,0,130
20150720,85630,85630,,,,86200,86200,570,570,0,130
20150721,86200,86200,,,,87400,87400,1200,1200,0,130
20150722,87400,87400,,,,87400,87400,0,0,0,130
20150723,87400,87400,,,,85580,85580,-1820,-1820,0,130
20150724,85580,85580,84520,86400,84520,86400,85140,820,-440,20,132
20150727,86400,85140,,,,84080,84080,-1060,-1060,0,132
20150728,84080,84080,82650,85100,82650,85100,83870,1020,-210,4,130
20150729,85100,83870,85000,85000,85000,85000,85000,1130,1130,2,130
20150730,85000,85000,85370,85370,84060,84060,84710,-940,-290,12,130
20150731,84060,84710,,,,83530,83530,-1180,-1180,0,130
20150803,83530,83530,,,,82640,82640,-890,-890,0,130
20150804,82640,82640,81890,81890,81890,81890,81890,-750,-750,2,128
20150805,81890,81890,81190,82620,81190,82570,81850,680,-40,20,128
20150806,82570,81850,82590,82590,82590,82590,82590,740,740,2,126
20150807,82590,82590,,,,82090,82090,-500,-500,0,126
20150810,82090,82090,,,,82090,82090,0,0,0,126
20150811,82090,82090,85420,85500,85420,85500,85480,3410,3390,20,146
20150812,85500,85480,82380,84060,81260,84060,82540,-1420,-2940,26,146
20150813,84060,82540,84580,84580,83360,83850,83900,1310,1360,8,150
20150814,83850,83900,83960,83960,83340,83340,83650,-560,-250,4,148
20150817,83340,83650,83460,84670,82660,83100,83480,-550,-170,32,148
20150818,83100,83480,83600,83640,82000,82000,82930,-1480,-550,38,154
20150819,82000,82930,81880,81880,81880,81880,81880,-1050,-1050,2,154
20150820,81880,81880,81180,81860,81180,81860,81580,-20,-300,6,152
20150821,81860,81580,81650,82760,81050,81050,81580,-530,0,44,154
20150824,81050,81580,79690,79690,77680,77870,78160,-3710,-3420,60,156
20150825,77870,78160,,,,74880,74880,-3280,-3280,0,156
20150826,74880,74880,,,,74880,74880,0,0,0,156
20150827,74880,74880,75190,76500,75100,76500,75930,1620,1050,22,154
20150828,76500,75930,79000,79000,78800,78800,78900,2870,2970,4,154
20150831,78800,78900,,,,78900,78900,0,0,0,154
20150901,78900,78900,76790,77200,76790,77050,76960,-1850,-1940,8,152
20150902,77050,76960,77050,77050,76390,76390,76790,-570,-170,16,158
20150907,76390,76790,,,,77510,77510,720,720,0,158
20150908,77510,77510,76750,78110,76170,76670,77210,-840,-300,128,162
20150909,76670,77210,,,,79160,79160,1950,1950,0,162
20150910,79160,79160,78400,78400,78400,78400,78400,-760,-760,2,160
20150911,78400,78400,78450,80030,78450,79740,79070,1340,670,40,168
20150914,79740,79070,79690,79810,79000,79000,79290,-70,220,48,138
20150915,79000,79290,77550,77550,77350,77350,77490,-1940,-1800,14,140
20150916,77350,77490,76710,79140,76710,79140,78610,1650,1120,72,132
20150917,79140,78610,78930,79440,78930,79420,79330,810,720,58,134
20150918,79420,79330,78070,78750,78070,78620,78480,-710,-850,6,134
20150921,78620,78480,,,,77420,77420,-1060,-1060,0,134
20150922,77420,77420,77610,78470,76280,77470,77180,50,-240,900,138
20150923,77470,77180,76620,77200,76380,77200,76800,20,-380,56,136
20150924,77200,76800,77320,77480,76380,77210,76930,410,130,26,136
20150925,77210,76930,77190,77900,77190,77880,77570,950,640,52,138
20150928,77880,77570,77660,78050,77650,77920,77840,350,270,24,138
20150929,77920,77840,76610,76610,76610,76610,76610,-1230,-1230,2,138
20150930,76610,76610,76800,76800,76800,76800,76800,190,190,2,136
20151008,76800,76800,77900,77900,77900,77900,77900,1100,1100,2,138
20151009,77900,77900,78510,80400,78510,80400,79190,2500,1290,24,138
20151012,80400,79190,80900,80900,79830,80610,80490,1420,1300,8,136
20151013,80610,80490,79850,80850,78970,79620,79440,-870,-1050,64,152
20151014,79620,79440,79900,79900,79490,79670,79600,230,160,32,168
20151015,79670,79600,79780,80900,79780,80900,80050,1300,450,30,148
20151016,80900,80050,81650,81650,79360,80700,80470,650,420,20,148
20151019,80700,80470,79500,79500,79500,79500,79500,-970,-970,2,150
20151020,79500,79500,77470,79490,77470,78590,78600,-910,-900,16,150
20151021,78590,78600,78970,78970,78030,78790,78590,190,-10,6,148
20151022,78790,78590,,,,78590,78590,0,0,0,148
20151023,78590,78590,80000,80000,78960,79030,79440,440,850,52,146
20151026,79030,79440,80030,80030,79000,79000,79460,-440,20,60,152
20151027,79000,79460,79170,79670,78670,79670,79180,210,-280,26,148
20151028,79670,79180,79390,79700,78400,79700,79350,520,170,22,146
20151029,79700,79350,79690,79690,79690,79690,79690,340,340,2,144
20151030,79690,79690,77710,77710,77560,77560,77620,-2130,-2070,8,144
20151102,77560,77620,,,,76450,76450,-1170,-1170,0,144
20151103,76450,76450,76760,77480,76760,77230,77150,780,700,50,144
20151104,77230,77150,,,,77150,77150,0,0,0,144
20151105,77150,77150,77110,77110,75300,75300,76490,-1850,-660,8,144
20151106,75300,76490,75190,75690,75180,75300,75440,-1190,-1050,24,142
20151109,75300,75440,75870,75880,74460,75880,75400,440,-40,6,142
20151110,75880,75400,75400,75400,72830,73990,74080,-1410,-1320,30,146
20151111,73990,74080,73820,73820,73400,73400,73550,-680,-530,8,148
20151112,73400,73550,73250,73910,73240,73770,73570,220,20,70,152
20151113,73770,73570,74870,74870,72380,73490,73380,-80,-190,80,182
20151116,73490,73380,73560,74540,73560,73610,74120,230,740,14,188
20151117,73610,74120,73650,73670,69690,71760,72070,-2360,-2050,132,220
20151118,71760,72070,71530,71830,70030,70990,71170,-1080,-900,194,310
20151119,70990,71170,70980,71070,69510,69700,70040,-1470,-1130,328,456
20151120,69700,70040,69590,69800,68550,68910,69270,-1130,-770,208,470
20151123,68910,69270,68410,69180,65110,65110,67300,-4160,-1970,118,470
20151124,65110,67300,64370,66360,63570,65870,64590,-1430,-2710,82,480
20151125,65870,64590,65460,68450,64910,68430,67200,3840,2610,318,498
20151126,68430,67200,68110,71230,66780,70510,70410,3310,3210,562,544
20151127,70510,70410,71290,72300,68510,69090,70400,-1320,-10,340,544
20151130,69090,70400,68480,69390,67750,68940,68360,-1460,-2040,372,592
ni1603,20150327,102070,102070,100640,102010,100290,101430,100980,-640,-1090,16,12
20150330,101430,100980,99230,100620,97330,99740,98890,-1240,-2090,60,54
20150331,99740,98890,96100,100270,96100,97100,98280,-1790,-610,48,76
20150401,97100,98280,,,,95500,95500,-2780,-2780,0,76
20150402,95500,95500,97160,97450,96850,97300,97200,1800,1700,50,102
20150403,97300,97200,97040,97890,96670,97890,96990,690,-210,28,102
20150407,97890,96990,97970,98310,96660,96660,97590,-330,600,42,124
20150408,96660,97590,95600,95600,93980,94610,94870,-2980,-2720,58,154
20150409,94610,94870,95070,95600,94330,94670,94890,-200,20,20,164
20150410,94670,94890,95000,95000,93840,94550,94350,-340,-540,18,174
20150413,94550,94350,94920,95670,93990,95670,94700,1320,350,16,178
20150414,95670,94700,95220,95220,93420,93420,94020,-1280,-680,96,212
20150415,93420,94020,93500,94490,93500,94280,94090,260,70,6,212
20150416,94280,94090,95420,95550,95030,95030,95290,940,1200,10,222
20150417,95030,95290,95630,95630,94580,95090,95140,-200,-150,16,234
20150420,95090,95140,95270,95560,93510,94280,94490,-860,-650,88,270
20150421,94280,94490,94290,95000,94290,94320,94630,-170,140,42,292
20150422,94320,94630,94630,95000,94430,94900,94690,270,60,58,314
20150423,94900,94690,95000,95370,94500,94530,94720,-160,30,142,412
20150424,94530,94720,94760,96000,94760,96000,95220,1280,500,84,442
20150427,96000,95220,96910,99980,96800,99970,98390,4750,3170,88,440
20150428,99970,98390,101390,101390,100100,100100,100260,1710,1870,44,434
20150429,100100,100260,100940,102090,99690,99690,100550,-570,290,60,474
20150430,99690,100550,101900,104250,101900,103900,103430,3350,2880,56,460
20150504,103900,103430,104800,105980,104440,105280,105450,1850,2020,26,456
20150505,105280,105450,106970,107370,105010,106000,106000,550,550,32,474
20150506,106000,106000,108550,111290,108010,109590,109530,3590,3530,196,510
20150507,109590,109530,110160,110160,105580,105810,107160,-3720,-2370,122,552
20150508,105810,107160,106890,108050,105440,107840,107210,680,50,112,592
20150511,107840,107210,108370,110490,107270,109880,109050,2670,1840,78,612
20150512,109880,109050,109520,111430,106540,106540,107620,-2510,-1430,106,656
20150513,106540,107620,107760,108950,107550,107610,107940,-10,320,58,656
20150514,107610,107940,107800,108050,105000,106060,107040,-1880,-900,124,666
20150515,106060,107040,104450,107000,104450,107000,106060,-40,-980,24,672
20150518,107000,106060,106000,106190,105500,105740,105890,-320,-170,16,680
20150519,105740,105890,105410,105410,103460,103810,104570,-2080,-1320,110,732
20150520,103810,104570,101510,101510,99340,99340,99760,-5230,-4810,42,746
20150521,99340,99760,99290,99780,99200,99690,99500,-70,-260,26,750
20150522,99690,99500,99100,101080,97100,98050,98970,-1450,-530,74,762
20150525,98050,98970,97420,97960,97000,97360,97310,-1610,-1660,60,812
20150526,97360,97310,99060,99240,98510,98510,98970,1200,1660,48,838
20150527,98510,98970,97920,98190,97510,97510,97780,-1460,-1190,18,838
20150528,97510,97780,97570,99960,97570,98570,99100,790,1320,28,832
20150529,98570,99100,99060,99060,97090,97470,97940,-1630,-1160,24,852
20150601,97470,97940,97150,97460,96820,97460,97200,-480,-740,18,860
20150602,97460,97200,97480,100500,97480,100310,99200,3110,2000,22,852
20150603,100310,99200,100390,101200,99350,99790,100500,590,1300,72,846
20150604,99790,100500,99150,99670,98250,98510,98830,-1990,-1670,36,854
20150605,98510,98830,99100,99710,98360,98690,99400,-140,570,68,896
20150608,98690,99400,99020,100320,99020,100320,99700,920,300,72,904
20150609,100320,99700,101500,101900,101290,101900,101640,2200,1940,10,900
20150610,101900,101640,101540,101690,100820,101300,101270,-340,-370,86,870
20150611,101300,101270,102170,102170,101500,101680,101730,410,460,34,900
20150612,101680,101730,99900,99900,98110,98110,98540,-3620,-3190,32,918
20150615,98110,98540,98810,98810,97610,97880,98200,-660,-340,14,926
20150616,97880,98200,97430,98030,95930,96190,97150,-2010,-1050,32,948
20150617,96190,97150,95630,96060,95420,95840,95730,-1310,-1420,26,958
20150618,95840,95730,96240,96710,96240,96710,96450,980,720,10,948
20150619,96710,96450,95530,95530,95280,95280,95330,-1170,-1120,10,938
20150623,95280,95330,,,,95330,95330,0,0,0,938
20150624,95330,95330,96150,97770,95660,96420,96420,1090,1090,12,934
20150625,96420,96420,96150,96410,95660,95660,96220,-760,-200,20,934
20150626,95660,96220,95250,96040,94450,94450,95180,-1770,-1040,22,944
20150629,94450,95180,94160,94180,91450,93440,93190,-1740,-1990,78,992
20150630,93440,93190,90810,90810,88530,88780,88880,-4410,-4310,176,978
20150701,88780,88880,88680,91290,88670,90500,90120,1620,1240,88,1010
20150702,90500,90120,90330,91640,90290,91120,90910,1000,790,48,988
20150703,91120,90910,92180,92180,90680,90870,91090,-40,180,38,984
20150706,90870,91090,90540,90540,87010,87900,87950,-3190,-3140,184,914
20150707,87900,87950,87790,89050,86230,86230,86930,-1720,-1020,96,908
20150708,86230,86930,82580,82580,82580,82580,82580,-4350,-4350,32,888
20150709,82580,82580,78010,86570,75970,85500,80040,2920,-2540,524,762
20150710,85500,80040,,,,84040,84040,4000,4000,0,762
20150713,84040,84040,85840,85840,82970,83150,83470,-890,-570,112,824
20150714,83150,83470,87080,87590,85280,86020,86280,2550,2810,266,950
20150715,86020,86280,86300,88640,86300,88640,87780,2360,1500,34,964
20150716,88640,87780,88210,88220,85550,86860,87100,-920,-680,102,1040
20150717,86860,87100,87110,87110,86370,86460,86550,-640,-550,82,1034
20150720,86460,86550,86680,86680,86680,86680,86680,130,130,10,1024
20150721,86680,86680,86030,88020,86030,88020,87740,1340,1060,64,1026
20150722,88020,87740,88590,88590,85830,86330,87450,-1410,-290,126,1036
20150723,86330,87450,85990,86320,85620,85950,86020,-1500,-1430,22,1042
20150724,85950,86020,85400,85490,84600,84600,85290,-1420,-730,60,1056
20150727,84600,85290,85410,85410,85140,85140,85270,-150,-20,4,1056
20150728,85140,85270,82980,82980,82980,82980,82980,-2290,-2290,2,1056
20150729,82980,82980,85740,85960,83990,85800,85160,2820,2180,104,1066
20150730,85800,85160,84800,85000,84790,84790,84890,-370,-270,8,1062
20150731,84790,84890,83680,83680,83300,83300,83490,-1590,-1400,12,1068
20150803,83300,83490,84130,84240,82000,82000,82700,-1490,-790,24,1068
20150804,82000,82700,81720,82160,81490,82160,81780,-540,-920,10,1066
20150805,82160,81780,82780,82780,81930,81930,82570,150,790,48,1072
20150806,81930,82570,82820,82990,82150,82150,82590,-420,20,24,1074
20150807,82150,82590,82250,82250,82250,82250,82250,-340,-340,2,1072
20150810,82250,82250,83510,83510,83510,83510,83510,1260,1260,2,1072
20150811,83510,83510,83630,84830,83630,83780,84030,270,520,30,1086
20150812,83780,84030,82640,83600,82640,83510,83320,-520,-710,32,1074
20150813,83510,83320,84820,84980,83880,83880,84840,560,1520,64,1052
20150814,83880,84840,84220,84220,83310,83410,83580,-1430,-1260,86,1056
20150817,83410,83580,84160,84160,83350,83450,83630,-130,50,100,1000
20150818,83450,83630,83950,84070,81810,82300,83360,-1330,-270,694,952
20150819,82300,83360,81820,82500,81820,82500,82110,-860,-1250,36,962
20150820,82500,82110,82270,82400,80890,81390,81590,-720,-520,224,1074
20150821,81390,81590,81780,81900,81160,81160,81480,-430,-110,82,1112
20150824,81160,81480,80080,80110,77400,77400,78420,-4080,-3060,122,1142
20150825,77400,78420,76000,77030,74490,74510,75650,-3910,-2770,414,1282
20150826,74510,75650,76640,76870,75050,75050,75820,-600,170,200,1316
20150827,75050,75820,75150,76530,75150,76200,75580,380,-240,68,1308
20150828,76200,75580,77340,79350,77230,79280,78610,3700,3030,322,1256
20150831,79280,78610,78330,79470,77610,77650,78560,-960,-50,156,1220
20150901,77650,78560,77060,77730,76970,77100,77260,-1460,-1300,96,1230
20150902,77100,77260,76840,77310,76440,77310,76870,50,-390,14,1226
20150907,77310,76870,77550,77730,77550,77730,77640,860,770,4,1224
20150908,77730,77640,77300,77300,76150,76290,76610,-1350,-1030,28,1228
20150909,76290,76610,77490,79500,77490,79160,78780,2550,2170,56,1236
20150910,79160,78780,78840,79040,78130,79040,78660,260,-120,24,1252
20150911,79040,78660,79870,80810,79660,79880,80100,1220,1440,208,1296
20150914,79880,80100,79980,80400,79120,79120,80030,-980,-70,60,1266
20150915,79120,80030,78480,78740,77930,77930,78400,-2100,-1630,196,1374
20150916,77930,78400,78080,79700,78050,79700,78710,1300,310,102,1354
20150917,79700,78710,79210,79800,79100,79190,79460,480,750,320,1440
20150918,79190,79460,79010,79120,78500,78500,78950,-960,-510,252,1526
20150921,78500,78950,78020,78680,77000,78430,77810,-520,-1140,526,1574
20150922,78430,77810,78520,78520,77020,77550,78110,-260,300,404,1624
20150923,77550,78110,77410,77410,76680,77360,77030,-750,-1080,114,1610
20150924,77360,77030,77530,77550,76950,77080,77360,50,330,230,1574
20150925,77080,77360,76880,78300,76880,77910,77870,550,510,114,1588
20150928,77910,77870,77990,78190,77900,77960,78110,90,240,354,1542
20150929,77960,78110,77750,77850,76000,76350,76640,-1760,-1470,118,1538
20150930,76350,76640,76470,77450,76470,77450,76800,810,160,404,1468
20151008,77450,76800,78590,78590,77690,77800,77970,1000,1170,296,1506
20151009,77800,77970,78050,79780,77880,79710,79320,1740,1350,450,1432
20151012,79710,79320,81430,81490,79500,80660,80270,1340,950,662,1440
20151013,80660,80270,80540,80550,79190,80020,79730,-250,-540,566,1408
20151014,80020,79730,79420,80190,79170,79710,79790,-20,60,624,1472
20151015,79710,79790,79960,81180,79600,80750,80450,960,660,434,1474
20151016,80750,80450,80670,81290,80380,80560,80720,110,270,416,1470
20151019,80560,80720,80920,80930,79610,79610,80280,-1110,-440,512,1502
20151020,79610,80280,79710,79710,78600,78700,79020,-1580,-1260,410,1630
20151021,78700,79020,78890,79130,78450,78500,78900,-520,-120,140,1678
20151022,78500,78900,78510,79640,78160,79300,78940,400,40,362,1732
20151023,79300,78940,79190,80180,79070,80180,79550,1240,610,78,1734
20151026,80180,79550,80210,80230,79000,79100,79570,-450,20,246,1800
20151027,79100,79570,79380,79770,78880,79770,79130,200,-440,122,1812
20151028,79770,79130,79640,80000,79380,80000,79680,870,550,58,1808
20151029,80000,79680,79490,80190,79230,79710,79740,30,60,92,1764
20151030,79710,79740,79510,79810,77820,77880,78290,-1860,-1450,140,1842
20151102,77880,78290,77800,77800,77020,77080,77570,-1210,-720,304,1826
20151103,77080,77570,77300,77690,76800,76800,77180,-770,-390,56,1836
20151104,76800,77180,76930,77160,76020,77000,76650,-180,-530,198,1910
20151105,77000,76650,76840,77370,75300,75380,76490,-1270,-160,508,2212
20151106,75380,76490,75420,75770,75270,75550,75420,-940,-1070,344,2370
20151109,75550,75420,75210,75600,74420,74580,75170,-840,-250,158,2446
20151110,74580,75170,74590,74630,73010,74200,73780,-970,-1390,396,2436
20151111,74200,73780,74110,74110,73330,73390,73640,-390,-140,130,2436
20151112,73390,73640,73410,74050,73230,73770,73480,130,-160,142,2394
20151113,73770,73480,73100,73900,72770,73450,73520,-30,40,548,2400
20151116,73450,73520,73450,73980,72660,73740,73660,220,140,158,2328
20151117,73740,73660,73640,73660,70570,71650,72510,-2010,-1150,418,2350
20151118,71650,72510,71810,72120,70660,71520,71590,-990,-920,244,2376
20151119,71520,71590,71370,71370,68930,70110,70590,-1480,-1000,406,2382
20151120,70110,70590,70590,70590,68810,69240,69640,-1350,-950,356,2378
20151123,69240,69640,69360,69590,65460,65460,66950,-4180,-2690,208,2398
20151124,65460,66950,64580,66090,63860,65280,64600,-1670,-2350,768,2406
20151125,65280,64600,65800,68470,65660,68470,67380,3870,2780,282,2362
20151126,68470,67380,68100,71420,67640,70780,70070,3400,2690,442,2338
20151127,70780,70070,70990,72200,69460,69740,70820,-330,750,410,2322
20151130,69740,70820,67870,69340,67710,69180,68320,-1640,-2500,728,2262
ni1604,20150416,94090,94090,95060,95060,95060,95060,95060,970,970,2,2
20150417,95060,95060,95590,95590,95540,95540,95560,480,500,8,10
20150420,95540,95560,95220,95220,94800,94800,95020,-760,-540,12,22
20150421,94800,95020,,,,95160,95160,140,140,0,22
20150422,95160,95160,96960,96960,95350,95380,96610,220,1450,78,82
20150423,95380,96610,94680,94680,94680,94680,94680,-1930,-1930,4,86
20150424,94680,94680,95460,95460,95460,95460,95460,780,780,2,88
20150427,95460,95460,99540,99540,99540,99540,99540,4080,4080,2,86
20150428,99540,99540,,,,101430,101430,1890,1890,0,86
20150429,101430,101430,101560,101560,100200,100200,100570,-1230,-860,10,88
20150430,100200,100570,102020,102020,102020,102020,102020,1450,1450,4,92
20150504,102020,102020,105250,105830,105250,105830,105390,3810,3370,8,90
20150505,105830,105390,106660,106660,106660,106660,106660,1270,1270,2,90
20150506,106660,106660,109750,111980,107310,107310,109870,650,3210,18,102
20150507,107310,109870,112090,112090,105930,107520,108710,-2350,-1160,80,96
20150508,107520,108710,108790,109000,107790,108160,108570,-550,-140,32,100
20150511,108160,108570,109090,111000,109090,111000,110080,2430,1510,14,106
20150512,111000,110080,110080,110130,108130,108130,108860,-1950,-1220,44,116
20150513,108130,108860,108190,108190,107200,107200,107690,-1660,-1170,4,114
20150514,107200,107690,108390,108390,106350,106350,107030,-1340,-660,6,116
20150515,106350,107030,,,,106050,106050,-980,-980,0,116
20150518,106050,106050,,,,105880,105880,-170,-170,0,116
20150519,105880,105880,,,,105880,105880,0,0,0,116
20150520,105880,105880,100580,100580,100580,100580,100580,-5300,-5300,12,114
20150521,100580,100580,,,,100320,100320,-260,-260,0,114
20150522,100320,100320,100670,100670,100670,100670,100670,350,350,2,114
20150525,100670,100670,,,,99000,99000,-1670,-1670,0,114
20150526,99000,99000,99000,99000,98880,98880,98940,-120,-60,4,118
20150527,98880,98940,,,,97750,97750,-1190,-1190,0,118
20150528,97750,97750,,,,97750,97750,0,0,0,118
20150529,97750,97750,,,,97750,97750,0,0,0,118
20150601,97750,97750,97690,98170,97690,98040,98110,290,360,22,132
20150602,98040,98110,100070,100070,97300,99680,98660,1570,550,26,118
20150603,99680,98660,100900,100900,100900,100900,100900,2240,2240,2,118
20150604,100900,100900,99900,99900,99900,99900,99900,-1000,-1000,2,120
20150605,99900,99900,,,,100480,100480,580,580,0,120
20150608,100480,100480,,,,100790,100790,310,310,0,120
20150609,100790,100790,,,,100800,100800,10,10,0,120
20150610,100800,100800,,,,100800,100800,0,0,0,120
20150611,100800,100800,,,,101260,101260,460,460,0,120
20150612,101260,101260,,,,98090,98090,-3170,-3170,0,120
20150615,98090,98090,,,,98090,98090,0,0,0,120
20150616,98090,98090,97000,97000,97000,97000,97000,-1090,-1090,2,120
20150617,97000,97000,,,,97000,97000,0,0,0,120
20150618,97000,97000,,,,97730,97730,730,730,0,120
20150619,97730,97730,,,,96590,96590,-1140,-1140,0,120
20150623,96590,96590,95730,96180,95730,96180,95870,-410,-720,14,120
20150624,96180,95870,96290,96290,96290,96290,96290,420,420,2,120
20150625,96290,96290,96250,96250,96250,96250,96250,-40,-40,6,120
20150626,96250,96250,94780,94830,94780,94780,94800,-1470,-1450,16,112
20150629,94780,94800,94540,94540,91820,92400,93630,-2400,-1170,16,120
20150630,92400,93630,92400,92400,92400,92400,92400,-1230,-1230,2,120
20150701,92400,92400,91650,92670,91650,92670,92160,270,-240,4,124
20150702,92670,92160,,,,92970,92970,810,810,0,124
20150703,92970,92970,92900,92900,92000,92000,92450,-970,-520,4,122
20150706,92000,92450,90820,90820,87830,88300,88670,-4150,-3780,54,122
20150707,88300,88670,89140,89140,88240,88240,88690,-430,20,4,122
20150708,88240,88690,84260,84260,84260,84260,84260,-4430,-4430,2,122
20150709,84260,84260,80050,86630,80040,85600,81920,1340,-2340,66,102
20150710,85600,81920,86010,86010,85850,86010,85950,4090,4030,6,102
20150713,86010,85950,85810,85810,85810,85810,85810,-140,-140,2,102
20150714,85810,85810,,,,86080,86080,270,270,0,102
20150715,86080,86080,,,,87550,87550,1470,1470,0,102
20150716,87550,87550,,,,87550,87550,0,0,0,102
20150717,87550,87550,87250,87250,87250,87250,87250,-300,-300,2,102
20150720,87250,87250,87770,87770,87770,87770,87770,520,520,2,100
20150721,87770,87770,89870,89870,89870,89870,89870,2100,2100,6,98
20150722,89870,89870,89600,89600,88680,88680,89380,-1190,-490,54,136
20150723,88680,89380,,,,89380,89380,0,0,0,136
20150724,89380,89380,85770,86330,84940,84940,85730,-4440,-3650,18,144
20150727,84940,85730,85240,85240,85120,85120,85160,-610,-570,6,148
20150728,85120,85160,,,,82870,82870,-2290,-2290,0,148
20150729,82870,82870,,,,85050,85050,2180,2180,0,148
20150730,85050,85050,,,,84780,84780,-270,-270,0,148
20150731,84780,84780,,,,84780,84780,0,0,0,148
20150803,84780,84780,84150,84200,83720,83720,84080,-1060,-700,12,154
20150804,83720,84080,,,,83140,83140,-940,-940,0,154
20150805,83140,83140,82480,82490,82410,82410,82460,-730,-680,6,152
20150806,82410,82460,83000,83000,83000,83000,83000,540,540,2,150
20150807,83000,83000,,,,83000,83000,0,0,0,150
20150810,83000,83000,,,,84270,84270,1270,1270,0,150
20150811,84270,84270,,,,84790,84790,520,520,0,150
20150812,84790,84790,,,,84080,84080,-710,-710,0,150
20150813,84080,84080,85300,85890,85300,85480,85630,1400,1550,76,136
20150814,85480,85630,83220,83220,83220,83220,83220,-2410,-2410,2,134
20150817,83220,83220,84540,84540,84090,84090,84380,870,1160,16,132
20150818,84090,84380,84090,85490,83970,83990,84490,-390,110,36,138
20150819,83990,84490,,,,84490,84490,0,0,0,138
20150820,84490,84490,83300,83300,81750,81750,82520,-2740,-1970,4,138
20150821,81750,82520,82570,82570,82210,82210,82360,-310,-160,6,136
20150824,82210,82360,78490,78490,78490,78490,78490,-3870,-3870,4,136
20150825,78490,78490,77160,77160,74560,75050,75390,-3440,-3100,32,144
20150826,75050,75390,78160,78160,74720,76960,76340,1570,950,56,144
20150827,76960,76340,76110,76840,76090,76840,76440,500,100,48,122
20150828,76840,76440,77840,77840,77830,77830,77830,1390,1390,6,120
20150831,77830,77830,78840,81140,77340,78570,79360,740,1530,18,110
20150901,78570,79360,77740,77740,77740,77740,77740,-1620,-1620,2,108
20150902,77740,77740,,,,77350,77350,-390,-390,0,108
20150907,77350,77350,78080,79530,77710,79530,78440,2180,1090,14,112
20150908,79530,78440,78080,78080,77520,77520,77800,-920,-640,6,108
20150909,77520,77800,78520,81490,77970,79290,79200,1490,1400,46,104
20150910,79290,79200,78950,80510,77780,78300,78830,-900,-370,12,106
20150911,78300,78830,,,,80280,80280,1450,1450,0,106
20150914,80280,80280,80510,80780,80510,80780,80640,500,360,4,106
20150915,80780,80640,,,,79000,79000,-1640,-1640,0,106
20150916,79000,79000,79400,79720,79400,79720,79560,720,560,4,104
20150917,79720,79560,,,,79560,79560,0,0,0,104
20150918,79560,79560,,,,79560,79560,0,0,0,104
20150921,79560,79560,78220,78220,77760,77760,77990,-1800,-1570,4,104
20150922,77760,77990,78300,78350,78250,78300,78300,310,310,10,98
20150923,78300,78300,77110,77890,77110,77700,77700,-600,-600,20,96
20150924,77700,77700,77580,77580,77580,77580,77580,-120,-120,2,96
20150925,77580,77580,,,,78090,78090,510,510,0,96
20150928,78090,78090,,,,78090,78090,0,0,0,96
20150929,78090,78090,77250,77250,75860,76440,76210,-1650,-1880,50,88
20150930,76440,76210,76220,78240,76220,78240,77230,2030,1020,8,88
20151008,78240,77230,79200,79200,77200,78280,78200,1050,970,8,86
20151009,78280,78200,79720,80080,79720,80050,79890,1850,1690,10,80
20151012,80050,79890,80380,81120,80380,81120,81030,1230,1140,18,88
20151013,81120,81030,,,,81030,81030,0,0,0,88
20151014,81030,81030,80500,81960,79290,80350,80770,-680,-260,50,100
20151015,80350,80770,80150,81360,80150,81040,80820,270,50,12,102
20151016,81040,80820,,,,80820,80820,0,0,0,102
20151019,80820,80820,81120,81120,80170,80170,80810,-650,-10,10,94
20151020,80170,80810,79340,79340,79000,79000,79160,-1810,-1650,10,92
20151021,79000,79160,79300,79300,79300,79300,79300,140,140,10,100
20151022,79300,79300,79940,79940,78560,78560,79250,-740,-50,12,102
20151023,78560,79250,80260,80530,79870,80530,80160,1280,910,12,100
20151026,80530,80160,,,,79740,79740,-420,-420,0,100
20151027,79740,79740,79310,79310,79310,79310,79310,-430,-430,30,94
20151028,79310,79310,79880,79880,79880,79880,79880,570,570,2,92
20151029,79880,79880,80050,80050,80050,80050,80050,170,170,6,86
20151030,80050,80050,80020,80020,80020,80020,80020,-30,-30,8,80
20151102,80020,80020,77870,77870,77870,77870,77870,-2150,-2150,2,80
20151103,77870,77870,,,,77480,77480,-390,-390,0,80
20151104,77480,77480,,,,76950,76950,-530,-530,0,80
20151105,76950,76950,,,,76780,76780,-170,-170,0,80
20151106,76780,76780,,,,76780,76780,0,0,0,80
20151109,76780,76780,,,,76520,76520,-260,-260,0,80
20151110,76520,76520,,,,75110,75110,-1410,-1410,0,80
20151111,75110,75110,73890,73890,73890,73890,73890,-1220,-1220,2,80
20151112,73890,73890,,,,73730,73730,-160,-160,0,80
20151113,73730,73730,,,,73730,73730,0,0,0,80
20151116,73730,73730,,,,73870,73870,140,140,0,80
20151117,73870,73870,72520,72520,71530,71530,72120,-2340,-1750,10,78
20151118,71530,72120,72620,72620,71040,71930,71660,-190,-460,118,66
20151119,71930,71660,70940,70940,70940,70940,70940,-720,-720,2,64
20151120,70940,70940,69560,69800,69560,69800,69720,-1140,-1220,6,66
20151123,69800,69720,,,,67030,67030,-2690,-2690,0,66
20151124,67030,67030,64310,67010,64310,66160,65500,-870,-1530,30,70
20151125,66160,65500,66720,68930,66530,68930,67820,3430,2320,38,72
20151126,68930,67820,70040,71880,70040,71570,71570,3750,3750,16,68
20151127,71570,71570,,,,71570,71570,0,0,0,68
20151130,71570,71570,68710,69780,68710,69780,69400,-1790,-2170,10,66
ni1605,20150518,106050,106050,106990,106990,105830,105830,106430,-220,380,6,4
20150519,105830,106430,,,,105110,105110,-1320,-1320,0,4
20150520,105110,105110,99860,99860,99860,99860,99860,-5250,-5250,2,6
20150521,99860,99860,99230,100620,99230,100620,99920,760,60,4,6
20150522,100620,99920,99560,99560,99120,99120,99310,-800,-610,10,16
20150525,99120,99310,,,,97650,97650,-1660,-1660,0,16
20150526,97650,97650,99960,99960,99960,99960,99960,2310,2310,2,18
20150527,99960,99960,,,,99960,99960,0,0,0,18
20150528,99960,99960,100430,100430,98720,98720,99570,-1240,-390,4,18
20150529,98720,99570,99110,101420,98850,98850,99630,-720,60,10,20
20150601,98850,99630,,,,99510,99510,-120,-120,0,20
20150602,99510,99510,99720,101530,98510,99870,99800,360,290,18,16
20150603,99870,99800,101300,101420,101090,101090,101290,1290,1490,10,20
20150604,101090,101290,98890,100630,98890,99100,99450,-2190,-1840,14,22
20150605,99100,99450,99110,99200,99110,99200,99150,-250,-300,4,24
20150608,99200,99150,99770,101000,99770,101000,100330,1850,1180,10,26
20150609,101000,100330,102940,103490,101860,102690,102870,2360,2540,20,32
20150610,102690,102870,102730,102730,101010,102160,101840,-710,-1030,18,28
20150611,102160,101840,102820,103140,102710,103140,102880,1300,1040,16,40
20150612,103140,102880,101690,101690,99400,99400,100450,-3480,-2430,34,40
20150615,99400,100450,99850,100360,98410,98950,99320,-1500,-1130,30,46
20150616,98950,99320,98930,98930,98220,98220,98530,-1100,-790,6,52
20150617,98220,98530,98590,98590,96510,96510,97230,-2020,-1300,20,56
20150618,96510,97230,97720,97870,97720,97870,97790,640,560,4,58
20150619,97870,97790,97850,98380,96710,96710,97600,-1080,-190,12,62
20150623,96710,97600,96180,98310,96180,96840,97060,-760,-540,88,78
20150624,96840,97060,100000,100000,96660,97740,97920,680,860,126,82
20150625,97740,97920,97320,97320,96710,96710,96980,-1210,-940,34,104
20150626,96710,96980,96180,96750,95000,95600,95730,-1380,-1250,54,130
20150629,95600,95730,95600,95600,92310,93100,94430,-2630,-1300,54,152
20150630,93100,94430,92000,92420,89700,89700,90520,-4730,-3910,110,198
20150701,89700,90520,89850,92300,89850,92010,91380,1490,860,74,190
20150702,92010,91380,91110,92420,90670,92420,91660,1040,280,44,184
20150703,92420,91660,92770,93130,91010,91010,92410,-650,750,16,172
20150706,91010,92410,91570,91570,87780,88540,89070,-3870,-3340,92,208
20150707,88540,89070,87900,90060,87000,87000,88210,-2070,-860,38,196
20150708,87000,88210,86360,86360,83790,83790,84750,-4420,-3460,24,198
20150709,83790,84750,80510,87500,80510,86370,83650,1620,-1100,154,210
20150710,86370,83650,85890,87830,85860,87000,86710,3350,3060,36,206
20150713,87000,86710,85720,86970,82650,83880,84720,-2830,-1990,90,226
20150714,83880,84720,85760,87990,85760,87040,87180,2320,2460,74,216
20150715,87040,87180,88930,88930,87770,88410,88110,1230,930,24,210
20150716,88410,88110,87000,87120,86410,87120,86750,-990,-1360,20,212
20150717,87120,86750,88770,89780,87400,87680,88130,930,1380,24,208
20150720,87680,88130,87010,92090,86400,87760,88350,-370,220,24,206
20150721,87760,88350,88610,88610,88460,88480,88500,130,150,12,208
20150722,88480,88500,89330,89330,86870,86870,88310,-1630,-190,10,214
20150723,86870,88310,85810,87680,85810,86950,86860,-1360,-1450,16,222
20150724,86950,86860,86900,86900,85310,85750,86250,-1110,-610,22,230
20150727,85750,86250,85350,87190,84020,85280,85500,-970,-750,28,230
20150728,85280,85500,,,,85500,85500,0,0,0,230
20150729,85500,85500,85560,86630,85560,86630,86140,1130,640,10,226
20150730,86630,86140,85510,85510,85510,85510,85510,-630,-630,2,226
20150731,85510,85510,85100,85100,85100,85100,85100,-410,-410,6,232
20150803,85100,85100,84610,84610,84610,84610,84610,-490,-490,6,234
20150804,84610,84610,80830,81300,80830,81300,81140,-3310,-3470,8,230
20150805,81300,81140,83550,83980,82650,83790,83040,2650,1900,30,208
20150806,83790,83040,83550,83550,82500,82700,82900,-340,-140,84,242
20150807,82700,82900,83220,83220,82000,82080,82420,-820,-480,16,238
20150810,82080,82420,,,,83680,83680,1260,1260,0,238
20150811,83680,83680,85170,86860,84750,84750,85250,1070,1570,14,246
20150812,84750,85250,83930,84600,82680,84600,83750,-650,-1500,32,236
20150813,84600,83750,85420,85480,84150,84660,84730,910,980,72,238
20150814,84660,84730,,,,84140,84140,-590,-590,0,238
20150817,84140,84140,,,,84140,84140,0,0,0,238
20150818,84140,84140,84670,84680,83980,84190,84480,50,340,12,238
20150819,84190,84480,82540,83350,82450,83350,82660,-1130,-1820,18,246
20150820,83350,82660,81720,82760,81670,82040,81900,-620,-760,24,254
20150821,82040,81900,83190,83190,81910,81910,82590,10,690,8,252
20150824,81910,82590,80920,80920,78460,78460,79240,-4130,-3350,124,290
20150825,78460,79240,76930,78610,75280,75900,76670,-3340,-2570,160,304
20150826,75900,76670,76790,77860,76370,76390,76850,-280,180,42,324
20150827,76390,76850,76620,77990,76530,77990,77200,1140,350,22,332
20150828,77990,77200,78390,80980,76960,80510,79560,3310,2360,116,334
20150831,80510,79560,79460,80590,78310,78530,79270,-1030,-290,118,382
20150901,78530,79270,77960,78300,77040,77040,77760,-2230,-1510,58,398
20150902,77040,77760,77710,78050,77130,77270,77750,-490,-10,92,420
20150907,77270,77750,78170,78350,78020,78250,78190,500,440,14,424
20150908,78250,78190,78000,78110,76810,76810,77800,-1380,-390,36,428
20150909,76810,77800,78280,80920,78250,79460,79340,1660,1540,162,422
20150910,79460,79340,79190,79810,78580,79730,78990,390,-350,90,460
20150911,79730,78990,80860,81740,80750,80900,81020,1910,2030,90,452
20150914,80900,81020,80540,81110,79120,80150,80160,-870,-860,186,554
20150915,80150,80160,79300,79320,78400,78400,79070,-1760,-1090,48,564
20150916,78400,79070,79650,80390,78490,80340,79910,1270,840,96,600
20150917,80340,79910,79900,81210,79010,79860,80300,-50,390,216,594
20150918,79860,80300,79790,79910,79510,79510,79720,-790,-580,78,630
20150921,79510,79720,78610,79280,77740,79230,78320,-490,-1400,322,836
20150922,79230,78320,79110,79480,78280,78390,78710,70,390,72,868
20150923,78390,78710,77930,79330,77410,77670,77690,-1040,-1020,272,918
20150924,77670,77690,78240,78450,77440,77510,77880,-180,190,200,1032
20150925,77510,77880,78290,78920,78220,78220,78620,340,740,122,1090
20150928,78220,78620,78450,78840,78090,78090,78640,-530,20,66,1114
20150929,78090,78640,78060,78300,76210,76420,77320,-2220,-1320,138,1136
20150930,76420,77320,76420,78190,76420,78190,77360,870,40,96,1154
20151008,78190,77360,80480,80480,78300,78450,78680,1090,1320,52,1154
20151009,78450,78680,78250,80410,78250,80350,79740,1670,1060,158,1122
20151012,80350,79740,81000,81500,80130,81210,80860,1470,1120,514,1048
20151013,81210,80860,80990,81040,79900,80500,80350,-360,-510,426,1096
20151014,80500,80350,80330,80750,79950,80230,80330,-120,-20,250,1072
20151015,80230,80330,80360,81450,80080,80970,80980,640,650,208,1054
20151016,80970,80980,80920,81630,80700,81050,81220,70,240,152,1014
20151019,81050,81220,81150,81530,80170,80380,80840,-840,-380,124,1024
20151020,80380,80840,80080,80460,78000,79600,79520,-1240,-1320,356,1166
20151021,79600,79520,79800,79800,79200,79260,79380,-260,-140,104,1180
20151022,79260,79380,79150,80200,78940,79770,79660,390,280,144,1176
20151023,79770,79660,79310,84380,79310,81020,80820,1360,1160,416,1320
20151026,81020,80820,81250,81260,79600,79870,80220,-950,-600,432,1240
20151027,79870,80220,79170,80820,79170,80220,79740,0,-480,174,1232
20151028,80220,79740,80270,80710,79740,80200,80150,460,410,90,1224
20151029,80200,80150,79870,80780,79840,80200,80280,50,130,108,1224
20151030,80200,80280,80190,80400,78240,79230,79040,-1050,-1240,1006,1430
20151102,79230,79040,78600,78600,77430,77550,78030,-1490,-1010,1234,2026
20151103,77550,78030,77760,78250,77180,77360,77800,-670,-230,1256,2604
20151104,77360,77800,77360,77650,76660,77490,77230,-310,-570,1602,3316
20151105,77490,77230,77250,77890,75700,75710,76720,-1520,-510,2764,4144
20151106,75710,76720,75700,76460,75480,75900,75870,-820,-850,3262,4822
20151109,75900,75870,75880,76010,74720,74880,75380,-990,-490,4074,6640
20151110,74880,75380,74980,75090,73390,74730,74200,-650,-1180,7874,9092
20151111,74730,74200,74360,74600,73670,73890,74050,-310,-150,10528,9572
20151112,73890,74050,73890,74570,73400,74200,74000,150,-50,9530,11908
20151113,74200,74000,73500,74640,73180,74220,74200,220,200,37422,28522
20151116,74220,74200,74040,74680,74000,74130,74230,-70,30,12626,32834
20151117,74130,74230,74310,74310,71720,72300,72920,-1930,-1310,27048,39334
20151118,72300,72920,72330,72760,71020,71860,71920,-1060,-1000,17868,43068
20151119,71860,71920,71710,71920,70090,70600,70860,-1320,-1060,26208,50750
20151120,70600,70860,70300,70840,69410,69840,70030,-1020,-830,37652,56402
20151123,69840,70030,70130,70200,65820,65820,67780,-4210,-2250,50146,61134
20151124,65820,67780,65510,66930,63730,66160,65550,-1620,-2230,97180,80404
20151125,66160,65550,65860,69480,65660,69480,68210,3930,2660,126464,90042
20151126,69480,68210,69100,73780,68520,71790,71230,3580,3020,183834,98516
20151127,71790,71230,71230,72950,70000,70380,71410,-850,180,194280,112352
20151130,70380,71410,69990,70090,68650,69910,69320,-1500,-2090,171766,128756
ni1606,20150616,99320,99320,,,,99320,99320,0,0,0,0
20150617,99320,99320,,,,99320,99320,0,0,0,0
20150618,99320,99320,,,,99320,99320,0,0,0,0
20150619,99320,99320,,,,99320,99320,0,0,0,0
20150623,99320,99320,,,,99320,99320,0,0,0,0
20150624,99320,99320,,,,99320,99320,0,0,0,0
20150625,99320,99320,,,,98370,98370,-950,-950,0,0
20150626,98370,98370,96000,96100,95190,95190,95710,-3180,-2660,22,12
20150629,95190,95710,95100,95110,92000,92000,93700,-3710,-2010,12,20
20150630,92000,93700,92220,92220,89010,89310,90100,-4390,-3600,24,26
20150701,89310,90100,90020,91990,90020,91080,91050,980,950,10,24
20150702,91080,91050,91690,91790,91690,91700,91730,650,680,10,22
20150703,91700,91730,93000,93000,93000,93000,93000,1270,1270,2,22
20150706,93000,93000,90890,90890,88350,88620,89570,-4380,-3430,28,22
20150707,88620,89570,87970,88430,87970,88430,88200,-1140,-1370,4,22
20150708,88430,88200,83800,85330,83790,85330,84100,-2870,-4100,10,32
20150709,85330,84100,80000,87980,80000,87980,84150,3880,50,18,24
20150710,87980,84150,,,,86960,86960,2810,2810,0,24
20150713,86960,86960,,,,84960,84960,-2000,-2000,0,24
20150714,84960,84960,86800,88690,86520,87230,87310,2270,2350,14,24
20150715,87230,87310,86100,90000,86100,90000,88050,2690,740,4,24
20150716,90000,88050,,,,88050,88050,0,0,0,24
20150717,88050,88050,,,,88050,88050,0,0,0,24
20150720,88050,88050,,,,88050,88050,0,0,0,24
20150721,88050,88050,,,,88200,88200,150,150,0,24
20150722,88200,88200,,,,88010,88010,-190,-190,0,24
20150723,88010,88010,,,,88010,88010,0,0,0,24
20150724,88010,88010,86030,86030,86030,86030,86030,-1980,-1980,2,24
20150727,86030,86030,,,,86030,86030,0,0,0,24
20150728,86030,86030,,,,86030,86030,0,0,0,24
20150729,86030,86030,87460,87460,87460,87460,87460,1430,1430,4,28
20150730,87460,87460,,,,87460,87460,0,0,0,28
20150731,87460,87460,86840,86840,86840,86840,86840,-620,-620,2,28
20150803,86840,86840,,,,86840,86840,0,0,0,28
20150804,86840,86840,85580,85580,82580,82580,84080,-4260,-2760,8,28
20150805,82580,84080,86240,86240,83170,83730,84320,-350,240,68,30
20150806,83730,84320,,,,84320,84320,0,0,0,30
20150807,84320,84320,83810,83810,83810,83810,83810,-510,-510,2,30
20150810,83810,83810,,,,85090,85090,1280,1280,0,30
20150811,85090,85090,88360,88360,84430,86500,86370,1410,1280,14,30
20150812,86500,86370,84330,84330,84330,84330,84330,-2040,-2040,4,26
20150813,84330,84330,86220,86220,83800,86050,84580,1720,250,30,40
20150814,86050,84580,86050,86050,83360,84420,84530,-160,-50,8,40
20150817,84420,84530,,,,84530,84530,0,0,0,40
20150818,84530,84530,,,,84870,84870,340,340,0,40
20150819,84870,84870,83210,84000,83210,83550,83800,-1320,-1070,24,32
20150820,83550,83800,83570,83570,83570,83570,83570,-230,-230,2,32
20150821,83570,83570,,,,83570,83570,0,0,0,32
20150824,83570,83570,79580,79800,79580,79800,79630,-3770,-3940,8,40
20150825,79800,79630,76050,76950,76000,76000,76340,-3630,-3290,12,34
20150826,76000,76340,79780,79780,77580,77710,78340,1370,2000,14,36
20150827,77710,78340,,,,78340,78340,0,0,0,36
20150828,78340,78340,79940,79940,79560,79560,79680,1220,1340,6,32
20150831,79560,79680,,,,79680,79680,0,0,0,32
20150901,79680,79680,,,,78160,78160,-1520,-1520,0,32
20150902,78160,78160,,,,78160,78160,0,0,0,32
20150907,78160,78160,,,,78160,78160,0,0,0,32
20150908,78160,78160,,,,77770,77770,-390,-390,0,32
20150909,77770,77770,,,,79310,79310,1540,1540,0,32
20150910,79310,79310,,,,79310,79310,0,0,0,32
20150911,79310,79310,81100,82830,81100,82200,81830,2890,2520,10,32
20150914,82200,81830,81510,81510,81510,81510,81510,-320,-320,2,30
20150915,81510,81510,,,,80400,80400,-1110,-1110,0,30
20150916,80400,80400,,,,81260,81260,860,860,0,30
20150917,81260,81260,82330,82330,79990,80550,81130,-710,-130,126,30
20150918,80550,81130,80160,80160,80160,80160,80160,-970,-970,2,30
20150921,80160,80160,,,,80160,80160,0,0,0,30
20150922,80160,80160,78310,79600,78310,79160,79020,-1000,-1140,6,32
20150923,79160,79020,77930,78630,76460,78190,77940,-830,-1080,28,40
20150924,78190,77940,78960,80440,78690,78690,80100,750,2160,22,42
20150925,78690,80100,78570,79320,78470,79320,78690,-780,-1410,16,40
20150928,79320,78690,,,,78690,78690,0,0,0,40
20150929,78690,78690,78860,78860,78200,78200,78640,-490,-50,6,34
20150930,78200,78640,78150,78520,78050,78520,78240,-120,-400,6,34
20151008,78520,78240,,,,78450,78450,210,210,0,34
20151009,78450,78450,81000,81000,81000,81000,81000,2550,2550,2,32
20151012,81000,81000,81810,81950,81810,81950,81870,950,870,6,32
20151013,81950,81870,,,,81870,81870,0,0,0,32
20151014,81870,81870,81110,81230,81110,81230,81170,-640,-700,4,34
20151015,81230,81170,,,,81170,81170,0,0,0,34
20151016,81170,81170,,,,81170,81170,0,0,0,34
20151019,81170,81170,82340,82340,79800,81010,80400,-160,-770,28,56
20151020,81010,80400,80090,80090,79730,79730,79850,-670,-550,6,54
20151021,79730,79850,,,,79850,79850,0,0,0,54
20151022,79850,79850,,,,79850,79850,0,0,0,54
20151023,79850,79850,80000,80000,80000,80000,80000,150,150,4,50
20151026,80000,80000,,,,80000,80000,0,0,0,50
20151027,80000,80000,,,,80000,80000,0,0,0,50
20151028,80000,80000,,,,80000,80000,0,0,0,50
20151029,80000,80000,80420,80420,80190,80190,80300,190,300,4,48
20151030,80190,80300,79200,79200,79200,79200,79200,-1100,-1100,4,44
20151102,79200,79200,,,,79200,79200,0,0,0,44
20151103,79200,79200,78350,79400,78350,79400,78900,200,-300,18,36
20151104,79400,78900,78060,78060,77580,77580,77700,-1320,-1200,8,38
20151105,77580,77700,77090,79460,76580,77560,77590,-140,-110,20,42
20151106,77560,77590,,,,77590,77590,0,0,0,42
20151109,77590,77590,,,,77080,77080,-510,-510,0,42
20151110,77080,77080,,,,75870,75870,-1210,-1210,0,42
20151111,75870,75870,74860,74860,74860,74860,74860,-1010,-1010,2,42
20151112,74860,74860,,,,74810,74810,-50,-50,0,42
20151113,74810,74810,73670,79280,72860,74440,74710,-370,-100,104,96
20151116,74440,74710,74560,74570,74530,74530,74550,-180,-160,8,92
20151117,74530,74550,74510,74800,74510,74800,74610,250,60,6,92
20151118,74800,74610,72750,73410,71860,71860,72800,-2750,-1810,48,98
20151119,71860,72800,70650,70650,70650,70650,70650,-2150,-2150,2,98
20151120,70650,70650,70650,70650,70650,70650,70650,0,0,2,100
20151123,70650,70650,,,,68380,68380,-2270,-2270,0,100
20151124,68380,68380,66740,66850,66740,66850,66790,-1530,-1590,8,104
20151125,66850,66790,69630,69630,69630,69630,69630,2840,2840,4,104
20151126,69630,69630,72070,73460,71690,72080,72300,2450,2670,14,106
20151127,72080,72300,70970,72280,70450,70510,71110,-1790,-1190,54,98
20151130,70510,71110,69550,69550,69550,69550,69550,-1560,-1560,4,96
ni1607,20150716,88050,88050,85630,89530,85630,89530,87580,1480,-470,4,2
20150717,89530,87580,,,,87580,87580,0,0,0,2
20150720,87580,87580,,,,87800,87800,220,220,0,2
20150721,87800,87800,89560,89560,86920,86920,88210,-880,410,12,8
20150722,86920,88210,89030,91040,89030,91040,90030,2830,1820,4,8
20150723,91040,90030,,,,90030,90030,0,0,0,8
20150724,90030,90030,,,,88000,88000,-2030,-2030,0,8
20150727,88000,88000,,,,87230,87230,-770,-770,0,8
20150728,87230,87230,86940,86940,86940,86940,86940,-290,-290,2,10
20150729,86940,86940,86260,86260,86260,86260,86260,-680,-680,2,8
20150730,86260,86260,,,,85620,85620,-640,-640,0,8
20150731,85620,85620,,,,85010,85010,-610,-610,0,8
20150803,85010,85010,,,,84520,84520,-490,-490,0,8
20150804,84520,84520,,,,81830,81830,-2690,-2690,0,8
20150805,81830,81830,83120,85710,83120,85710,83550,3880,1720,24,14
20150806,85710,83550,85010,85010,85010,85010,85010,1460,1460,12,4
20150807,85010,85010,,,,84490,84490,-520,-520,0,4
20150810,84490,84490,,,,85780,85780,1290,1290,0,4
20150811,85780,85780,,,,87070,87070,1290,1290,0,4
20150812,87070,87070,,,,85010,85010,-2060,-2060,0,4
20150813,85010,85010,86590,86590,85480,85480,86030,470,1020,4,4
20150814,85480,86030,,,,85980,85980,-50,-50,0,4
20150817,85980,85980,,,,87180,87180,1200,1200,0,4
20150818,87180,87180,,,,87530,87530,350,350,0,4
20150819,87530,87530,,,,86420,86420,-1110,-1110,0,4
20150820,86420,86420,,,,86180,86180,-240,-240,0,4
20150821,86180,86180,,,,86910,86910,730,730,0,4
20150824,86910,86910,,,,82810,82810,-4100,-4100,0,4
20150825,82810,82810,,,,79390,79390,-3420,-3420,0,4
20150826,79390,79390,,,,81470,81470,2080,2080,0,4
20150827,81470,81470,,,,81840,81840,370,370,0,4
20150828,81840,81840,,,,83240,83240,1400,1400,0,4
20150831,83240,83240,,,,82940,82940,-300,-300,0,4
20150901,82940,82940,,,,81360,81360,-1580,-1580,0,4
20150902,81360,81360,,,,79540,79540,-1820,-1820,0,4
20150907,79540,79540,,,,79990,79990,450,450,0,4
20150908,79990,79990,,,,79600,79600,-390,-390,0,4
20150909,79600,79600,,,,81180,81180,1580,1580,0,4
20150910,81180,81180,,,,80820,80820,-360,-360,0,4
20150911,80820,80820,,,,83390,83390,2570,2570,0,4
20150914,83390,83390,80180,81570,80180,81570,80870,-1820,-2520,4,6
20150915,81570,80870,,,,79770,79770,-1100,-1100,0,6
20150916,79770,79770,,,,80620,80620,850,850,0,6
20150917,80620,80620,,,,80490,80490,-130,-130,0,6
20150918,80490,80490,79570,80710,79570,80710,80140,220,-350,8,4
20150921,80710,80140,,,,78740,78740,-1400,-1400,0,4
20150922,78740,78740,,,,77620,77620,-1120,-1120,0,4
20150923,77620,77620,79220,79220,77330,77330,78270,-290,650,8,6
20150924,77330,78270,78760,78760,78760,78760,78760,490,490,2,6
20150925,78760,78760,,,,77370,77370,-1390,-1390,0,6
20150928,77370,77370,,,,77390,77390,20,20,0,6
20150929,77390,77390,78770,78770,78770,78770,78770,1380,1380,2,6
20150930,78770,78770,,,,78360,78360,-410,-410,0,6
20151008,78360,78360,,,,79700,79700,1340,1340,0,6
20151009,79700,79700,80230,80230,80230,80230,80230,530,530,4,6
20151012,80230,80230,,,,81090,81090,860,860,0,6
20151013,81090,81090,,,,80570,80570,-520,-520,0,6
20151014,80570,80570,,,,79880,79880,-690,-690,0,6
20151015,79880,79880,,,,80530,80530,650,650,0,6
20151016,80530,80530,81850,82210,81850,82210,82090,1680,1560,6,10
20151019,82210,82090,,,,81310,81310,-780,-780,0,10
20151020,81310,81310,,,,80750,80750,-560,-560,0,10
20151021,80750,80750,,,,80610,80610,-140,-140,0,10
20151022,80610,80610,,,,80890,80890,280,280,0,10
20151023,80890,80890,,,,81040,81040,150,150,0,10
20151026,81040,81040,,,,80430,80430,-610,-610,0,10
20151027,80430,80430,,,,79950,79950,-480,-480,0,10
20151028,79950,79950,,,,80360,80360,410,410,0,10
20151029,80360,80360,,,,80660,80660,300,300,0,10
20151030,80660,80660,,,,79550,79550,-1110,-1110,0,10
20151102,79550,79550,,,,78530,78530,-1020,-1020,0,10
20151103,78530,78530,,,,78230,78230,-300,-300,0,10
20151104,78230,78230,,,,77040,77040,-1190,-1190,0,10
20151105,77040,77040,,,,76930,76930,-110,-110,0,10
20151106,76930,76930,,,,76080,76080,-850,-850,0,10
20151109,76080,76080,,,,75580,75580,-500,-500,0,10
20151110,75580,75580,,,,74400,74400,-1180,-1180,0,10
20151111,74400,74400,,,,73400,73400,-1000,-1000,0,10
20151112,73400,73400,,,,73350,73350,-50,-50,0,10
20151113,73350,73350,,,,73250,73250,-100,-100,0,10
20151116,73250,73250,75260,75260,73770,73770,74510,520,1260,4,12
20151117,73770,74510,,,,74560,74560,50,50,0,12
20151118,74560,74560,,,,72750,72750,-1810,-1810,0,12
20151119,72750,72750,,,,70600,70600,-2150,-2150,0,12
20151120,70600,70600,,,,70600,70600,0,0,0,12
20151123,70600,70600,,,,68330,68330,-2270,-2270,0,12
20151124,68330,68330,,,,66740,66740,-1590,-1590,0,12
20151125,66740,66740,70280,70280,70280,70280,70280,3540,3540,2,12
20151126,70280,70280,72060,72060,72060,72060,72060,1780,1780,2,12
20151127,72060,72060,,,,70880,70880,-1180,-1180,0,12
20151130,70880,70880,,,,69320,69320,-1560,-1560,0,12
ni1608,20150818,87180,87180,,,,87180,87180,0,0,0,0
20150819,87180,87180,,,,87180,87180,0,0,0,0
20150820,87180,87180,,,,86940,86940,-240,-240,0,0
20150821,86940,86940,81660,85480,81660,85290,83530,-1650,-3410,8,4
20150824,85290,83530,,,,83530,83530,0,0,0,4
20150825,83530,83530,,,,80080,80080,-3450,-3450,0,4
20150826,80080,80080,76610,78080,76610,78080,77370,-2000,-2710,8,4
20150827,78080,77370,78270,78270,78270,78270,78270,900,900,2,2
20150828,78270,78270,,,,79610,79610,1340,1340,0,2
20150831,79610,79610,,,,79320,79320,-290,-290,0,2
20150901,79320,79320,,,,77810,77810,-1510,-1510,0,2
20150902,77810,77810,,,,77810,77810,0,0,0,2
20150907,77810,77810,,,,78250,78250,440,440,0,2
20150908,78250,78250,,,,77860,77860,-390,-390,0,2
20150909,77860,77860,,,,79400,79400,1540,1540,0,2
20150910,79400,79400,,,,79050,79050,-350,-350,0,2
20150911,79050,79050,,,,81560,81560,2510,2510,0,2
20150914,81560,81560,,,,79100,79100,-2460,-2460,0,2
20150915,79100,79100,,,,78020,78020,-1080,-1080,0,2
20150916,78020,78020,,,,78850,78850,830,830,0,2
20150917,78850,78850,,,,78720,78720,-130,-130,0,2
20150918,78720,78720,79480,80920,79480,80920,80200,2200,1480,4,2
20150921,80920,80200,,,,78800,78800,-1400,-1400,0,2
20150922,78800,78800,,,,77680,77680,-1120,-1120,0,2
20150923,77680,77680,,,,78330,78330,650,650,0,2
20150924,78330,78330,,,,78820,78820,490,490,0,2
20150925,78820,78820,,,,77430,77430,-1390,-1390,0,2
20150928,77430,77430,,,,77450,77450,20,20,0,2
20150929,77450,77450,,,,78830,78830,1380,1380,0,2
20150930,78830,78830,,,,78420,78420,-410,-410,0,2
20151008,78420,78420,,,,79760,79760,1340,1340,0,2
20151009,79760,79760,80480,80480,80480,80480,80480,720,720,4,6
20151012,80480,80480,,,,81340,81340,860,860,0,6
20151013,81340,81340,,,,80820,80820,-520,-520,0,6
20151014,80820,80820,,,,80120,80120,-700,-700,0,6
20151015,80120,80120,82630,82630,82630,82630,82630,2510,2510,2,8
20151016,82630,82630,82500,82500,82500,82500,82500,-130,-130,2,8
20151019,82500,82500,81420,81420,81220,81220,81370,-1280,-1130,8,14
20151020,81220,81370,,,,80810,80810,-560,-560,0,14
20151021,80810,80810,81670,81680,78480,79200,80080,-1610,-730,56,18
20151022,79200,80080,79620,80990,79600,80990,80020,910,-60,20,32
20151023,80990,80020,80510,80840,80510,80670,80670,650,650,20,28
20151026,80670,80670,81050,81270,81010,81010,81070,340,400,12,28
20151027,81010,81070,80960,80960,80900,80900,80930,-170,-140,8,34
20151028,80900,80930,,,,80930,80930,0,0,0,34
20151029,80930,80930,,,,80930,80930,0,0,0,34
20151030,80930,80930,,,,79820,79820,-1110,-1110,0,34
20151102,79820,79820,,,,78800,78800,-1020,-1020,0,34
20151103,78800,78800,78560,78560,78560,78560,78560,-240,-240,2,34
20151104,78560,78560,,,,77360,77360,-1200,-1200,0,34
20151105,77360,77360,78510,78560,78190,78560,78360,1200,1000,8,40
20151106,78560,78360,77240,78400,77240,78130,78110,-230,-250,32,56
20151109,78130,78110,76820,76820,76820,76820,76820,-1290,-1290,4,56
20151110,76820,76820,75800,75800,74880,74880,75260,-1940,-1560,6,58
20151111,74880,75260,75330,75390,75330,75390,75340,130,80,12,58
20151112,75390,75340,,,,75290,75290,-50,-50,0,58
20151113,75290,75290,,,,75180,75180,-110,-110,0,58
20151116,75180,75180,,,,76470,76470,1290,1290,0,58
20151117,76470,76470,74390,74390,74370,74380,74380,-2090,-2090,22,60
20151118,74380,74380,,,,72570,72570,-1810,-1810,0,60
20151119,72570,72570,71940,71940,71290,71290,71620,-1280,-950,10,62
20151120,71290,71620,,,,71620,71620,0,0,0,62
20151123,71620,71620,68020,68210,67650,68210,67950,-3410,-3670,12,56
20151124,68210,67950,65770,65790,65770,65770,65770,-2180,-2180,8,52
20151125,65770,65770,68960,69710,68960,69710,69290,3940,3520,14,48
20151126,69710,69290,69420,72510,69420,72010,71360,2720,2070,18,44
20151127,72010,71360,71850,71850,71850,71850,71850,490,490,2,44
20151130,71850,71850,70310,70310,70310,70310,70310,-1540,-1540,2,42
ni1609,20150916,78020,78020,79760,82510,79660,82510,80400,4490,2380,8,6
20150917,82510,80400,79430,81610,79430,81610,80880,1210,480,6,6
20150918,81610,80880,82510,82510,82510,82510,82510,1630,1630,2,8
20150921,82510,82510,79720,81810,79720,81810,80760,-700,-1750,4,12
20150922,81810,80760,80790,80790,80790,80790,80790,30,30,2,14
20150923,80790,80790,79200,81140,79070,79400,79700,-1390,-1090,8,12
20150924,79400,79700,,,,79500,79500,-200,-200,0,12
20150925,79500,79500,80140,80280,80140,80180,80220,680,720,8,18
20150928,80180,80220,,,,80220,80220,0,0,0,18
20150929,80220,80220,,,,80220,80220,0,0,0,18
20150930,80220,80220,,,,80220,80220,0,0,0,18
20151008,80220,80220,,,,81590,81590,1370,1370,0,18
20151009,81590,81590,79370,81680,79370,81500,80850,-90,-740,94,76
20151012,81500,80850,80830,82150,80330,82150,81730,1300,880,26,94
20151013,82150,81730,81910,81910,81330,81470,81620,-260,-110,10,94
20151014,81470,81620,81310,81310,80730,80730,80780,-890,-840,20,90
20151015,80730,80780,81640,81640,81640,81640,81640,860,860,4,94
20151016,81640,81640,81560,82410,80600,82120,81610,480,-30,120,92
20151019,82120,81610,82300,82300,80970,80970,81440,-640,-170,28,92
20151020,80970,81440,79960,80030,79730,79730,79900,-1710,-1540,6,92
20151021,79730,79900,,,,79900,79900,0,0,0,92
20151022,79900,79900,,,,79900,79900,0,0,0,92
20151023,79900,79900,,,,79900,79900,0,0,0,92
20151026,79900,79900,,,,79900,79900,0,0,0,92
20151027,79900,79900,80710,81010,80710,80960,80890,1060,990,6,96
20151028,80960,80890,81000,81760,80330,81760,80900,870,10,28,106
20151029,81760,80900,80780,80780,80780,80780,80780,-120,-120,2,106
20151030,80780,80780,80010,80020,80010,80010,80010,-770,-770,42,130
20151102,80010,80010,,,,80010,80010,0,0,0,130
20151103,80010,80010,,,,79760,79760,-250,-250,0,130
20151104,79760,79760,,,,78540,78540,-1220,-1220,0,130
20151105,78540,78540,77830,77830,77480,77480,77620,-1060,-920,16,142
20151106,77480,77620,77480,77640,77480,77640,77510,20,-110,26,156
20151109,77640,77510,77520,77520,76220,76660,76910,-850,-600,46,176
20151110,76660,76910,76950,76950,74620,75340,75390,-1570,-1520,32,190
20151111,75340,75390,,,,75470,75470,80,80,0,190
20151112,75470,75470,75870,76380,75410,76240,75750,770,280,40,198
20151113,76240,75750,75520,77020,75400,75730,75790,-20,40,26,206
20151116,75730,75790,75490,75660,75350,75350,75550,-440,-240,16,206
20151117,75350,75550,75510,75510,72940,73650,74060,-1900,-1490,48,226
20151118,73650,74060,73680,74000,72300,72440,73080,-1620,-980,50,246
20151119,72440,73080,72670,72680,70930,71430,71120,-1650,-1960,262,456
20151120,71430,71120,71230,71770,70720,70920,71240,-200,120,376,384
20151123,70920,71240,70780,70790,66960,66960,68210,-4280,-3030,212,474
20151124,66960,68210,66130,67610,65680,67550,66340,-660,-1870,326,518
20151125,67550,66340,66810,70320,66400,70300,69280,3960,2940,468,560
20151126,70300,69280,70030,73430,69590,72850,71920,3570,2640,714,586
20151127,72850,71920,73410,73980,71290,71290,72760,-630,840,110,600
20151130,71290,72760,70500,71940,68940,70980,70800,-1780,-1960,206,662
ni1610,20151016,81640,81640,84200,84200,79980,79980,82090,-1660,450,12,6
20151019,79980,82090,,,,81920,81920,-170,-170,0,6
20151020,81920,81920,80670,80670,80670,80670,80670,-1250,-1250,2,6
20151021,80670,80670,,,,79940,79940,-730,-730,0,6
20151022,79940,79940,,,,79880,79880,-60,-60,0,6
20151023,79880,79880,,,,80520,80520,640,640,0,6
20151026,80520,80520,,,,80920,80920,400,400,0,6
20151027,80920,80920,,,,81920,81920,1000,1000,0,6
20151028,81920,81920,,,,81930,81930,10,10,0,6
20151029,81930,81930,,,,81930,81930,0,0,0,6
20151030,81930,81930,80540,80540,79540,79940,80160,-1990,-1770,10,12
20151102,79940,80160,80020,80020,79000,79000,79550,-1160,-610,24,24
20151103,79000,79550,78360,78910,78360,78910,78540,-640,-1010,6,20
20151104,78910,78540,,,,77340,77340,-1200,-1200,0,20
20151105,77340,77340,78110,78110,78110,78110,78110,770,770,2,22
20151106,78110,78110,76340,77970,76190,77970,76890,-140,-1220,20,20
20151109,77970,76890,,,,76300,76300,-590,-590,0,20
20151110,76300,76300,76090,76090,75640,75640,75860,-660,-440,4,20
20151111,75640,75860,,,,75940,75940,80,80,0,20
20151112,75940,75940,,,,76230,76230,290,290,0,20
20151113,76230,76230,,,,76270,76270,40,40,0,20
20151116,76270,76270,,,,76030,76030,-240,-240,0,20
20151117,76030,76030,74000,74000,73910,73910,73990,-2120,-2040,66,86
20151118,73910,73990,,,,73010,73010,-980,-980,0,86
20151119,73010,73010,72350,72350,72350,72350,72350,-660,-660,2,86
20151120,72350,72350,72730,72730,72730,72730,72730,380,380,4,90
20151123,72730,72730,69000,70030,68980,68980,69620,-3750,-3110,18,100
20151124,68980,69620,66150,67280,66150,66900,66710,-2720,-2910,14,94
20151125,66900,66710,70710,70710,70700,70710,70700,4000,3990,10,94
20151126,70710,70700,70420,74940,70300,73510,72630,2810,1930,40,86
20151127,73510,72630,71500,74070,68270,72450,72110,-180,-520,34,86
20151130,72450,72110,,,,70170,70170,-1940,-1940,0,86
ni1611,20151117,76030,76030,,,,76030,76030,0,0,0,0
20151118,76030,76030,,,,75020,75020,-1010,-1010,0,0
20151119,75020,75020,,,,74340,74340,-680,-680,0,0
20151120,74340,74340,,,,74730,74730,390,390,0,0
20151123,74730,74730,68000,68000,65760,65760,66880,-8970,-7850,16,12
20151124,65760,66880,,,,64080,64080,-2800,-2800,0,12
20151125,64080,64080,,,,67920,67920,3840,3840,0,12
20151126,67920,67920,,,,71990,71990,4070,4070,0,12
20151127,71990,71990,,,,71480,71480,-510,-510,0,12
20151130,71480,71480,71670,72030,71060,71060,71480,-420,0,18,14
pb1501,20150105,12070,12300,12375,12375,12275,12315,12295,15,-5,1070,4790
20150106,12315,12295,12205,12320,12180,12320,12250,25,-45,830,4220
20150107,12320,12250,12270,12350,12270,12340,12315,90,65,470,4130
20150108,12340,12315,12280,12330,12280,12310,12310,-5,-5,430,4120
20150109,12310,12310,12310,12360,12310,12360,12340,50,30,540,4080
20150112,12360,12340,12295,12310,12215,12215,12285,-125,-55,360,3920
20150113,12215,12285,12250,12250,12200,12200,12220,-85,-65,380,3550
20150114,12200,12220,12000,12010,11850,11850,11945,-370,-275,930,2860
20150115,11850,11945,11970,12120,11970,12105,12055,160,110,440,2850
pb1502,20150105,12380,12375,12330,12500,12315,12395,12385,20,10,4384,14744
20150106,12395,12385,12205,12600,12115,12395,12285,10,-100,5534,13340
20150107,12395,12285,12390,12465,12305,12385,12390,100,105,4278,11324
20150108,12385,12390,12365,12460,12340,12405,12395,15,5,2630,10368
20150109,12405,12395,12505,12535,12370,12415,12425,20,30,1734,9880
20150112,12415,12425,12350,12450,12175,12325,12360,-100,-65,1430,9128
20150113,12325,12360,12170,12305,12170,12185,12250,-175,-110,1534,8652
20150114,12185,12250,12175,12175,11830,11850,11960,-400,-290,3808,6700
20150115,11850,11960,11860,12185,11860,12170,12090,210,130,1124,6242
20150116,12170,12090,12265,12475,12210,12220,12335,130,245,1414,5660
20150119,12220,12335,12280,12560,12280,12475,12430,140,95,690,5246
20150120,12475,12430,12480,12490,12390,12460,12435,30,5,808,4594
20150121,12460,12435,12540,12570,12485,12540,12520,105,85,716,3992
20150122,12540,12520,12480,12740,12480,12645,12625,125,105,228,3810
20150123,12645,12625,12630,12630,12470,12485,12505,-140,-120,552,3362
20150126,12485,12505,12475,12475,12400,12470,12430,-35,-75,312,3194
20150127,12470,12430,12600,12645,12465,12540,12565,110,135,206,3092
20150128,12540,12565,12510,12550,12500,12550,12525,-15,-40,482,2990
20150129,12550,12525,12595,12655,12460,12590,12595,65,70,660,3018
20150130,12590,12595,12535,12560,12480,12490,12510,-105,-85,272,2790
20150202,12490,12510,12600,12605,12580,12600,12590,90,80,450,2740
20150203,12600,12590,12620,12670,12620,12670,12635,80,45,360,2590
20150204,12670,12635,12670,12670,12550,12615,12590,-20,-45,300,2350
20150205,12615,12590,12580,12580,12560,12560,12570,-30,-20,190,2350
20150206,12560,12570,12595,12620,12595,12620,12605,50,35,160,2330
20150209,12620,12605,12590,12600,12580,12600,12595,-5,-10,100,2360
20150210,12600,12595,12600,12600,12575,12575,12595,-20,0,50,2370
pb1503,20150105,12420,12410,12410,12535,12350,12405,12400,-5,-10,4856,18958
20150106,12405,12400,12290,12450,12140,12410,12295,10,-105,11062,20230
20150107,12410,12295,12395,12485,12305,12380,12410,85,115,11656,22438
20150108,12380,12410,12380,12475,12330,12400,12395,-10,-15,8806,23146
20150109,12400,12395,12455,12520,12350,12400,12420,5,25,6522,24212
20150112,12400,12420,12350,12455,12295,12335,12350,-85,-70,13684,24430
20150113,12335,12350,12200,12320,12160,12170,12245,-180,-105,12092,25580
20150114,12170,12245,12000,12145,11770,11770,11955,-475,-290,27796,27450
20150115,11770,11955,11830,12170,11810,12140,12005,185,50,23288,24920
20150116,12140,12005,12200,12395,12145,12175,12265,170,260,20170,21698
20150119,12175,12265,12170,12500,12155,12500,12380,235,115,14680,20624
20150120,12500,12380,12400,12480,12345,12425,12405,45,25,10686,19264
20150121,12425,12405,12555,12555,12445,12515,12495,110,90,8622,18568
20150122,12515,12495,12445,12695,12445,12615,12600,120,105,9198,17216
20150123,12615,12600,12630,12660,12410,12500,12525,-100,-75,8488,16690
20150126,12500,12525,12455,12495,12355,12460,12410,-65,-115,8034,16038
20150127,12460,12410,12510,12580,12485,12485,12535,75,125,5816,14378
20150128,12485,12535,12460,12565,12445,12560,12500,25,-35,4306,13344
20150129,12560,12500,12555,12595,12500,12515,12535,15,35,3230,12860
20150130,12515,12535,12470,12530,12390,12415,12465,-120,-70,5236,11662
20150202,12415,12465,12475,12585,12435,12565,12525,100,60,3704,10088
20150203,12565,12525,12555,12620,12510,12585,12565,60,40,2630,8926
20150204,12585,12565,12150,12665,12150,12540,12600,-25,35,1930,8014
20150205,12540,12600,12570,12630,12545,12565,12575,-35,-25,1502,7420
20150206,12565,12575,12600,12645,12595,12640,12620,65,45,1708,6596
20150209,12640,12620,12630,12655,12570,12570,12590,-50,-30,820,6130
20150210,12570,12590,12580,12625,12575,12575,12585,-15,-5,576,5888
20150211,12575,12585,12550,12575,12420,12495,12490,-90,-95,924,5380
20150212,12495,12490,12495,12495,12310,12370,12355,-120,-135,826,4994
20150213,12370,12355,12455,12635,12420,12635,12550,280,195,574,4788
20150216,12635,12550,12560,12570,12540,12570,12550,20,0,254,4630
20150217,12570,12550,12540,12575,12510,12555,12540,5,-10,478,4390
20150225,12555,12540,12325,12370,12320,12325,12330,-215,-210,746,4284
20150226,12325,12330,12320,12320,12180,12295,12275,-35,-55,1534,3352
20150227,12295,12275,12310,12310,12100,12200,12280,-75,5,698,2760
20150302,12200,12280,12235,12235,12100,12180,12160,-100,-120,670,2360
20150303,12180,12160,12165,12180,12150,12170,12170,10,10,400,1970
20150304,12170,12170,12185,12250,12170,12250,12195,80,25,650,1460
20150305,12250,12195,12230,12240,12220,12220,12235,25,40,180,1380
20150306,12220,12235,12250,12285,12245,12285,12260,50,25,270,1170
20150309,12285,12260,12315,12315,12300,12300,12305,40,45,190,1000
20150310,12300,12305,12340,12360,12300,12325,12330,20,25,640,880
20150311,12325,12330,12260,12290,12245,12290,12255,-40,-75,220,820
20150312,12290,12255,12300,12300,12300,12300,12300,45,45,40,820
20150313,12300,12300,12400,12400,12400,12400,12400,100,100,110,780
20150316,12400,12400,12200,12200,12200,12200,12200,-200,-200,10,780
pb1504,20150105,12445,12450,12460,12550,12405,12450,12430,0,-20,1078,3470
20150106,12450,12430,12275,12435,12175,12425,12320,-5,-110,966,3816
20150107,12425,12320,12440,12510,12335,12400,12440,80,120,778,3966
20150108,12400,12440,12450,12495,12370,12435,12420,-5,-20,728,4398
20150109,12435,12420,12500,12530,12385,12430,12440,10,20,974,4558
20150112,12430,12440,12350,12470,12330,12370,12375,-70,-65,1008,4972
20150113,12370,12375,12300,12345,12185,12190,12265,-185,-110,2150,5978
20150114,12190,12265,12020,12150,11800,11800,11985,-465,-280,4850,6788
20150115,11800,11985,11840,12255,11840,12145,12035,160,50,2462,7044
20150116,12145,12035,12250,12375,12160,12180,12265,145,230,3288,7488
20150119,12180,12265,12165,12495,12165,12485,12370,220,105,2870,7502
20150120,12485,12370,12405,12465,12345,12415,12400,45,30,1960,7906
20150121,12415,12400,12520,12540,12435,12510,12485,110,85,2692,7960
20150122,12510,12485,12470,12690,12450,12595,12595,110,110,2334,8108
20150123,12595,12595,12605,12640,12300,12470,12475,-125,-120,3704,8614
20150126,12470,12475,12450,12450,12320,12400,12365,-75,-110,3280,9474
20150127,12400,12365,12470,12515,12425,12445,12480,80,115,3192,10570
20150128,12445,12480,12430,12500,12425,12500,12455,20,-25,2066,11598
20150129,12500,12455,12505,12520,12450,12455,12475,0,20,1296,11916
20150130,12455,12475,12405,12460,12335,12350,12405,-125,-70,2224,12806
20150202,12350,12405,12410,12500,12380,12490,12465,85,60,2680,13338
20150203,12490,12465,12485,12550,12435,12515,12500,50,35,3666,14372
20150204,12515,12500,12535,12620,12475,12480,12545,-20,45,4674,15212
20150205,12480,12545,12520,12580,12485,12505,12520,-40,-25,2978,15758
20150206,12505,12520,12510,12590,12505,12575,12555,55,35,3282,16506
20150209,12575,12555,12580,12625,12510,12515,12540,-40,-15,3282,16706
20150210,12515,12540,12550,12570,12510,12520,12530,-20,-10,1662,16510
20150211,12520,12530,12500,12510,12370,12435,12425,-95,-105,4080,16768
20150212,12435,12425,12435,12450,12225,12310,12305,-115,-120,9564,17454
20150213,12310,12305,12370,12580,12355,12570,12465,265,160,6130,15630
20150216,12570,12465,12575,12605,12475,12525,12510,60,45,1702,15252
20150217,12525,12510,12520,12625,12475,12510,12520,0,10,1634,14864
20150225,12510,12520,12195,12340,12195,12290,12305,-230,-215,2286,15042
20150226,12290,12305,12285,12285,12220,12260,12255,-45,-50,4182,15554
20150227,12260,12255,12275,12320,12225,12245,12260,-10,5,2236,15172
20150302,12245,12260,12215,12230,12090,12200,12150,-60,-110,3966,14198
20150303,12200,12150,12155,12205,12150,12165,12170,15,20,2258,12990
20150304,12165,12170,12150,12255,12150,12240,12195,70,25,2720,11918
20150305,12240,12195,12240,12305,12200,12240,12245,45,50,1690,11176
20150306,12240,12245,12255,12300,12250,12295,12280,50,35,2290,10144
20150309,12295,12280,12300,12320,12210,12305,12300,25,20,1978,9202
20150310,12305,12300,12300,12370,12290,12320,12345,20,45,2630,8224
20150311,12320,12345,12275,12315,12215,12275,12290,-70,-55,1736,7432
20150312,12275,12290,12300,12400,12300,12400,12325,110,35,492,7142
20150313,12400,12325,12430,12615,12345,12365,12370,40,45,788,6594
20150316,12365,12370,12305,12330,12200,12300,12270,-70,-100,670,6272
20150317,12300,12270,12290,12300,12185,12185,12220,-85,-50,546,6042
20150318,12185,12220,12150,12185,12090,12090,12140,-130,-80,710,5606
20150319,12090,12140,12085,12170,12065,12165,12115,25,-25,488,5374
20150320,12165,12115,12085,12170,12085,12130,12120,15,5,982,4576
20150323,12130,12120,12195,12370,12195,12325,12310,205,190,764,4038
20150324,12325,12310,12410,12515,12405,12495,12445,185,135,1034,3688
20150325,12495,12445,12515,12515,12390,12485,12430,40,-15,644,3198
20150326,12485,12430,12515,12515,12355,12490,12470,60,40,878,2772
20150327,12490,12470,12500,12585,12385,12430,12430,-40,-40,236,2652
20150330,12430,12430,12410,12490,12390,12445,12425,15,-5,446,2216
20150331,12445,12425,12380,12470,12220,12400,12410,-25,-15,416,1860
20150401,12400,12410,12390,12430,12390,12395,12400,-15,-10,380,1960
20150402,12395,12400,12500,12500,12400,12450,12440,50,40,420,1850
20150403,12450,12440,12500,12600,12490,12600,12540,160,100,440,2030
20150407,12600,12540,12650,12650,12600,12650,12630,110,90,170,2070
20150408,12650,12630,12515,12705,12515,12625,12615,-5,-15,560,2060
20150409,12625,12615,12715,12740,12710,12710,12725,95,110,230,2100
20150410,12710,12725,12815,13230,12815,13230,13000,505,275,470,2250
20150413,13230,13000,12300,13320,12300,13240,13100,240,100,140,2320
20150414,13240,13100,13010,13010,12900,12900,12945,-200,-155,230,2330
20150415,12900,12945,12830,13220,12830,13220,13020,275,75,210,2420
pb1505,20150105,12420,12415,12505,12505,12450,12480,12475,65,60,86,518
20150106,12480,12475,12315,12450,12250,12450,12340,-25,-135,74,520
20150107,12450,12340,12525,12550,12365,12465,12455,125,115,358,530
20150108,12465,12455,12445,12465,12400,12455,12425,0,-30,120,592
20150109,12455,12425,12510,12545,12470,12505,12485,80,60,26,602
20150112,12505,12485,12410,12440,12400,12405,12410,-80,-75,80,640
20150113,12405,12410,12325,12390,12230,12230,12325,-180,-85,260,736
20150114,12230,12325,12205,12205,11890,11900,11985,-425,-340,920,1228
20150115,11900,11985,12020,12200,11950,12200,12055,215,70,814,1380
20150116,12200,12055,12255,12405,12175,12190,12265,135,210,754,1614
20150119,12190,12265,12150,12475,12150,12435,12390,170,125,522,1616
20150120,12435,12390,12450,12450,12355,12435,12410,45,20,362,1632
20150121,12435,12410,12500,12535,12445,12535,12490,125,80,378,1768
20150122,12535,12490,12480,12850,12450,12630,12625,140,135,532,1880
20150123,12630,12625,12605,12605,12390,12490,12475,-135,-150,450,2048
20150126,12490,12475,12400,12445,12320,12410,12365,-65,-110,534,2176
20150127,12410,12365,12465,12550,12430,12440,12480,75,115,412,2268
20150128,12440,12480,12440,12500,12440,12500,12460,20,-20,372,2458
20150129,12500,12460,12490,12495,12445,12460,12465,0,5,200,2554
20150130,12460,12465,12420,12440,12330,12345,12405,-120,-60,578,2776
20150202,12345,12405,12425,12500,12390,12490,12475,85,70,442,2904
20150203,12490,12475,12475,12535,12435,12500,12500,25,25,186,2896
20150204,12500,12500,12645,12645,12480,12480,12540,-20,40,658,3198
20150205,12480,12540,12490,12585,12480,12500,12520,-40,-20,684,3442
20150206,12500,12520,12550,12575,12520,12565,12550,45,30,260,3504
20150209,12565,12550,12560,12560,12510,12515,12525,-35,-25,284,3634
20150210,12515,12525,12530,12590,12500,12505,12510,-20,-15,290,3734
20150211,12505,12510,12475,12475,12350,12425,12395,-85,-115,750,4070
20150212,12425,12395,12430,12430,12225,12315,12265,-80,-130,2316,5266
20150213,12315,12265,12385,12530,12360,12515,12435,250,170,1472,5286
20150216,12515,12435,12510,12510,12455,12490,12475,55,40,454,5412
20150217,12490,12475,12470,12500,12455,12480,12475,5,0,780,5586
20150225,12480,12475,12240,12305,12190,12270,12275,-205,-200,1482,6176
20150226,12270,12275,12280,12280,12200,12240,12230,-35,-45,3422,8004
20150227,12240,12230,12300,12300,12210,12240,12245,10,15,2078,8502
20150302,12240,12245,12205,12220,12070,12175,12135,-70,-110,6436,11000
20150303,12175,12135,12135,12195,12125,12160,12150,25,15,3476,12420
20150304,12160,12150,12170,12220,12135,12205,12175,55,25,3740,13826
20150305,12205,12175,12215,12280,12140,12205,12215,30,40,4472,14192
20150306,12205,12215,12240,12285,12220,12245,12245,30,30,4162,14904
20150309,12245,12245,12265,12350,12100,12240,12230,-5,-15,4178,15952
20150310,12240,12230,12245,12305,12235,12275,12275,45,45,3154,16794
20150311,12275,12275,12230,12250,12135,12220,12210,-55,-65,3036,17816
20150312,12220,12210,12240,12370,12225,12370,12270,160,60,1770,17854
20150313,12370,12270,12355,12370,12285,12350,12330,80,60,3160,16774
20150316,12350,12330,12300,12300,12160,12280,12245,-50,-85,4820,16552
20150317,12280,12245,12260,12280,12165,12165,12210,-80,-35,3610,16180
20150318,12165,12210,12115,12185,12035,12085,12130,-125,-80,3628,15682
20150319,12085,12130,12065,12165,11995,12150,12090,20,-40,4312,15688
20150320,12150,12090,12135,12155,12070,12070,12110,-20,20,3042,15674
20150323,12070,12110,12165,12350,12140,12335,12275,225,165,5790,14806
20150324,12335,12275,12400,12570,12355,12480,12440,205,165,6344,13274
20150325,12480,12440,12490,12550,12390,12480,12445,40,5,3550,12990
20150326,12480,12445,12495,12540,12440,12495,12475,50,30,2482,12442
20150327,12495,12475,12500,12505,12385,12425,12435,-50,-40,2142,11914
20150330,12425,12435,12435,12500,12375,12415,12440,-20,5,2634,10370
20150331,12415,12440,12420,12470,12365,12385,12415,-55,-25,2692,9322
20150401,12385,12415,12370,12480,12270,12450,12385,35,-30,2550,8592
20150402,12450,12385,12435,12570,12390,12520,12495,135,110,2938,7856
20150403,12520,12495,12530,12680,12500,12680,12590,185,95,2474,7052
20150407,12680,12590,12670,12740,12620,12720,12690,130,100,1546,6386
20150408,12720,12690,12755,12800,12650,12710,12715,20,25,2118,5784
20150409,12710,12715,12725,12815,12705,12790,12770,75,55,1856,5296
20150410,12790,12770,12845,13280,12810,13280,13020,510,250,2382,4804
20150413,13280,13020,13450,13450,13185,13295,13325,275,305,2224,3962
20150414,13295,13325,13300,13340,12845,12935,13040,-390,-285,1286,3598
20150415,12935,13040,13000,13185,12995,13175,13095,135,55,464,3452
20150416,13175,13095,13235,13310,13140,13255,13230,160,135,630,3366
20150417,13255,13230,13440,13695,13365,13590,13565,360,335,1196,2924
20150420,13590,13565,13595,13685,13440,13580,13570,15,5,282,2798
20150421,13580,13570,13625,13625,13485,13485,13510,-85,-60,446,2604
20150422,13485,13510,13480,13750,13480,13720,13610,210,100,498,2556
20150423,13720,13610,13735,13735,13410,13490,13570,-120,-40,552,2314
20150424,13490,13570,13490,13560,13375,13480,13430,-90,-140,314,2204
20150427,13480,13430,13660,13845,13610,13750,13740,320,310,454,1982
20150428,13750,13740,13800,13970,13655,13710,13730,-30,-10,182,1870
20150429,13710,13730,13725,13725,13650,13700,13675,-30,-55,210,1776
20150430,13700,13675,13675,13970,13675,13750,13750,75,75,454,1560
20150504,13750,13750,13850,13860,13830,13860,13845,110,95,200,1510
20150505,13860,13845,13795,13805,13775,13775,13790,-70,-55,140,1380
20150506,13775,13790,13860,13915,13860,13900,13890,110,100,210,1180
20150507,13900,13890,13840,13840,13550,13550,13595,-340,-295,150,1090
20150508,13550,13595,13520,13520,13500,13500,13510,-95,-85,70,1050
20150511,13500,13510,13420,13470,13400,13470,13440,-40,-70,330,970
20150512,13470,13440,13400,13400,13355,13370,13360,-70,-80,110,960
20150513,13370,13360,13490,13490,13490,13490,13490,130,130,20,940
20150514,13490,13490,13500,13600,13500,13600,13540,110,50,400,940
20150515,13600,13540,13500,13500,13450,13450,13480,-90,-60,60,940
pb1506,20150105,12540,12495,12525,12545,12525,12545,12530,50,35,6,364
20150106,12545,12530,12440,12445,12440,12445,12440,-85,-90,6,368
20150107,12445,12440,12520,12590,12450,12590,12485,150,45,32,386
20150108,12590,12485,12485,12535,12485,12520,12525,35,40,54,376
20150109,12520,12525,12525,12595,12520,12520,12550,-5,25,26,374
20150112,12520,12550,12465,12465,12445,12445,12455,-105,-95,4,374
20150113,12445,12455,12350,12410,12290,12290,12360,-165,-95,202,414
20150114,12290,12360,12180,12275,11945,11965,12010,-395,-350,276,458
20150115,11965,12010,12000,12200,12000,12165,12050,155,40,230,476
20150116,12165,12050,12435,12435,12135,12245,12275,195,225,98,486
20150119,12245,12275,,,,12390,12390,115,115,0,486
20150120,12390,12390,,,,12420,12420,30,30,0,486
20150121,12420,12420,12500,12505,12495,12505,12500,85,80,24,478
20150122,12505,12500,12450,12745,12450,12650,12640,150,140,70,474
20150123,12650,12640,12615,12615,12450,12560,12555,-80,-85,48,470
20150126,12560,12555,12500,12500,12385,12390,12400,-165,-155,60,470
20150127,12390,12400,12505,12505,12505,12505,12505,105,105,40,458
20150128,12505,12505,12420,12495,12420,12465,12465,-40,-40,274,504
20150129,12465,12465,12480,12480,12460,12470,12465,5,0,144,530
20150130,12470,12465,12445,12445,12375,12375,12435,-90,-30,80,562
20150202,12375,12435,12490,12520,12490,12510,12495,75,60,92,634
20150203,12510,12495,12490,12490,12490,12490,12490,-5,-5,2,634
20150204,12490,12490,12505,12505,12505,12505,12505,15,15,2,634
20150205,12505,12505,12540,12540,12515,12520,12520,15,15,54,676
20150206,12520,12520,12550,12570,12520,12565,12550,45,30,282,808
20150209,12565,12550,12540,12550,12505,12505,12530,-45,-20,140,888
20150210,12505,12530,12540,12540,12525,12540,12535,10,5,94,944
20150211,12540,12535,12500,12515,12390,12420,12440,-115,-95,188,1030
20150212,12420,12440,12370,12370,12260,12325,12285,-115,-155,276,1236
20150213,12325,12285,12360,12550,12360,12500,12455,215,170,436,1384
20150216,12500,12455,12510,12510,12480,12510,12500,55,45,116,1428
20150217,12510,12500,12470,12525,12470,12525,12510,25,10,44,1466
20150225,12525,12510,12290,12410,12270,12275,12285,-235,-225,356,1710
20150226,12275,12285,12265,12265,12210,12230,12230,-55,-55,898,2344
20150227,12230,12230,12245,12300,12225,12240,12240,10,10,616,2682
20150302,12240,12240,12225,12225,12100,12190,12145,-50,-95,986,3074
20150303,12190,12145,12170,12195,12145,12185,12165,40,20,456,3356
20150304,12185,12165,12160,12230,12160,12230,12190,65,25,274,3422
20150305,12230,12190,12250,12250,12185,12210,12230,20,40,354,3300
20150306,12210,12230,12260,12270,12230,12245,12250,15,20,434,3440
20150309,12245,12250,12250,12270,12150,12250,12230,0,-20,598,3536
20150310,12250,12230,12255,12300,12255,12270,12275,40,45,1138,4122
20150311,12270,12275,12175,12240,12155,12210,12210,-65,-65,452,4218
20150312,12210,12210,12225,12345,12220,12345,12255,135,45,536,4482
20150313,12345,12255,12355,12355,12270,12340,12310,85,55,1336,4960
20150316,12340,12310,12290,12290,12170,12275,12230,-35,-80,1444,5504
20150317,12275,12230,12245,12265,12165,12165,12190,-65,-40,1222,5956
20150318,12165,12190,12150,12165,12050,12085,12115,-105,-75,1918,6948
20150319,12085,12115,12075,12145,12000,12140,12095,25,-20,2022,7716
20150320,12140,12095,12130,12130,12030,12030,12090,-65,-5,1860,8438
20150323,12030,12090,12280,12330,12125,12330,12250,240,160,3374,8208
20150324,12330,12250,12405,12500,12355,12470,12420,220,170,3302,8742
20150325,12470,12420,12485,12530,12370,12485,12435,65,15,2812,9442
20150326,12485,12435,12500,12530,12420,12485,12465,50,30,1882,9926
20150327,12485,12465,12495,12500,12375,12410,12420,-55,-45,2080,10240
20150330,12410,12420,12420,12485,12375,12405,12415,-15,-5,1792,10804
20150331,12405,12415,12430,12450,12350,12360,12395,-55,-20,1552,11282
20150401,12360,12395,12340,12450,12275,12440,12360,45,-35,1858,11734
20150402,12440,12360,12390,12700,12370,12500,12470,140,110,2936,12610
20150403,12500,12470,12500,12660,12470,12660,12565,190,95,3832,13422
20150407,12660,12565,12700,12730,12600,12690,12665,125,100,2112,13736
20150408,12690,12665,12725,12840,12625,12680,12710,15,45,3878,14410
20150409,12680,12710,12715,12820,12680,12810,12760,100,50,6694,16172
20150410,12810,12760,12860,13270,12830,13270,13030,510,270,13692,18306
20150413,13270,13030,13450,13500,13210,13320,13365,290,335,23234,20444
20150414,13320,13365,13305,13355,12870,12925,13075,-440,-290,19678,18842
20150415,12925,13075,13000,13260,12935,13180,13100,105,25,11186,17790
20150416,13180,13100,13150,13365,13130,13290,13250,190,150,15764,17238
20150417,13290,13250,13410,13720,13385,13540,13560,290,310,22928,17714
20150420,13540,13560,13510,13660,13410,13565,13555,5,-5,14726,16558
20150421,13565,13555,13520,13645,13445,13475,13530,-80,-25,9088,15672
20150422,13475,13530,13485,13750,13480,13725,13630,195,100,10376,16494
20150423,13725,13630,13720,13740,13210,13490,13595,-140,-35,13940,16980
20150424,13490,13595,13490,13545,13355,13495,13460,-100,-135,8382,16286
20150427,13495,13460,13620,13840,13595,13755,13720,295,260,13520,16370
20150428,13755,13720,13780,13885,13680,13740,13790,20,70,8828,15412
20150429,13740,13790,13800,13820,13650,13730,13725,-60,-65,5294,15020
20150430,13730,13725,13785,13865,13745,13790,13795,65,70,5512,13776
20150504,13790,13795,13830,13895,13765,13880,13845,85,50,2916,13180
20150505,13880,13845,13860,14025,13510,13800,13790,-45,-55,4712,12918
20150506,13800,13790,13880,13955,13800,13895,13915,105,125,4420,11382
20150507,13895,13915,13840,13850,13455,13540,13645,-375,-270,5006,10358
20150508,13540,13645,13575,13600,13360,13565,13485,-80,-160,2028,9884
20150511,13565,13485,13520,13620,13455,13510,13500,25,15,2190,8792
20150512,13510,13500,13400,13435,13175,13175,13355,-325,-145,2330,7940
20150513,13175,13355,13370,13625,13365,13625,13465,270,110,1420,7482
20150514,13625,13465,13555,13600,13400,13565,13500,100,35,670,7350
20150515,13565,13500,13490,13540,13330,13400,13385,-100,-115,1020,7080
20150518,13400,13385,13345,13495,13315,13435,13430,50,45,1608,6348
20150519,13435,13430,13420,13480,13365,13375,13415,-55,-15,620,6106
20150520,13375,13415,13280,13340,13195,13200,13260,-215,-155,1158,5512
20150521,13200,13260,13180,13375,13140,13335,13220,75,-40,950,5234
20150522,13335,13220,13355,13480,13355,13415,13410,195,190,610,5070
20150525,13415,13410,13265,13350,13250,13335,13315,-75,-95,710,4770
20150526,13335,13315,13370,13440,13320,13320,13375,5,60,404,4514
20150527,13320,13375,13275,13380,13265,13340,13345,-35,-30,944,4288
20150528,13340,13345,13325,13430,13290,13395,13385,50,40,408,4102
20150529,13395,13385,13475,13475,13370,13380,13415,-5,30,312,3910
20150601,13380,13415,13280,13345,13270,13345,13315,-70,-100,70,3910
20150602,13345,13315,13295,13305,13245,13305,13265,-10,-50,290,3710
20150603,13305,13265,13300,13315,13300,13300,13300,35,35,160,3590
20150604,13300,13300,13150,13300,13150,13300,13180,0,-120,230,3360
20150605,13300,13180,13245,13250,13205,13205,13230,25,50,130,3270
20150608,13205,13230,13170,13250,13170,13245,13210,15,-20,940,3120
20150609,13245,13210,13350,13350,13315,13335,13325,125,115,290,3130
20150610,13335,13325,13375,13455,13365,13455,13415,130,90,400,2810
20150611,13455,13415,13400,13410,13395,13410,13400,-5,-15,260,2630
20150612,13410,13400,13180,13200,13100,13100,13180,-300,-220,60,2590
20150615,13100,13180,13180,13180,13070,13070,13130,-110,-50,320,2590
pb1507,20150105,12610,12595,,,,12595,12595,0,0,0,34
20150106,12595,12595,12555,12605,12555,12605,12570,10,-25,8,32
20150107,12605,12570,,,,12570,12570,0,0,0,32
20150108,12570,12570,12580,12580,12580,12580,12580,10,10,2,32
20150109,12580,12580,12575,12575,12575,12575,12575,-5,-5,4,32
20150112,12575,12575,,,,12575,12575,0,0,0,32
20150113,12575,12575,,,,12390,12390,-185,-185,0,32
20150114,12390,12390,12045,12045,12020,12020,12025,-370,-365,8,38
20150115,12020,12025,12070,12215,12070,12210,12170,185,145,12,36
20150116,12210,12170,12205,12275,12205,12240,12230,70,60,10,36
20150119,12240,12230,12250,12350,12250,12350,12300,120,70,4,36
20150120,12350,12300,12520,12520,12520,12520,12520,220,220,2,34
20150121,12520,12520,,,,12520,12520,0,0,0,34
20150122,12520,12520,12730,12750,12695,12735,12730,215,210,18,30
20150123,12735,12730,12645,12645,12480,12480,12545,-250,-185,6,34
20150126,12480,12545,,,,12545,12545,0,0,0,34
20150127,12545,12545,12510,12510,12470,12470,12505,-75,-40,20,26
20150128,12470,12505,,,,12505,12505,0,0,0,26
20150129,12505,12505,,,,12505,12505,0,0,0,26
20150130,12505,12505,,,,12465,12465,-40,-40,0,26
20150202,12465,12465,,,,12465,12465,0,0,0,26
20150203,12465,12465,,,,12465,12465,0,0,0,26
20150204,12465,12465,,,,12465,12465,0,0,0,26
20150205,12465,12465,,,,12465,12465,0,0,0,26
20150206,12465,12465,,,,12465,12465,0,0,0,26
20150209,12465,12465,,,,12465,12465,0,0,0,26
20150210,12465,12465,,,,12465,12465,0,0,0,26
20150211,12465,12465,,,,12465,12465,0,0,0,26
20150212,12465,12465,,,,12465,12465,0,0,0,26
20150213,12465,12465,12580,12580,12580,12580,12580,115,115,2,26
20150216,12580,12580,,,,12565,12565,-15,-15,0,26
20150217,12565,12565,12475,12475,12475,12475,12475,-90,-90,2,26
20150225,12475,12475,12325,12325,12325,12325,12325,-150,-150,2,24
20150226,12325,12325,12245,12245,12240,12240,12240,-85,-85,4,24
20150227,12240,12240,,,,12240,12240,0,0,0,24
20150302,12240,12240,12150,12180,12135,12180,12155,-60,-85,12,34
20150303,12180,12155,,,,12155,12155,0,0,0,34
20150304,12155,12155,12170,12195,12170,12195,12180,40,25,32,50
20150305,12195,12180,12220,12220,12220,12220,12220,40,40,2,50
20150306,12220,12220,12265,12265,12265,12265,12265,45,45,2,52
20150309,12265,12265,12270,12295,12175,12270,12265,5,0,136,148
20150310,12270,12265,12290,12325,12290,12300,12315,35,50,54,198
20150311,12300,12315,12240,12280,12240,12260,12260,-55,-55,98,294
20150312,12260,12260,12280,12350,12280,12350,12335,90,75,14,296
20150313,12350,12335,12345,12355,12340,12350,12345,15,10,92,384
20150316,12350,12345,12255,12300,12255,12280,12280,-65,-65,90,446
20150317,12280,12280,12255,12255,12180,12190,12205,-90,-75,250,618
20150318,12190,12205,12120,12165,12100,12100,12140,-105,-65,110,670
20150319,12100,12140,12110,12145,12045,12140,12110,0,-30,118,722
20150320,12140,12110,12095,12125,12090,12105,12110,-5,0,270,906
20150323,12105,12110,12140,12325,12140,12285,12255,175,145,342,998
20150324,12285,12255,12360,12490,12360,12445,12420,190,165,324,1162
20150325,12445,12420,12500,12525,12370,12475,12415,55,-5,578,1306
20150326,12475,12415,12505,12505,12430,12475,12455,60,40,342,1298
20150327,12475,12455,12465,12490,12380,12425,12415,-30,-40,284,1392
20150330,12425,12415,12400,12475,12380,12415,12425,0,10,234,1362
20150331,12415,12425,12400,12435,12365,12365,12400,-60,-25,738,1754
20150401,12365,12400,12350,12440,12300,12440,12375,40,-25,442,1834
20150402,12440,12375,12410,12590,12410,12480,12475,105,100,1006,2056
20150403,12480,12475,12505,12660,12500,12660,12575,185,100,450,2160
20150407,12660,12575,12645,12720,12625,12675,12665,100,90,510,2252
20150408,12675,12665,12700,12780,12625,12685,12680,20,15,772,2362
20150409,12685,12680,12730,12805,12730,12805,12760,125,80,738,2756
20150410,12805,12760,12850,13270,12840,13270,13040,510,280,1802,3422
20150413,13270,13040,13365,13485,13205,13310,13325,270,285,1916,3792
20150414,13310,13325,13280,13350,12895,12960,13080,-365,-245,3416,4984
20150415,12960,13080,13025,13265,12970,13195,13115,115,35,1898,5094
20150416,13195,13115,13155,13360,13140,13295,13255,180,140,1786,5704
20150417,13295,13255,13410,13710,13410,13555,13555,300,300,3908,5776
20150420,13555,13555,13560,13635,13420,13560,13545,5,-10,1424,5952
20150421,13560,13545,13515,13620,13440,13470,13505,-75,-40,1532,6290
20150422,13470,13505,13490,13740,13465,13725,13620,220,115,3848,7806
20150423,13725,13620,13710,13710,13395,13470,13580,-150,-40,3388,8176
20150424,13470,13580,13425,13525,13345,13500,13445,-80,-135,1582,8306
20150427,13500,13445,13620,13820,13595,13725,13705,280,260,4230,9704
20150428,13725,13705,13765,13880,13675,13735,13770,30,65,5942,11064
20150429,13735,13770,13780,13795,13645,13740,13720,-30,-50,2682,11528
20150430,13740,13720,13775,13875,13755,13790,13805,70,85,3978,12200
20150504,13790,13805,13885,13900,13755,13900,13845,95,40,3118,12438
20150505,13900,13845,13870,14030,13510,13790,13805,-55,-40,5478,12806
20150506,13790,13805,13900,13980,13840,13910,13935,105,130,6580,14300
20150507,13910,13935,13880,13880,13445,13485,13650,-450,-285,13254,15448
20150508,13485,13650,13555,13585,13360,13560,13490,-90,-160,8424,15468
20150511,13560,13490,13520,13630,13450,13495,13505,5,15,5804,15762
20150512,13495,13505,13450,13450,13295,13320,13375,-185,-130,7050,15628
20150513,13320,13375,13445,13675,13380,13620,13490,245,115,6946,15334
20150514,13620,13490,13580,13600,13405,13550,13485,60,-5,5860,15068
20150515,13550,13485,13480,13530,13300,13360,13385,-125,-100,7082,14858
20150518,13360,13385,13345,13460,13265,13410,13375,25,-10,5910,15244
20150519,13410,13375,13385,13500,13320,13335,13385,-40,10,5104,15034
20150520,13335,13385,13240,13300,13155,13180,13225,-205,-160,6986,15286
20150521,13180,13225,13165,13340,13095,13270,13200,45,-25,6224,14688
20150522,13270,13200,13280,13465,13280,13380,13355,180,155,6554,14442
20150525,13380,13355,13270,13280,13180,13275,13235,-80,-120,6012,13632
20150526,13275,13235,13265,13425,13235,13250,13335,15,100,3876,13008
20150527,13250,13335,13200,13340,13170,13310,13275,-25,-60,5060,12966
20150528,13310,13275,13260,13380,13260,13355,13330,80,55,3404,12560
20150529,13355,13330,13415,13445,13300,13415,13380,85,50,4658,11596
20150601,13415,13380,13310,13360,13210,13285,13265,-95,-115,3602,10496
20150602,13285,13265,13210,13300,13180,13220,13235,-45,-30,3774,9378
20150603,13220,13235,13240,13295,13100,13100,13225,-135,-10,2926,8524
20150604,13100,13225,13130,13290,13110,13265,13200,40,-25,2332,8068
20150605,13265,13200,13300,13300,13160,13170,13200,-30,0,1196,7854
20150608,13170,13200,13165,13245,13105,13180,13170,-20,-30,1634,7446
20150609,13180,13170,13250,13315,13210,13240,13250,70,80,1030,6956
20150610,13240,13250,13285,13450,13245,13450,13315,200,65,1020,6636
20150611,13450,13315,13435,13435,13260,13260,13320,-55,5,790,6418
20150612,13260,13320,13235,13240,13000,13020,13095,-300,-225,1048,6476
20150615,13020,13095,13055,13135,13000,13035,13080,-60,-15,810,6006
20150616,13035,13080,12920,12995,12875,12930,12935,-150,-145,706,5528
20150617,12930,12935,12940,12980,12875,12940,12935,5,0,432,5202
20150618,12940,12935,12915,13175,12895,13145,13085,210,150,922,4632
20150619,13145,13085,13185,13200,13000,13020,13075,-65,-10,380,4386
20150623,13020,13075,13080,13185,13070,13170,13165,95,90,304,4240
20150624,13170,13165,13280,13400,13150,13390,13360,225,195,1010,3540
20150625,13390,13360,13500,13525,13300,13360,13375,0,15,662,3080
20150626,13360,13375,13330,13400,13330,13375,13380,0,5,440,2756
20150629,13375,13380,13305,13450,13155,13155,13320,-225,-60,512,2386
20150630,13155,13320,13110,13155,13000,13035,13095,-285,-225,614,2210
20150701,13035,13095,13015,13170,12850,13170,12960,75,-135,210,2100
20150702,13170,12960,13115,13360,13005,13200,13120,240,160,530,2160
20150703,13200,13120,13150,13160,13040,13045,13110,-75,-10,450,2120
20150706,13045,13110,13040,13115,12820,12850,12950,-260,-160,470,2170
20150707,12850,12950,13015,13020,12820,12820,12980,-130,30,270,2270
20150708,12820,12980,12605,12660,12460,12460,12590,-520,-390,240,2250
20150709,12460,12590,13090,13090,13000,13055,13070,465,480,170,2350
20150710,13055,13070,13260,13260,13110,13110,13195,40,125,270,2440
20150713,13110,13195,13100,13150,13100,13150,13125,-45,-70,20,2440
20150714,13150,13125,13390,13430,13250,13250,13350,125,225,230,2250
20150715,13250,13350,13300,13300,13280,13280,13295,-70,-55,70,2250
pb1508,20150105,12645,12645,12730,12730,12660,12660,12695,15,50,4,60
20150106,12660,12695,12570,12700,12570,12640,12620,-55,-75,18,58
20150107,12640,12620,,,,12665,12665,45,45,0,58
20150108,12665,12665,12655,12655,12655,12655,12655,-10,-10,2,58
20150109,12655,12655,12640,12650,12640,12650,12645,-5,-10,4,60
20150112,12650,12645,12565,12565,12565,12565,12565,-80,-80,2,60
20150113,12565,12565,,,,12465,12465,-100,-100,0,60
20150114,12465,12465,12320,12320,12035,12075,12075,-390,-390,16,68
20150115,12075,12075,12065,12220,12015,12190,12100,115,25,18,64
20150116,12190,12100,,,,12160,12160,60,60,0,64
20150119,12160,12160,12385,12515,12385,12515,12465,355,305,6,64
20150120,12515,12465,,,,12465,12465,0,0,0,64
20150121,12465,12465,,,,12545,12545,80,80,0,64
20150122,12545,12545,12640,12895,12640,12895,12740,350,195,18,58
20150123,12895,12740,,,,12615,12615,-125,-125,0,58
20150126,12615,12615,12485,12485,12485,12485,12485,-130,-130,2,60
20150127,12485,12485,12585,12585,12520,12520,12530,35,45,28,44
20150128,12520,12530,,,,12530,12530,0,0,0,44
20150129,12530,12530,12550,12550,12550,12550,12550,20,20,2,44
20150130,12550,12550,12470,12470,12470,12470,12470,-80,-80,2,44
20150202,12470,12470,,,,12470,12470,0,0,0,44
20150203,12470,12470,,,,12470,12470,0,0,0,44
20150204,12470,12470,12590,12590,12590,12590,12590,120,120,2,44
20150205,12590,12590,12600,12600,12600,12600,12600,10,10,2,44
20150206,12600,12600,,,,12600,12600,0,0,0,44
20150209,12600,12600,,,,12580,12580,-20,-20,0,44
20150210,12580,12580,12550,12550,12550,12550,12550,-30,-30,2,44
20150211,12550,12550,12550,12550,12550,12550,12550,0,0,4,48
20150212,12550,12550,12385,12385,12385,12385,12385,-165,-165,2,48
20150213,12385,12385,12565,12590,12560,12590,12570,205,185,6,44
20150216,12590,12570,,,,12570,12570,0,0,0,44
20150217,12570,12570,12525,12525,12525,12525,12525,-45,-45,2,44
20150225,12525,12525,,,,12370,12370,-155,-155,0,44
20150226,12370,12370,,,,12370,12370,0,0,0,44
20150227,12370,12370,,,,12290,12290,-80,-80,0,44
20150302,12290,12290,12150,12200,12100,12200,12150,-90,-140,18,46
20150303,12200,12150,12120,12245,12120,12140,12160,-10,10,8,44
20150304,12140,12160,12170,12170,12170,12170,12170,10,10,2,44
20150305,12170,12170,12200,12210,12200,12210,12205,40,35,12,52
20150306,12210,12205,12275,12275,12275,12275,12275,70,70,10,62
20150309,12275,12275,12280,12280,12265,12280,12275,5,0,12,66
20150310,12280,12275,12290,12365,12290,12300,12340,25,65,14,70
20150311,12300,12340,12260,12260,12260,12260,12260,-80,-80,2,70
20150312,12260,12260,,,,12355,12355,95,95,0,70
20150313,12355,12355,,,,12355,12355,0,0,0,70
20150316,12355,12355,12265,12265,12265,12265,12265,-90,-90,2,70
20150317,12265,12265,12260,12260,12255,12255,12255,-10,-10,6,70
20150318,12255,12255,,,,12190,12190,-65,-65,0,70
20150319,12190,12190,12170,12170,12170,12170,12170,-20,-20,2,70
20150320,12170,12170,,,,12130,12130,-40,-40,0,70
20150323,12130,12130,,,,12130,12130,0,0,0,70
20150324,12130,12130,,,,12230,12230,100,100,0,70
20150325,12230,12230,12480,12480,12405,12405,12440,175,210,4,72
20150326,12405,12440,12460,12460,12460,12460,12460,20,20,2,70
20150327,12460,12460,,,,12420,12420,-40,-40,0,70
20150330,12420,12420,,,,12420,12420,0,0,0,70
20150331,12420,12420,,,,12420,12420,0,0,0,70
20150401,12420,12420,12405,12455,12405,12430,12425,10,5,10,66
20150402,12430,12425,12435,12435,12435,12435,12435,10,10,2,64
20150403,12435,12435,12520,12635,12520,12630,12575,195,140,10,66
20150407,12630,12575,,,,12665,12665,90,90,0,66
20150408,12665,12665,12680,12680,12680,12680,12680,15,15,2,64
20150409,12680,12680,,,,12760,12760,80,80,0,64
20150410,12760,12760,13000,13270,12990,13270,13185,510,425,130,96
20150413,13270,13185,13600,13600,13240,13300,13320,115,135,314,270
20150414,13300,13320,13300,13300,12910,12955,13055,-365,-265,708,550
20150415,12955,13055,13050,13205,13050,13185,13105,130,50,300,652
20150416,13185,13105,13295,13350,13165,13300,13240,195,135,446,750
20150417,13300,13240,13465,13685,13445,13545,13575,305,335,1324,1460
20150420,13545,13575,13495,13625,13450,13510,13565,-65,-10,532,1548
20150421,13510,13565,13530,13605,13395,13470,13475,-95,-90,276,1620
20150422,13470,13475,13525,13710,13490,13705,13585,230,110,818,1892
20150423,13705,13585,13655,13700,13410,13455,13525,-130,-60,1128,2258
20150424,13455,13525,13460,13500,13360,13500,13450,-25,-75,836,2532
20150427,13500,13450,13655,13805,13605,13785,13720,335,270,534,2652
20150428,13785,13720,13785,13855,13675,13720,13740,0,20,1024,3146
20150429,13720,13740,13800,13800,13640,13740,13690,0,-50,516,3276
20150430,13740,13690,13780,13865,13755,13785,13785,95,95,652,3434
20150504,13785,13785,13800,13890,13760,13880,13840,95,55,674,3818
20150505,13880,13840,13950,14020,13590,13820,13800,-20,-40,430,3920
20150506,13820,13800,13900,13965,13825,13915,13935,115,135,638,4130
20150507,13915,13935,13845,13850,13500,13515,13660,-420,-275,918,4224
20150508,13515,13660,13550,13595,13370,13565,13510,-95,-150,864,4504
20150511,13565,13510,13525,13620,13450,13500,13505,-10,-5,762,4656
20150512,13500,13505,13410,13435,13310,13350,13375,-155,-130,1084,4954
20150513,13350,13375,13400,13600,13395,13580,13495,205,120,922,5248
20150514,13580,13495,13650,13650,13395,13550,13445,55,-50,942,5384
20150515,13550,13445,13470,13530,13315,13370,13360,-75,-85,882,5564
20150518,13370,13360,13350,13460,13270,13420,13375,60,15,1738,6482
20150519,13420,13375,13380,13445,13310,13325,13375,-50,0,1630,6960
20150520,13325,13375,13250,13280,13150,13165,13210,-210,-165,1242,7310
20150521,13165,13210,13160,13310,13085,13240,13190,30,-20,1568,7846
20150522,13240,13190,13290,13415,13290,13360,13340,170,150,1362,8186
20150525,13360,13340,13240,13255,13155,13240,13210,-100,-130,1808,8568
20150526,13240,13210,13250,13410,13200,13200,13300,-10,90,1100,8712
20150527,13200,13300,13200,13295,13150,13260,13235,-40,-65,2306,9330
20150528,13260,13235,13235,13330,13220,13305,13285,70,50,1278,9610
20150529,13305,13285,13445,13445,13275,13395,13350,110,65,2496,10170
20150601,13395,13350,13305,13335,13185,13235,13240,-115,-110,2710,10530
20150602,13235,13240,13200,13250,13140,13190,13190,-50,-50,3118,10598
20150603,13190,13190,13190,13255,13075,13075,13175,-115,-15,2856,10956
20150604,13075,13175,13110,13240,13040,13215,13150,40,-25,3774,10862
20150605,13215,13150,13205,13260,13100,13100,13155,-50,5,2768,11250
20150608,13100,13155,13100,13185,13030,13110,13095,-45,-60,4436,11754
20150609,13110,13095,13135,13260,13135,13150,13190,55,95,4604,12020
20150610,13150,13190,13200,13240,13165,13225,13220,35,30,4424,12108
20150611,13225,13220,13260,13295,13155,13165,13225,-55,5,2802,12018
20150612,13165,13225,13135,13165,12800,12835,12940,-390,-285,7256,12060
20150615,12835,12940,12855,12905,12770,12775,12855,-165,-85,6566,12106
20150616,12775,12855,12720,12795,12650,12750,12730,-105,-125,10040,14392
20150617,12750,12730,12720,12780,12650,12705,12740,-25,10,4658,14024
20150618,12705,12740,12750,12990,12725,12985,12900,245,160,6972,13550
20150619,12985,12900,12970,13020,12905,12920,12960,20,60,4800,12914
20150623,12920,12960,12850,13095,12850,13080,13015,120,55,3100,13032
20150624,13080,13015,13080,13230,13040,13225,13160,210,145,5368,13096
20150625,13225,13160,13235,13290,13110,13135,13165,-25,5,3312,12946
20150626,13135,13165,13135,13140,13040,13100,13100,-65,-65,4758,13216
20150629,13100,13100,13080,13080,12755,12820,13000,-280,-100,3746,13106
20150630,12820,13000,12750,12920,12710,12795,12800,-205,-200,4462,13850
20150701,12795,12800,12795,12835,12435,12770,12660,-30,-140,3752,13668
20150702,12770,12660,12840,13130,12705,13100,12970,440,310,3934,13450
20150703,13100,12970,13110,13125,12910,12955,13020,-15,50,2334,13068
20150706,12955,13020,12895,12920,12660,12715,12795,-305,-225,2456,12822
20150707,12715,12795,12785,12880,12655,12690,12785,-105,-10,2420,12234
20150708,12690,12785,12655,12710,12270,12270,12445,-515,-340,6296,12214
20150709,12270,12445,12500,12940,12210,12940,12775,495,330,2828,11702
20150710,12940,12775,13155,13250,12970,13055,13105,280,330,1908,11104
20150713,13055,13105,13035,13100,12950,13010,13020,-95,-85,1130,10440
20150714,13010,13020,13155,13400,13155,13360,13315,340,295,1532,9934
20150715,13360,13315,13330,13360,13250,13355,13315,40,0,1330,9192
20150716,13355,13315,13400,13450,13240,13340,13320,25,5,1104,8558
20150717,13340,13320,13265,13350,13265,13280,13300,-40,-20,758,8036
20150720,13280,13300,13300,13380,13250,13310,13285,10,-15,1024,7472
20150721,13310,13285,13285,13335,13230,13230,13275,-55,-10,1528,6230
20150722,13230,13275,13210,13225,13005,13025,13095,-250,-180,916,5670
20150723,13025,13095,12955,13175,12945,13120,13045,25,-50,448,5528
20150724,13120,13045,13000,13020,12900,12915,12930,-130,-115,726,5166
20150727,12915,12930,12910,13000,12910,12960,12965,30,35,474,4814
20150728,12960,12965,12955,13005,12940,12955,12965,-10,0,832,4374
20150729,12955,12965,13085,13300,13085,13230,13215,265,250,532,4050
20150730,13230,13215,13205,13280,13205,13230,13225,15,10,390,3942
20150731,13230,13225,13350,13350,13180,13190,13210,-35,-15,732,3550
20150803,13190,13210,13160,13465,13100,13100,13135,-110,-75,440,3220
20150804,13100,13135,13080,13120,13080,13120,13090,-15,-45,510,3140
20150805,13120,13090,13150,13160,13140,13150,13150,60,60,210,3030
20150806,13150,13150,13055,13180,13055,13180,13125,30,-25,350,2680
20150807,13180,13125,13165,13165,13050,13090,13075,-35,-50,100,2600
20150810,13090,13075,13175,13250,13135,13250,13210,175,135,370,2490
20150811,13250,13210,13355,13355,13300,13355,13325,145,115,100,2400
20150812,13355,13325,13350,13400,13345,13400,13380,75,55,170,2330
20150813,13400,13380,13910,13910,13550,13650,13695,270,315,460,2430
20150814,13650,13695,13500,13510,13500,13510,13505,-185,-190,70,2380
20150817,13510,13505,13700,13700,13700,13700,13700,195,195,20,2380
pb1509,20150105,12685,12685,12700,12710,12700,12710,12700,25,15,16,38
20150106,12710,12700,,,,12700,12700,0,0,0,38
20150107,12700,12700,,,,12700,12700,0,0,0,38
20150108,12700,12700,12725,12725,12660,12660,12690,-40,-10,4,40
20150109,12660,12690,12625,12635,12625,12635,12630,-55,-60,4,42
20150112,12635,12630,,,,12630,12630,0,0,0,42
20150113,12630,12630,12565,12565,12500,12505,12515,-125,-115,8,42
20150114,12505,12515,12375,12375,12020,12020,12205,-495,-310,22,50
20150115,12020,12205,12150,12375,12045,12375,12180,170,-25,28,68
20150116,12375,12180,12480,12480,12280,12280,12325,100,145,10,66
20150119,12280,12325,12430,12450,12430,12450,12440,125,115,4,64
20150120,12450,12440,12515,12515,12515,12515,12515,75,75,2,66
20150121,12515,12515,12605,12605,12605,12605,12605,90,90,2,66
20150122,12605,12605,12735,12755,12735,12755,12740,150,135,10,60
20150123,12755,12740,12710,12710,12585,12585,12675,-155,-65,16,60
20150126,12585,12675,12465,12515,12465,12515,12490,-160,-185,4,56
20150127,12515,12490,12580,12580,12555,12555,12565,65,75,4,56
20150128,12555,12565,,,,12565,12565,0,0,0,56
20150129,12565,12565,12595,12595,12595,12595,12595,30,30,2,56
20150130,12595,12595,,,,12510,12510,-85,-85,0,56
20150202,12510,12510,,,,12510,12510,0,0,0,56
20150203,12510,12510,,,,12510,12510,0,0,0,56
20150204,12510,12510,,,,12630,12630,120,120,0,56
20150205,12630,12630,12625,12625,12590,12590,12600,-40,-30,6,58
20150206,12590,12600,,,,12630,12630,30,30,0,58
20150209,12630,12630,12625,12625,12625,12625,12625,-5,-5,2,60
20150210,12625,12625,,,,12625,12625,0,0,0,60
20150211,12625,12625,,,,12545,12545,-80,-80,0,60
20150212,12545,12545,,,,12405,12405,-140,-140,0,60
20150213,12405,12405,12630,12630,12630,12630,12630,225,225,2,60
20150216,12630,12630,12590,12590,12590,12590,12590,-40,-40,2,62
20150217,12590,12590,12525,12525,12490,12505,12505,-85,-85,16,58
20150225,12505,12505,,,,12350,12350,-155,-155,0,58
20150226,12350,12350,12300,12305,12280,12280,12295,-70,-55,6,58
20150227,12280,12295,12325,12325,12300,12300,12305,5,10,10,64
20150302,12300,12305,12170,12210,12170,12210,12190,-95,-115,4,64
20150303,12210,12190,12215,12215,12215,12215,12215,25,25,2,66
20150304,12215,12215,,,,12215,12215,0,0,0,66
20150305,12215,12215,12220,12245,12220,12245,12235,30,20,6,64
20150306,12245,12235,,,,12305,12305,70,70,0,64
20150309,12305,12305,,,,12305,12305,0,0,0,64
20150310,12305,12305,,,,12305,12305,0,0,0,64
20150311,12305,12305,,,,12275,12275,-30,-30,0,64
20150312,12275,12275,12305,12305,12230,12230,12265,-45,-10,4,64
20150313,12230,12265,,,,12265,12265,0,0,0,64
20150316,12265,12265,,,,12265,12265,0,0,0,64
20150317,12265,12265,,,,12230,12230,-35,-35,0,64
20150318,12230,12230,12135,12135,12135,12135,12135,-95,-95,2,66
20150319,12135,12135,12165,12185,12165,12185,12175,50,40,4,66
20150320,12185,12175,12105,12105,12105,12105,12105,-70,-70,2,66
20150323,12105,12105,12210,12325,12210,12285,12290,180,185,20,68
20150324,12285,12290,12405,12570,12405,12425,12460,135,170,20,64
20150325,12425,12460,,,,12460,12460,0,0,0,64
20150326,12460,12460,12580,12580,12500,12500,12525,40,65,12,68
20150327,12500,12525,12425,12425,12425,12425,12425,-100,-100,6,70
20150330,12425,12425,12420,12420,12420,12420,12420,-5,-5,2,72
20150331,12420,12420,12420,12420,12420,12420,12420,0,0,2,72
20150401,12420,12420,12415,12500,12415,12500,12450,80,30,6,74
20150402,12500,12450,12430,12520,12430,12480,12485,30,35,20,78
20150403,12480,12485,12500,12540,12500,12540,12520,55,35,14,74
20150407,12540,12520,12650,12650,12650,12650,12650,130,130,2,72
20150408,12650,12650,12730,12765,12635,12680,12690,30,40,16,70
20150409,12680,12690,12770,12770,12770,12770,12770,80,80,2,68
20150410,12770,12770,12945,13280,12945,13280,13170,510,400,36,58
20150413,13280,13170,13520,13520,13280,13280,13435,110,265,130,108
20150414,13280,13435,13320,13325,12970,13000,13150,-435,-285,36,116
20150415,13000,13150,13145,13220,13120,13205,13155,55,5,48,132
20150416,13205,13155,13275,13370,13180,13370,13275,215,120,62,140
20150417,13370,13275,13480,13710,13480,13630,13575,355,300,108,174
20150420,13630,13575,13555,13625,13540,13550,13570,-25,-5,102,198
20150421,13550,13570,13555,13555,13500,13510,13520,-60,-50,20,192
20150422,13510,13520,13635,13720,13635,13715,13705,195,185,32,182
20150423,13715,13705,13670,13715,13405,13460,13555,-245,-150,160,236
20150424,13460,13555,13450,13515,13350,13515,13475,-40,-80,52,238
20150427,13515,13475,13700,13800,13660,13775,13765,300,290,618,644
20150428,13775,13765,13815,13900,13690,13720,13755,-45,-10,546,606
20150429,13720,13755,13780,13780,13655,13750,13705,-5,-50,190,640
20150430,13750,13705,13840,13850,13760,13760,13800,55,95,64,644
20150504,13760,13800,13855,13875,13825,13875,13845,75,45,26,648
20150505,13875,13845,13945,13945,13675,13790,13805,-55,-40,64,652
20150506,13790,13805,13945,13995,13875,13910,13955,105,150,180,742
20150507,13910,13955,13850,13850,13500,13500,13765,-455,-190,114,776
20150508,13500,13765,13615,13625,13440,13610,13550,-155,-215,176,850
20150511,13610,13550,13590,13995,13465,13500,13515,-50,-35,174,882
20150512,13500,13515,13430,13435,13335,13370,13385,-145,-130,156,928
20150513,13370,13385,13420,13625,13420,13570,13520,185,135,244,1062
20150514,13570,13520,13540,13560,13410,13545,13475,25,-45,208,1132
20150515,13545,13475,13515,13515,13325,13365,13355,-110,-120,210,1152
20150518,13365,13355,13285,13475,13285,13460,13415,105,60,172,1226
20150519,13460,13415,13480,13480,13320,13320,13380,-95,-35,118,1196
20150520,13320,13380,13285,13315,13140,13140,13210,-240,-170,826,1616
20150521,13140,13210,13140,13320,13090,13280,13160,70,-50,962,2298
20150522,13280,13160,13260,13525,13260,13420,13355,260,195,516,2494
20150525,13420,13355,13215,13260,13150,13220,13190,-135,-165,1232,3322
20150526,13220,13190,13290,13350,13200,13200,13295,10,105,844,3676
20150527,13200,13295,13190,13280,13140,13230,13215,-65,-80,568,3916
20150528,13230,13215,13190,13300,13190,13300,13275,85,60,254,4048
20150529,13300,13275,13380,13385,13230,13380,13325,105,50,696,4202
20150601,13380,13325,13280,13320,13160,13215,13205,-110,-120,1046,4676
20150602,13215,13205,13145,13260,13130,13175,13180,-30,-25,1302,5096
20150603,13175,13180,13200,13250,13080,13085,13155,-95,-25,972,5474
20150604,13085,13155,13150,13245,13000,13225,13150,70,-5,1452,5902
20150605,13225,13150,13200,13250,13100,13100,13150,-50,0,952,6196
20150608,13100,13150,13100,13160,13050,13105,13080,-45,-70,708,6466
20150609,13105,13080,13145,13250,13135,13135,13170,55,90,1056,6776
20150610,13135,13170,13185,13220,13170,13190,13190,20,20,1296,7194
20150611,13190,13190,13260,13275,13135,13140,13185,-50,-5,608,7336
20150612,13140,13185,13120,13120,12790,12805,12885,-380,-300,3084,8716
20150615,12805,12885,12835,12850,12730,12730,12805,-155,-80,1820,9390
20150616,12730,12805,12655,12720,12605,12685,12680,-120,-125,1384,10016
20150617,12685,12680,12680,12715,12610,12620,12650,-60,-30,1144,10496
20150618,12620,12650,12660,12850,12615,12840,12750,190,100,1808,10598
20150619,12840,12750,12870,12885,12830,12860,12850,110,100,902,10292
20150623,12860,12850,12800,13000,12755,12980,12895,130,45,1644,10218
20150624,12980,12895,12990,13175,12930,13130,13035,235,140,2970,10338
20150625,13130,13035,13135,13145,12990,13010,13050,-25,15,2710,10456
20150626,13010,13050,13010,13030,12910,12985,12995,-65,-55,2630,10404
20150629,12985,12995,12935,12965,12685,12700,12880,-295,-115,1418,10686
20150630,12700,12880,12680,12780,12605,12670,12690,-210,-190,1844,11190
20150701,12670,12690,12685,12730,12185,12665,12570,-25,-120,2994,11576
20150702,12665,12570,12780,12980,12680,12960,12830,390,260,2554,12360
20150703,12960,12830,12900,12990,12790,12865,12890,35,60,2672,12318
20150706,12865,12890,12800,12820,12575,12610,12700,-280,-190,1764,12234
20150707,12610,12700,12680,12765,12570,12570,12660,-130,-40,1828,12096
20150708,12570,12660,12570,12590,12150,12150,12335,-510,-325,11978,12608
20150709,12150,12335,12300,12825,12300,12810,12695,475,360,9282,12502
20150710,12810,12695,12905,13160,12800,12910,12970,215,275,5498,12382
20150713,12910,12970,12970,12975,12770,12840,12865,-130,-105,2768,12498
20150714,12840,12865,13040,13260,13015,13255,13155,390,290,5634,12900
20150715,13255,13155,13155,13215,13065,13180,13150,25,-5,4496,12566
20150716,13180,13150,13210,13290,13015,13190,13130,40,-20,4818,12624
20150717,13190,13130,13045,13190,13035,13115,13100,-15,-30,3396,12524
20150720,13115,13100,13080,13225,13020,13110,13125,10,25,2728,12382
20150721,13110,13125,13020,13190,13020,13095,13115,-30,-10,3028,12166
20150722,13095,13115,13020,13075,12825,12870,12945,-245,-170,4448,11654
20150723,12870,12945,12865,13000,12760,12960,12895,15,-50,3884,11174
20150724,12960,12895,12855,12950,12680,12730,12780,-165,-115,3828,11038
20150727,12730,12780,12705,12860,12705,12815,12790,35,10,2798,11150
20150728,12815,12790,12740,12850,12730,12815,12790,25,0,2968,10382
20150729,12815,12790,12895,13200,12845,13200,13080,410,290,4792,10268
20150730,13200,13080,13160,13265,13125,13220,13175,140,95,4682,9848
20150731,13220,13175,13195,13200,13075,13130,13150,-45,-25,2888,9806
20150803,13130,13150,13100,13200,12990,12995,13115,-155,-35,2696,8902
20150804,12995,13115,12980,13045,12820,13040,12925,-75,-190,3016,8034
20150805,13040,12925,13170,13195,13080,13115,13110,190,185,2108,7656
20150806,13115,13110,13085,13110,13035,13100,13080,-10,-30,1436,7274
20150807,13100,13080,13020,13060,12970,13000,13010,-80,-70,1118,6750
20150810,13000,13010,12955,13240,12930,13240,13135,230,125,1294,6396
20150811,13240,13135,13220,13385,13200,13385,13290,250,155,1944,6016
20150812,13385,13290,13260,13375,13215,13355,13305,65,15,858,5690
20150813,13355,13305,13495,13595,13270,13585,13480,280,175,930,5498
20150814,13585,13480,13465,13520,13340,13380,13440,-100,-40,742,5552
20150817,13380,13440,13420,13535,13345,13465,13425,25,-15,798,5316
20150818,13465,13425,13405,13475,13300,13300,13420,-125,-5,626,4922
20150819,13300,13420,13280,13400,13160,13400,13270,-20,-150,324,4866
20150820,13400,13270,13430,13495,13420,13480,13455,210,185,524,4752
20150821,13480,13455,13685,13685,13350,13385,13545,-70,90,968,4340
20150824,13385,13545,13390,13480,13270,13270,13340,-275,-205,830,4090
20150825,13270,13340,13130,13390,13105,13315,13240,-25,-100,902,3498
20150826,13315,13240,13485,13530,13280,13325,13425,85,185,366,3292
20150827,13325,13425,13305,13460,13305,13455,13425,30,0,470,2942
20150828,13455,13425,13485,13595,13465,13500,13530,75,105,632,2602
20150831,13500,13530,13450,13525,13440,13460,13485,-70,-45,248,2460
20150901,13460,13485,13385,13500,13385,13460,13465,-25,-20,290,2270
20150902,13460,13465,13500,13525,13500,13525,13505,60,40,490,1850
20150907,13525,13505,13585,13775,13510,13545,13570,40,65,480,1690
20150908,13545,13570,13475,13520,13250,13300,13390,-270,-180,1000,1170
20150909,13300,13390,13555,13555,13480,13480,13495,90,105,120,1130
20150910,13480,13495,13540,13540,13440,13500,13465,5,-30,1080,1780
20150911,13500,13465,13500,13520,13490,13520,13505,55,40,200,1630
20150914,13520,13505,,,,13430,13430,-75,-75,0,1630
20150915,13430,13430,13230,13260,13230,13250,13245,-180,-185,760,870
pb1510,20150105,12695,12680,12730,12730,12680,12680,12705,0,25,4,414
20150106,12680,12705,12650,12660,12645,12645,12650,-60,-55,8,416
20150107,12645,12650,12615,12630,12615,12630,12620,-20,-30,10,406
20150108,12630,12620,,,,12620,12620,0,0,0,406
20150109,12620,12620,12650,12710,12650,12710,12680,90,60,4,408
20150112,12710,12680,12640,12640,12640,12640,12640,-40,-40,2,408
20150113,12640,12640,12535,12610,12485,12485,12535,-155,-105,14,406
20150114,12485,12535,12285,12370,12045,12115,12255,-420,-280,78,414
20150115,12115,12255,12065,12315,12065,12230,12145,-25,-110,16,418
20150116,12230,12145,12325,12450,12245,12390,12315,245,170,28,424
20150119,12390,12315,12335,12540,12335,12530,12475,215,160,24,410
20150120,12530,12475,12580,12580,12560,12560,12570,85,95,4,410
20150121,12560,12570,12605,12630,12605,12630,12615,60,45,4,408
20150122,12630,12615,12625,12795,12625,12765,12735,150,120,46,402
20150123,12765,12735,12645,12645,12600,12600,12615,-135,-120,12,394
20150126,12600,12615,12575,12590,12550,12550,12565,-65,-50,38,392
20150127,12550,12565,12640,12640,12545,12545,12565,-20,0,42,392
20150128,12545,12565,12525,12525,12525,12525,12525,-40,-40,2,394
20150129,12525,12525,,,,12525,12525,0,0,0,394
20150130,12525,12525,12520,12520,12480,12480,12500,-45,-25,4,394
20150202,12480,12500,,,,12555,12555,55,55,0,394
20150203,12555,12555,12570,12600,12570,12600,12590,45,35,8,394
20150204,12600,12590,12630,12670,12630,12670,12640,80,50,6,396
20150205,12670,12640,,,,12640,12640,0,0,0,396
20150206,12640,12640,12650,12650,12625,12630,12630,-10,-10,14,398
20150209,12630,12630,,,,12630,12630,0,0,0,398
20150210,12630,12630,12660,12660,12660,12660,12660,30,30,6,394
20150211,12660,12660,12550,12695,12525,12525,12565,-135,-95,10,388
20150212,12525,12565,12490,12490,12385,12430,12420,-135,-145,8,390
20150213,12430,12420,12480,12585,12480,12585,12500,165,80,20,392
20150216,12585,12500,12615,12620,12590,12590,12605,90,105,30,382
20150217,12590,12605,12535,12535,12500,12505,12505,-100,-100,76,370
20150225,12505,12505,12350,12365,12350,12350,12355,-155,-150,10,368
20150226,12350,12355,12280,12345,12280,12300,12310,-55,-45,16,366
20150227,12300,12310,12370,12405,12285,12290,12320,-20,10,116,370
20150302,12290,12320,12195,12260,12195,12260,12205,-60,-115,26,364
20150303,12260,12205,12195,12215,12195,12215,12200,10,-5,14,374
20150304,12215,12200,12170,12240,12170,12230,12200,30,0,66,378
20150305,12230,12200,12230,12280,12210,12210,12220,10,20,20,380
20150306,12210,12220,12285,12305,12225,12235,12250,15,30,50,378
20150309,12235,12250,12215,12290,12215,12260,12250,10,0,18,382
20150310,12260,12250,12295,12300,12290,12300,12295,50,45,42,404
20150311,12300,12295,12105,12305,12100,12280,12260,-15,-35,70,420
20150312,12280,12260,12255,12345,12255,12345,12300,85,40,4,420
20150313,12345,12300,12380,12380,12315,12375,12360,75,60,14,418
20150316,12375,12360,12230,12300,12225,12285,12275,-75,-85,16,420
20150317,12285,12275,12225,12230,12180,12180,12210,-95,-65,50,462
20150318,12180,12210,12160,12170,12145,12160,12160,-50,-50,20,470
20150319,12160,12160,12110,12160,12110,12160,12155,0,-5,24,470
20150320,12160,12155,12100,12145,12100,12145,12130,-10,-25,16,470
20150323,12145,12130,12210,12345,12210,12330,12265,200,135,58,470
20150324,12330,12265,12430,12470,12415,12470,12445,205,180,12,472
20150325,12470,12445,,,,12450,12450,5,5,0,472
20150326,12450,12450,12445,12445,12445,12445,12445,-5,-5,10,468
20150327,12445,12445,12420,12420,12420,12420,12420,-25,-25,4,468
20150330,12420,12420,12390,12405,12390,12405,12400,-15,-20,8,468
20150331,12405,12400,12380,12425,12350,12350,12405,-50,5,16,468
20150401,12350,12405,12285,12430,12285,12430,12355,25,-50,34,468
20150402,12430,12355,12420,12465,12420,12460,12435,105,80,16,470
20150403,12460,12435,12455,12645,12455,12640,12555,205,120,32,470
20150407,12640,12555,12660,12715,12660,12690,12690,135,135,32,478
20150408,12690,12690,12755,12755,12625,12695,12670,5,-20,78,478
20150409,12695,12670,12695,12780,12695,12780,12755,110,85,56,470
20150410,12780,12755,12970,13265,12970,13265,13180,510,425,286,466
20150413,13265,13180,13535,13550,13300,13360,13500,180,320,424,426
20150414,13360,13500,13365,13365,12960,12985,13090,-515,-410,88,428
20150415,12985,13090,13165,13250,13155,13235,13220,145,130,112,446
20150416,13235,13220,13360,13400,13205,13350,13330,130,110,42,448
20150417,13350,13330,13500,13730,13460,13730,13600,400,270,56,442
20150420,13730,13600,13730,13730,13490,13580,13610,-20,10,38,428
20150421,13580,13610,13520,13545,13480,13480,13515,-130,-95,12,422
20150422,13480,13515,13625,13770,13625,13770,13700,255,185,86,432
20150423,13770,13700,13655,13735,13430,13505,13575,-195,-125,78,446
20150424,13505,13575,13500,13500,13500,13500,13500,-75,-75,2,448
20150427,13500,13500,13685,13845,13670,13800,13765,300,265,336,580
20150428,13800,13765,13805,13865,13685,13735,13745,-30,-20,266,644
20150429,13735,13745,13755,13805,13680,13750,13715,5,-30,104,654
20150430,13750,13715,13765,13865,13750,13800,13780,85,65,164,732
20150504,13800,13780,13890,13890,13785,13870,13855,90,75,168,806
20150505,13870,13855,13880,13880,13795,13795,13830,-60,-25,20,808
20150506,13795,13830,13925,14030,13925,13935,13965,105,135,96,760
20150507,13935,13965,13870,13870,13490,13510,13600,-455,-365,34,754
20150508,13510,13600,13590,13590,13460,13560,13550,-40,-50,22,750
20150511,13560,13550,13600,13600,13515,13520,13530,-30,-20,24,752
20150512,13520,13530,13355,13355,13350,13350,13350,-180,-180,12,756
20150513,13350,13350,13450,13650,13425,13650,13490,300,140,40,766
20150514,13650,13490,13565,13585,13490,13560,13545,70,55,16,762
20150515,13560,13545,13485,13485,13355,13370,13380,-175,-165,40,784
20150518,13370,13380,13335,13440,13335,13440,13410,60,30,20,776
20150519,13440,13410,13420,13420,13350,13350,13410,-60,0,76,790
20150520,13350,13410,13275,13275,13165,13165,13200,-245,-210,88,822
20150521,13165,13200,13135,13315,13125,13315,13240,115,40,132,894
20150522,13315,13240,13445,13450,13415,13415,13445,175,205,40,898
20150525,13415,13445,13220,13275,13205,13275,13225,-170,-220,134,1024
20150526,13275,13225,13310,13445,13225,13225,13295,0,70,86,1074
20150527,13225,13295,13200,13270,13185,13230,13225,-65,-70,452,1406
20150528,13230,13225,13200,13300,13200,13280,13285,55,60,180,1496
20150529,13280,13285,13310,13370,13295,13370,13340,85,55,176,1508
20150601,13370,13340,13275,13275,13185,13215,13235,-125,-105,8,1506
20150602,13215,13235,13200,13200,13155,13180,13165,-55,-70,194,1694
20150603,13180,13165,13225,13225,13100,13100,13155,-65,-10,280,1846
20150604,13100,13155,13135,13250,13090,13225,13160,70,5,642,2100
20150605,13225,13160,13200,13200,13120,13120,13145,-40,-15,356,2176
20150608,13120,13145,13090,13165,13060,13090,13095,-55,-50,154,2276
20150609,13090,13095,13200,13250,13140,13150,13185,55,90,104,2324
20150610,13150,13185,13190,13220,13170,13195,13195,10,10,212,2458
20150611,13195,13195,13225,13270,13140,13140,13205,-55,10,146,2492
20150612,13140,13205,13120,13125,12790,12790,12920,-415,-285,884,3030
20150615,12790,12920,12820,12840,12725,12725,12780,-195,-140,730,3418
20150616,12725,12780,12700,12705,12600,12655,12650,-125,-130,678,3798
20150617,12655,12650,12650,12650,12580,12590,12615,-60,-35,826,4286
20150618,12590,12615,12630,12780,12580,12765,12665,150,50,656,4630
20150619,12765,12665,12825,12825,12780,12790,12790,125,125,400,4458
20150623,12790,12790,12810,12920,12780,12910,12860,120,70,396,4600
20150624,12910,12860,12920,13070,12875,13070,13000,210,140,838,4780
20150625,13070,13000,13025,13040,12915,12990,12990,-10,-10,744,5254
20150626,12990,12990,12915,12950,12840,12890,12890,-100,-100,464,5102
20150629,12890,12890,12885,12885,12620,12640,12825,-250,-65,1378,5712
20150630,12640,12825,12615,12810,12525,12610,12620,-215,-205,466,5730
20150701,12610,12620,12515,12640,12115,12590,12515,-30,-105,866,5786
20150702,12590,12515,12700,12915,12605,12915,12785,400,270,1068,5952
20150703,12915,12785,12915,12935,12720,12800,12850,15,65,1048,6360
20150706,12800,12850,12730,12735,12545,12560,12600,-290,-250,1152,6892
20150707,12560,12600,12580,12700,12515,12515,12615,-85,15,1292,7342
20150708,12515,12615,12445,12515,12110,12225,12305,-390,-310,3926,9004
20150709,12225,12305,12250,12795,12250,12785,12675,480,370,2102,9158
20150710,12785,12675,12980,13080,12725,12830,12910,155,235,1754,9420
20150713,12830,12910,12855,12880,12655,12730,12745,-180,-165,920,9754
20150714,12730,12745,12895,13085,12895,13025,13020,280,275,1858,10056
20150715,13025,13020,13050,13070,12940,13020,13000,0,-20,2364,11052
20150716,13020,13000,13120,13120,12870,13045,12970,45,-30,1904,11796
20150717,13045,12970,12900,13010,12900,12940,12950,-30,-20,1258,12422
20150720,12940,12950,12930,13020,12880,12940,12930,-10,-20,1460,13096
20150721,12940,12930,12920,13010,12905,12970,12960,40,30,1896,13948
20150722,12970,12960,12915,12940,12700,12700,12780,-260,-180,2634,14818
20150723,12700,12780,12680,12850,12605,12815,12735,35,-45,2126,15378
20150724,12815,12735,12735,12800,12535,12620,12655,-115,-80,1976,16194
20150727,12620,12655,12600,12735,12595,12680,12675,25,20,1864,16182
20150728,12680,12675,12625,12695,12590,12680,12640,5,-35,2524,16726
20150729,12680,12640,12700,13085,12700,13085,12955,445,315,3056,16596
20150730,13085,12955,13050,13170,12975,13100,13055,145,100,3782,16796
20150731,13100,13055,13070,13095,12930,13000,13015,-55,-40,2102,16894
20150803,13000,13015,12995,13070,12830,12850,12970,-165,-45,3454,17236
20150804,12850,12970,12825,12880,12650,12855,12760,-115,-210,5074,17350
20150805,12855,12760,12975,13015,12900,12920,12930,160,170,4262,17806
20150806,12920,12930,12890,12930,12820,12910,12875,-20,-55,2720,17974
20150807,12910,12875,12830,12870,12760,12800,12815,-75,-60,4470,18162
20150810,12800,12815,12765,13110,12725,13060,12915,245,100,5364,18396
20150811,13060,12915,13055,13320,13050,13250,13165,335,250,7508,18558
20150812,13250,13165,13180,13285,13100,13255,13185,90,20,9050,18230
20150813,13255,13185,13295,13520,13120,13430,13360,245,175,9678,18708
20150814,13430,13360,13310,13395,13180,13215,13295,-145,-65,4536,18250
20150817,13215,13295,13290,13395,13170,13375,13280,80,-15,5344,18664
20150818,13375,13280,13310,13380,13190,13205,13315,-75,35,6028,18150
20150819,13205,13315,13160,13300,13025,13295,13145,-20,-170,5774,17584
20150820,13295,13145,13300,13395,13260,13370,13330,225,185,5446,17940
20150821,13370,13330,13475,13860,13070,13205,13370,-125,40,6640,17564
20150824,13205,13370,13210,13480,13035,13050,13130,-320,-240,6948,17742
20150825,13050,13130,12980,13245,12725,13140,13080,10,-50,8852,17560
20150826,13140,13080,13240,13425,13170,13205,13300,125,220,7226,17318
20150827,13205,13300,13145,13375,13115,13355,13255,55,-45,6356,16684
20150828,13355,13255,13360,13590,13320,13415,13440,160,185,7368,16254
20150831,13415,13440,13520,13520,13300,13345,13370,-95,-70,4302,16028
20150901,13345,13370,13325,13415,13200,13330,13320,-40,-50,3040,15268
20150902,13330,13320,13370,13490,13300,13490,13400,170,80,2590,14598
20150907,13490,13400,13350,13555,13350,13475,13480,75,80,2910,13920
20150908,13475,13480,13440,13465,13205,13270,13325,-210,-155,3604,12600
20150909,13270,13325,13340,13505,13340,13415,13450,90,125,2042,11802
20150910,13415,13450,13425,13510,13405,13510,13455,60,5,1632,11078
20150911,13510,13455,13530,13550,13440,13485,13495,30,40,1150,10826
20150914,13485,13495,13395,13460,13355,13365,13390,-130,-105,1258,10520
20150915,13365,13390,13300,13440,13270,13365,13370,-25,-20,1596,10004
20150916,13365,13370,13900,13900,13380,13410,13435,40,65,856,9734
20150917,13410,13435,13435,13480,13410,13450,13440,15,5,748,9494
20150918,13450,13440,13430,13470,13410,13455,13440,15,0,686,9216
20150921,13455,13440,13350,13410,13205,13295,13305,-145,-135,3032,8344
20150922,13295,13305,13295,13350,13225,13245,13250,-60,-55,1576,7380
20150923,13245,13250,13185,13270,13165,13265,13215,15,-35,1466,6466
20150924,13265,13215,13330,13400,13195,13400,13310,185,95,1384,5612
20150925,13400,13310,13310,13420,13310,13400,13365,90,55,810,5010
20150928,13400,13365,13395,13395,13200,13200,13275,-165,-90,970,4422
20150929,13200,13275,13070,13270,13070,13270,13160,-5,-115,1600,3518
20150930,13270,13160,13340,13460,13310,13450,13390,290,230,1676,2570
20151008,13450,13390,13540,13545,13470,13470,13500,80,110,170,2490
20151009,13470,13500,13505,13650,13505,13535,13545,35,45,1280,1430
20151012,13535,13545,13680,13720,13630,13685,13675,140,130,700,830
20151013,13685,13675,13550,13580,13550,13560,13560,-115,-115,180,730
20151014,13560,13560,13560,13600,13505,13505,13550,-55,-10,170,560
20151015,13505,13550,13550,13560,13420,13420,13490,-130,-60,210,590
pb1511,20150105,12710,12705,,,,12730,12730,25,25,0,12
20150106,12730,12730,,,,12730,12730,0,0,0,12
20150107,12730,12730,12790,12790,12730,12730,12760,0,30,4,14
20150108,12730,12760,12790,12790,12790,12790,12790,30,30,2,14
20150109,12790,12790,12770,12775,12770,12775,12770,-15,-20,4,12
20150112,12775,12770,12725,12725,12625,12625,12655,-145,-115,6,16
20150113,12625,12655,12730,12730,12575,12575,12640,-80,-15,8,14
20150114,12575,12640,12465,12465,12195,12195,12280,-445,-360,10,20
20150115,12195,12280,12180,12240,12135,12240,12165,-40,-115,20,30
20150116,12240,12165,12515,12515,12515,12515,12515,350,350,2,28
20150119,12515,12515,12410,12690,12410,12535,12585,20,70,22,20
20150120,12535,12585,12595,12595,12595,12595,12595,10,10,2,22
20150121,12595,12595,,,,12640,12640,45,45,0,22
20150122,12640,12640,12655,12885,12655,12885,12805,245,165,14,22
20150123,12885,12805,12810,12810,12710,12710,12780,-95,-25,10,20
20150126,12710,12780,,,,12780,12780,0,0,0,20
20150127,12780,12780,12655,12655,12605,12605,12615,-175,-165,16,20
20150128,12605,12615,12605,12605,12605,12605,12605,-10,-10,2,20
20150129,12605,12605,,,,12605,12605,0,0,0,20
20150130,12605,12605,,,,12575,12575,-30,-30,0,20
20150202,12575,12575,,,,12575,12575,0,0,0,20
20150203,12575,12575,,,,12575,12575,0,0,0,20
20150204,12575,12575,,,,12575,12575,0,0,0,20
20150205,12575,12575,,,,12545,12545,-30,-30,0,20
20150206,12545,12545,,,,12535,12535,-10,-10,0,20
20150209,12535,12535,12730,12730,12730,12730,12730,195,195,2,22
20150210,12730,12730,12645,12645,12640,12640,12640,-90,-90,6,22
20150211,12640,12640,,,,12545,12545,-95,-95,0,22
20150212,12545,12545,,,,12515,12515,-30,-30,0,22
20150213,12515,12515,12390,12615,12390,12615,12565,100,50,10,20
20150216,12615,12565,,,,12565,12565,0,0,0,20
20150217,12565,12565,12560,12560,12560,12560,12560,-5,-5,4,24
20150225,12560,12560,12315,12340,12315,12340,12320,-220,-240,6,26
20150226,12340,12320,12310,12400,12310,12400,12355,80,35,4,24
20150227,12400,12355,,,,12355,12355,0,0,0,24
20150302,12355,12355,,,,12355,12355,0,0,0,24
20150303,12355,12355,,,,12350,12350,-5,-5,0,24
20150304,12350,12350,12235,12235,12235,12235,12235,-115,-115,2,22
20150305,12235,12235,,,,12240,12240,5,5,0,22
20150306,12240,12240,12295,12295,12270,12270,12280,30,40,8,22
20150309,12270,12280,12285,12285,12285,12285,12285,5,5,2,24
20150310,12285,12285,,,,12285,12285,0,0,0,24
20150311,12285,12285,,,,12250,12250,-35,-35,0,24
20150312,12250,12250,,,,12250,12250,0,0,0,24
20150313,12250,12250,,,,12310,12310,60,60,0,24
20150316,12310,12310,,,,12310,12310,0,0,0,24
20150317,12310,12310,,,,12250,12250,-60,-60,0,24
20150318,12250,12250,,,,12130,12130,-120,-120,0,24
20150319,12130,12130,,,,12130,12130,0,0,0,24
20150320,12130,12130,12135,12135,12135,12135,12135,5,5,4,24
20150323,12135,12135,,,,12270,12270,135,135,0,24
20150324,12270,12270,12310,12310,12310,12310,12310,40,40,2,24
20150325,12310,12310,,,,12380,12380,70,70,0,24
20150326,12380,12380,,,,12375,12375,-5,-5,0,24
20150327,12375,12375,12425,12425,12425,12425,12425,50,50,2,26
20150330,12425,12425,12390,12390,12390,12390,12390,-35,-35,2,26
20150331,12390,12390,,,,12395,12395,5,5,0,26
20150401,12395,12395,,,,12395,12395,0,0,0,26
20150402,12395,12395,,,,12475,12475,80,80,0,26
20150403,12475,12475,12510,12510,12510,12510,12510,35,35,2,26
20150407,12510,12510,,,,12515,12515,5,5,0,26
20150408,12515,12515,,,,12495,12495,-20,-20,0,26
20150409,12495,12495,,,,12735,12735,240,240,0,26
20150410,12735,12735,13165,13165,13165,13165,13165,430,430,2,24
20150413,13165,13165,13435,13465,13435,13460,13450,295,285,6,18
20150414,13460,13450,13055,13055,13055,13055,13055,-395,-395,2,20
20150415,13055,13055,13095,13170,13095,13170,13130,115,75,4,16
20150416,13170,13130,13295,13295,13290,13290,13290,160,160,6,14
20150417,13290,13290,,,,13555,13555,265,265,0,14
20150420,13555,13555,,,,13565,13565,10,10,0,14
20150421,13565,13565,,,,13470,13470,-95,-95,0,14
20150422,13470,13470,,,,13650,13650,180,180,0,14
20150423,13650,13650,,,,13525,13525,-125,-125,0,14
20150424,13525,13525,13495,13495,13495,13495,13495,-30,-30,2,12
20150427,13495,13495,13825,13825,13825,13825,13825,330,330,2,12
20150428,13825,13825,13765,13765,13765,13765,13765,-60,-60,6,12
20150429,13765,13765,,,,13735,13735,-30,-30,0,12
20150430,13735,13735,,,,13800,13800,65,65,0,12
20150504,13800,13800,,,,13875,13875,75,75,0,12
20150505,13875,13875,,,,13850,13850,-25,-25,0,12
20150506,13850,13850,,,,13985,13985,135,135,0,12
20150507,13985,13985,,,,13600,13600,-385,-385,0,12
20150508,13600,13600,13605,13605,13605,13605,13605,5,5,2,14
20150511,13605,13605,,,,13585,13585,-20,-20,0,14
20150512,13585,13585,,,,13450,13450,-135,-135,0,14
20150513,13450,13450,,,,13590,13590,140,140,0,14
20150514,13590,13590,,,,13645,13645,55,55,0,14
20150515,13645,13645,,,,13450,13450,-195,-195,0,14
20150518,13450,13450,13355,13665,13355,13665,13510,215,60,4,16
20150519,13665,13510,13510,13510,13510,13510,13510,0,0,14,28
20150520,13510,13510,,,,13300,13300,-210,-210,0,28
20150521,13300,13300,,,,13340,13340,40,40,0,28
20150522,13340,13340,,,,13545,13545,205,205,0,28
20150525,13545,13545,,,,13325,13325,-220,-220,0,28
20150526,13325,13325,13380,13380,13320,13320,13355,-5,30,20,44
20150527,13320,13355,13280,13280,13230,13235,13250,-120,-105,22,48
20150528,13235,13250,,,,13310,13310,60,60,0,48
20150529,13310,13310,13320,13380,13310,13340,13340,30,30,22,44
20150601,13340,13340,13320,13320,13220,13220,13270,-120,-70,4,42
20150602,13220,13270,13200,13200,13200,13200,13200,-70,-70,2,40
20150603,13200,13200,13265,13265,13200,13200,13240,0,40,16,56
20150604,13200,13240,,,,13245,13245,5,5,0,56
20150605,13245,13245,13365,13365,13175,13175,13270,-70,25,4,56
20150608,13175,13270,13205,13210,13205,13210,13205,-60,-65,4,58
20150609,13210,13205,13170,13200,13155,13200,13165,-5,-40,22,62
20150610,13200,13165,13160,13285,13160,13285,13220,120,55,4,62
20150611,13285,13220,13320,13320,13195,13195,13240,-25,20,8,68
20150612,13195,13240,13095,13095,12940,12940,13005,-300,-235,10,72
20150615,12940,13005,12820,12825,12770,12780,12790,-225,-215,50,104
20150616,12780,12790,12650,12685,12630,12660,12665,-130,-125,96,176
20150617,12660,12665,12670,12670,12590,12590,12630,-75,-35,42,214
20150618,12590,12630,12600,12765,12590,12760,12700,130,70,96,284
20150619,12760,12700,12825,12825,12785,12785,12805,85,105,18,296
20150623,12785,12805,12750,12910,12750,12905,12860,100,55,50,336
20150624,12905,12860,12900,13090,12900,13090,13055,230,195,200,508
20150625,13090,13055,13155,13155,12990,13015,13015,-40,-40,202,690
20150626,13015,13015,12960,12960,12880,12880,12920,-135,-95,36,722
20150629,12880,12920,12860,12865,12650,12650,12805,-270,-115,76,758
20150630,12650,12805,12605,12670,12490,12630,12600,-175,-205,160,836
20150701,12630,12600,12610,12610,12400,12610,12495,10,-105,116,888
20150702,12610,12495,12680,12930,12680,12865,12750,370,255,190,950
20150703,12865,12750,12775,12785,12740,12740,12765,-10,15,16,952
20150706,12740,12765,12655,12660,12545,12600,12585,-165,-180,56,964
20150707,12600,12585,12535,12660,12520,12530,12600,-55,15,48,980
20150708,12530,12600,12335,12435,12095,12100,12250,-500,-350,296,1066
20150709,12100,12250,12545,12740,12360,12710,12675,460,425,178,1112
20150710,12710,12675,12950,13000,12950,13000,12975,325,300,4,1114
20150713,13000,12975,12900,12900,12650,12685,12695,-290,-280,124,1210
20150714,12685,12695,12875,13000,12850,12915,12920,220,225,162,1140
20150715,12915,12920,12900,12900,12900,12900,12900,-20,-20,2,1140
20150716,12900,12900,12900,12900,12900,12900,12900,0,0,2,1140
20150717,12900,12900,12900,12940,12855,12860,12880,-40,-20,68,1192
20150720,12860,12880,12900,12900,12800,12800,12810,-80,-70,38,1204
20150721,12800,12810,12900,12900,12820,12850,12840,40,30,142,1200
20150722,12850,12840,12800,12800,12630,12630,12710,-210,-130,236,1216
20150723,12630,12710,12600,12750,12570,12750,12640,40,-70,270,1320
20150724,12750,12640,12695,12695,12500,12580,12580,-60,-60,420,1496
20150727,12580,12580,12575,12650,12540,12540,12575,-40,-5,652,1654
20150728,12540,12575,12555,12580,12500,12560,12540,-15,-35,846,2138
20150729,12560,12540,12650,12960,12650,12955,12845,415,305,1586,2716
20150730,12955,12845,12890,13035,12825,12945,12890,100,45,1718,3752
20150731,12945,12890,12860,12920,12860,12870,12875,-20,-15,892,4206
20150803,12870,12875,12915,12945,12720,12725,12825,-150,-50,1540,4964
20150804,12725,12825,12790,12790,12525,12735,12650,-90,-175,1876,5480
20150805,12735,12650,12850,12860,12760,12800,12790,150,140,1110,5930
20150806,12800,12790,12800,12800,12700,12780,12750,-10,-40,1430,6446
20150807,12780,12750,12735,12735,12610,12650,12665,-100,-85,1218,6828
20150810,12650,12665,12630,12920,12580,12890,12790,225,125,1694,7452
20150811,12890,12790,12895,13090,12890,13085,12985,295,195,3792,9120
20150812,13085,12985,13000,13150,12960,13130,13060,145,75,2088,9654
20150813,13130,13060,13190,13365,13035,13270,13205,210,145,1868,10032
20150814,13270,13205,13230,13235,13045,13050,13145,-155,-60,1684,10580
20150817,13050,13145,13110,13250,13030,13225,13125,80,-20,1284,10968
20150818,13225,13125,13165,13225,13050,13050,13170,-75,45,2246,11946
20150819,13050,13170,12995,13170,12895,13140,13010,-30,-160,3342,12254
20150820,13140,13010,13150,13245,13110,13230,13170,220,160,1922,12476
20150821,13230,13170,13350,13390,13040,13045,13215,-125,45,2086,12528
20150824,13045,13215,13040,13180,12865,12885,12970,-330,-245,3140,12850
20150825,12885,12970,12600,13080,12600,13005,12930,35,-40,3820,13582
20150826,13005,12930,13100,13250,13025,13075,13145,145,215,2566,13650
20150827,13075,13145,12990,13265,12990,13215,13125,70,-20,3082,14312
20150828,13215,13125,13225,13450,13225,13320,13320,195,195,4276,14624
20150831,13320,13320,13355,13420,13245,13285,13310,-35,-10,3126,15096
20150901,13285,13310,13225,13330,13145,13225,13235,-85,-75,2274,15080
20150902,13225,13235,13240,13385,13200,13385,13265,150,30,2338,15006
20150907,13385,13265,13230,13425,13225,13310,13340,45,75,3138,14884
20150908,13310,13340,13315,13355,13070,13130,13195,-210,-145,5658,15048
20150909,13130,13195,13170,13380,13170,13320,13325,125,130,7502,15040
20150910,13320,13325,13320,13430,13280,13410,13355,85,30,4952,15382
20150911,13410,13355,13410,13465,13280,13395,13395,40,40,5088,15090
20150914,13395,13395,13320,13420,13220,13240,13285,-155,-110,3756,14714
20150915,13240,13285,13175,13300,13145,13205,13230,-80,-55,5506,13470
20150916,13205,13230,13210,13375,13210,13320,13310,90,80,3944,12866
20150917,13320,13310,13330,13385,13290,13335,13345,25,35,3274,13122
20150918,13335,13345,13300,13360,13260,13320,13325,-25,-20,2394,13312
20150921,13320,13325,13245,13305,12995,13145,13170,-180,-155,8662,13254
20150922,13145,13170,13190,13245,13095,13135,13160,-35,-10,5824,13126
20150923,13135,13160,13060,13200,13000,13185,13110,25,-50,7170,12882
20150924,13185,13110,13195,13300,13145,13285,13215,175,105,5962,13130
20150925,13285,13215,13245,13315,13220,13290,13270,75,55,5170,13346
20150928,13290,13270,13270,13290,13115,13120,13205,-150,-65,3444,12752
20150929,13120,13205,12990,13170,12940,13135,13060,-70,-145,6802,12776
20150930,13135,13060,13200,13835,13190,13585,13330,525,270,10904,12498
20151008,13585,13330,13590,13590,13360,13360,13450,30,120,3888,11694
20151009,13360,13450,13345,13690,13115,13550,13500,100,50,6108,10992
20151012,13550,13500,13770,13945,13530,13675,13660,175,160,5288,10436
20151013,13675,13660,13690,13780,13425,13585,13580,-75,-80,2196,9860
20151014,13585,13580,13525,13615,13520,13560,13570,-20,-10,1864,8998
20151015,13560,13570,13600,13635,13480,13490,13565,-80,-5,1038,8708
20151016,13490,13565,13500,13575,13410,13410,13500,-155,-65,898,8368
20151019,13410,13500,13475,13525,13420,13475,13480,-25,-20,734,8110
20151020,13475,13480,13460,13585,13430,13490,13480,10,0,790,7740
20151021,13490,13480,13520,13520,13265,13265,13485,-215,5,2912,6318
20151022,13265,13485,13310,13425,13155,13315,13300,-170,-185,2052,5030
20151023,13315,13300,13440,13470,13270,13365,13345,65,45,1052,4390
20151026,13365,13345,13375,13375,13260,13280,13320,-65,-25,654,4128
20151027,13280,13320,13280,13400,13280,13390,13340,70,20,1168,3532
20151028,13390,13340,13380,13380,13315,13315,13330,-25,-10,748,3018
20151029,13315,13330,13370,13500,13340,13455,13395,125,65,742,2584
20151030,13455,13395,13400,13415,13300,13320,13345,-75,-50,626,2090
20151102,13320,13345,13240,13270,13220,13230,13240,-115,-105,580,1910
20151103,13230,13240,13145,13285,13145,13200,13240,-40,0,280,1840
20151104,13200,13240,13145,13210,13120,13205,13140,-35,-100,160,1750
20151105,13205,13140,13280,13285,13160,13175,13185,35,45,150,1730
20151106,13175,13185,13135,13180,13085,13100,13105,-85,-80,750,1730
20151109,13100,13105,13120,13200,13120,13150,13165,45,60,320,1730
20151110,13150,13165,13140,13145,13080,13120,13110,-45,-55,370,1670
20151111,13120,13110,13100,13210,12850,13000,12970,-110,-140,380,1670
20151112,13000,12970,13080,13080,12995,12995,13035,25,65,100,1620
20151113,12995,13035,12880,12895,12850,12870,12880,-165,-155,170,1450
20151116,12870,12880,12550,13010,12550,13000,12715,120,-165,160,1490
pb1512,20150105,12720,12720,12840,12840,12835,12835,12835,115,115,4,8
20150106,12835,12835,,,,12835,12835,0,0,0,8
20150107,12835,12835,,,,12865,12865,30,30,0,8
20150108,12865,12865,,,,12895,12895,30,30,0,8
20150109,12895,12895,,,,12875,12875,-20,-20,0,8
20150112,12875,12875,,,,12830,12830,-45,-45,0,8
20150113,12830,12830,12650,12685,12650,12685,12665,-145,-165,4,6
20150114,12685,12665,12505,12555,12275,12275,12400,-390,-265,8,10
20150115,12275,12400,12245,12345,12155,12330,12245,-70,-155,26,22
20150116,12330,12245,,,,12595,12595,350,350,0,22
20150119,12595,12595,12365,12520,12365,12520,12460,-75,-135,16,16
20150120,12520,12460,,,,12460,12460,0,0,0,16
20150121,12460,12460,,,,12505,12505,45,45,0,16
20150122,12505,12505,12720,12885,12720,12885,12805,380,300,8,16
20150123,12885,12805,12775,12775,12775,12775,12775,-30,-30,2,18
20150126,12775,12775,12605,12605,12605,12605,12605,-170,-170,2,18
20150127,12605,12605,12720,12720,12690,12690,12710,85,105,6,16
20150128,12690,12710,12640,12705,12640,12655,12675,-55,-35,14,22
20150129,12655,12675,,,,12705,12705,30,30,0,22
20150130,12705,12705,,,,12675,12675,-30,-30,0,22
20150202,12675,12675,,,,12735,12735,60,60,0,22
20150203,12735,12735,12650,12650,12650,12650,12650,-85,-85,4,24
20150204,12650,12650,,,,12700,12700,50,50,0,24
20150205,12700,12700,,,,12670,12670,-30,-30,0,24
20150206,12670,12670,,,,12660,12660,-10,-10,0,24
20150209,12660,12660,,,,12855,12855,195,195,0,24
20150210,12855,12855,,,,12765,12765,-90,-90,0,24
20150211,12765,12765,,,,12670,12670,-95,-95,0,24
20150212,12670,12670,,,,12545,12545,-125,-125,0,24
20150213,12545,12545,,,,12595,12595,50,50,0,24
20150216,12595,12595,,,,12705,12705,110,110,0,24
20150217,12705,12705,,,,12695,12695,-10,-10,0,24
20150225,12695,12695,,,,12455,12455,-240,-240,0,24
20150226,12455,12455,,,,12490,12490,35,35,0,24
20150227,12490,12490,12405,12440,12400,12400,12425,-90,-65,18,38
20150302,12400,12425,12310,12310,12310,12310,12310,-115,-115,2,40
20150303,12310,12310,,,,12305,12305,-5,-5,0,40
20150304,12305,12305,12295,12315,12295,12315,12295,10,-10,12,44
20150305,12315,12295,12370,12370,12370,12370,12370,75,75,4,44
20150306,12370,12370,12360,12360,12245,12245,12325,-125,-45,8,50
20150309,12245,12325,,,,12325,12325,0,0,0,50
20150310,12325,12325,,,,12325,12325,0,0,0,50
20150311,12325,12325,,,,12290,12290,-35,-35,0,50
20150312,12290,12290,,,,12290,12290,0,0,0,50
20150313,12290,12290,,,,12350,12350,60,60,0,50
20150316,12350,12350,,,,12350,12350,0,0,0,50
20150317,12350,12350,,,,12250,12250,-100,-100,0,50
20150318,12250,12250,,,,12200,12200,-50,-50,0,50
20150319,12200,12200,12070,12200,12070,12200,12180,0,-20,22,64
20150320,12200,12180,12140,12140,12140,12140,12140,-40,-40,2,64
20150323,12140,12140,12325,12360,12320,12320,12345,180,205,10,68
20150324,12320,12345,,,,12350,12350,5,5,0,68
20150325,12350,12350,12470,12470,12290,12450,12380,100,30,40,60
20150326,12450,12380,12490,12505,12425,12425,12470,45,90,26,52
20150327,12425,12470,12435,12435,12390,12410,12410,-60,-60,14,38
20150330,12410,12410,12365,12450,12365,12445,12390,35,-20,14,34
20150331,12445,12390,12460,12460,12370,12370,12405,-20,15,6,34
20150401,12370,12405,12300,12460,12300,12460,12405,55,0,6,36
20150402,12460,12405,12425,12480,12405,12460,12445,55,40,12,32
20150403,12460,12445,12540,12540,12540,12540,12540,95,95,2,32
20150407,12540,12540,12675,12675,12675,12675,12675,135,135,4,34
20150408,12675,12675,,,,12655,12655,-20,-20,0,34
20150409,12655,12655,,,,12670,12670,15,15,0,34
20150410,12670,12670,13090,13170,13090,13170,13130,500,460,12,26
20150413,13170,13130,13485,13485,13465,13470,13475,340,345,8,20
20150414,13470,13475,13300,13300,13055,13060,13105,-415,-370,10,24
20150415,13060,13105,13195,13280,13195,13280,13225,175,120,6,24
20150416,13280,13225,13385,13405,13290,13405,13340,180,115,8,28
20150417,13405,13340,13580,13580,13580,13580,13580,240,240,4,26
20150420,13580,13580,13750,13750,13750,13750,13750,170,170,2,28
20150421,13750,13750,,,,13655,13655,-95,-95,0,28
20150422,13655,13655,,,,13840,13840,185,185,0,28
20150423,13840,13840,,,,13715,13715,-125,-125,0,28
20150424,13715,13715,13535,13590,13535,13590,13550,-125,-165,6,28
20150427,13590,13550,13800,13800,13800,13800,13800,250,250,2,28
20150428,13800,13800,,,,13740,13740,-60,-60,0,28
20150429,13740,13740,,,,13710,13710,-30,-30,0,28
20150430,13710,13710,,,,13775,13775,65,65,0,28
20150504,13775,13775,,,,13850,13850,75,75,0,28
20150505,13850,13850,,,,13825,13825,-25,-25,0,28
20150506,13825,13825,13980,14030,13980,14030,13990,205,165,200,54
20150507,14030,13990,13700,13780,13680,13780,13705,-210,-285,16,40
20150508,13780,13705,13630,13630,13630,13630,13630,-75,-75,2,40
20150511,13630,13630,,,,13610,13610,-20,-20,0,40
20150512,13610,13610,13515,13515,13405,13490,13485,-120,-125,10,44
20150513,13490,13485,,,,13625,13625,140,140,0,44
20150514,13625,13625,,,,13680,13680,55,55,0,44
20150515,13680,13680,13445,13445,13445,13445,13445,-235,-235,2,42
20150518,13445,13445,13400,13400,13400,13400,13400,-45,-45,2,42
20150519,13400,13400,,,,13400,13400,0,0,0,42
20150520,13400,13400,,,,13190,13190,-210,-210,0,42
20150521,13190,13190,13275,13275,13275,13275,13275,85,85,4,46
20150522,13275,13275,13455,13460,13290,13440,13365,165,90,58,48
20150525,13440,13365,,,,13365,13365,0,0,0,48
20150526,13365,13365,,,,13395,13395,30,30,0,48
20150527,13395,13395,13435,13610,13275,13340,13420,-55,25,58,52
20150528,13340,13420,,,,13380,13380,-40,-40,0,52
20150529,13380,13380,13370,13410,13370,13410,13380,30,0,8,50
20150601,13410,13380,,,,13305,13305,-75,-75,0,50
20150602,13305,13305,,,,13230,13230,-75,-75,0,50
20150603,13230,13230,,,,13230,13230,0,0,0,50
20150604,13230,13230,,,,13230,13230,0,0,0,50
20150605,13230,13230,,,,13250,13250,20,20,0,50
20150608,13250,13250,13210,13210,13210,13210,13210,-40,-40,2,50
20150609,13210,13210,,,,13170,13170,-40,-40,0,50
20150610,13170,13170,13295,13295,13210,13225,13240,55,70,8,48
20150611,13225,13240,,,,13240,13240,0,0,0,48
20150612,13240,13240,12990,12990,12850,12850,12895,-390,-345,8,44
20150615,12850,12895,12845,12845,12615,12755,12760,-140,-135,52,66
20150616,12755,12760,12650,12705,12650,12705,12685,-55,-75,8,72
20150617,12705,12685,12640,12645,12640,12640,12640,-45,-45,16,86
20150618,12640,12640,12605,12700,12605,12700,12615,60,-25,14,88
20150619,12700,12615,,,,12765,12765,150,150,0,88
20150623,12765,12765,12870,12920,12870,12920,12895,155,130,20,108
20150624,12920,12895,12980,12980,12980,12980,12980,85,85,4,112
20150625,12980,12980,13055,13060,13020,13030,13035,50,55,42,150
20150626,13030,13035,,,,12940,12940,-95,-95,0,150
20150629,12940,12940,,,,12825,12825,-115,-115,0,150
20150630,12825,12825,12700,12700,12700,12700,12700,-125,-125,66,216
20150701,12700,12700,12480,12600,12480,12600,12580,-100,-120,102,302
20150702,12600,12580,,,,12840,12840,260,260,0,302
20150703,12840,12840,12870,12870,12870,12870,12870,30,30,6,302
20150706,12870,12870,,,,12690,12690,-180,-180,0,302
20150707,12690,12690,12545,12615,12545,12550,12560,-140,-130,12,302
20150708,12550,12560,12120,12595,12120,12120,12335,-440,-225,60,300
20150709,12120,12335,12380,12645,12350,12645,12560,310,225,14,304
20150710,12645,12560,,,,12740,12740,180,180,0,304
20150713,12740,12740,12655,12655,12655,12655,12655,-85,-85,4,304
20150714,12655,12655,13000,13000,13000,13000,13000,345,345,6,304
20150715,13000,13000,,,,12975,12975,-25,-25,0,304
20150716,12975,12975,,,,12975,12975,0,0,0,304
20150717,12975,12975,13045,13045,12800,12800,12920,-175,-55,4,304
20150720,12800,12920,13105,13105,13105,13105,13105,185,185,2,306
20150721,13105,13105,12965,12965,12655,12655,12810,-450,-295,4,304
20150722,12655,12810,,,,12810,12810,0,0,0,304
20150723,12810,12810,,,,12810,12810,0,0,0,304
20150724,12810,12810,,,,12810,12810,0,0,0,304
20150727,12810,12810,,,,12810,12810,0,0,0,304
20150728,12810,12810,,,,12810,12810,0,0,0,304
20150729,12810,12810,,,,12810,12810,0,0,0,304
20150730,12810,12810,12805,12945,12805,12870,12870,60,60,14,314
20150731,12870,12870,,,,12870,12870,0,0,0,314
20150803,12870,12870,12705,12705,12700,12700,12700,-170,-170,18,326
20150804,12700,12700,12440,12655,12440,12615,12640,-85,-60,44,352
20150805,12615,12640,12780,12780,12700,12700,12740,60,100,8,350
20150806,12700,12740,12700,12735,12615,12615,12700,-125,-40,38,352
20150807,12615,12700,12515,12515,12515,12515,12515,-185,-185,8,358
20150810,12515,12515,12520,12750,12500,12750,12555,235,40,478,472
20150811,12750,12555,12880,12955,12830,12955,12875,400,320,544,660
20150812,12955,12875,12825,13110,12825,13110,12940,235,65,204,740
20150813,13110,12940,13100,13190,12915,13190,13040,250,100,220,784
20150814,13190,13040,13070,13095,12900,12920,13055,-120,15,252,898
20150817,12920,13055,13000,13090,13000,13085,13080,30,25,96,942
20150818,13085,13080,13075,13170,13065,13080,13075,0,-5,124,1018
20150819,13080,13075,12865,12995,12865,12980,12955,-95,-120,182,1114
20150820,12980,12955,13030,13130,13005,13100,13090,145,135,62,1138
20150821,13100,13090,13215,13215,12990,12990,13135,-100,45,22,1140
20150824,12990,13135,12830,12875,12720,12720,12815,-415,-320,222,1186
20150825,12720,12815,12590,12930,12560,12820,12830,5,15,704,1426
20150826,12820,12830,12880,13200,12880,12975,12945,145,115,524,1602
20150827,12975,12945,12925,13075,12900,13070,12980,125,35,642,1908
20150828,13070,12980,13110,13250,13075,13170,13160,190,180,968,2310
20150831,13170,13160,13185,13285,13085,13200,13140,40,-20,584,2594
20150901,13200,13140,13035,13175,13015,13050,13075,-90,-65,782,3010
20150902,13050,13075,13065,13235,13065,13210,13115,135,40,620,3200
20150907,13210,13115,13195,13265,13150,13160,13190,45,75,1442,4044
20150908,13160,13190,13130,13190,12945,13015,13070,-175,-120,1950,4782
20150909,13015,13070,13170,13245,13120,13180,13195,110,125,1938,5268
20150910,13180,13195,13290,13305,13155,13255,13210,60,15,1040,5704
20150911,13255,13210,13235,13310,13210,13255,13255,45,45,1432,6238
20150914,13255,13255,13210,13230,13080,13100,13140,-155,-115,952,6510
20150915,13100,13140,13020,13150,13020,13080,13090,-60,-50,1888,7408
20150916,13080,13090,13125,13220,13105,13190,13160,100,70,1564,7962
20150917,13190,13160,13225,13255,13155,13195,13205,35,45,906,8196
20150918,13195,13205,13150,13235,13150,13195,13190,-10,-15,988,8466
20150921,13195,13190,13100,13195,12885,13085,13060,-105,-130,2520,9046
20150922,13085,13060,13060,13135,13000,13040,13050,-20,-10,1364,9686
20150923,13040,13050,13035,13105,12940,13100,13015,50,-35,1484,10110
20150924,13100,13015,13155,13200,13070,13195,13115,180,100,1830,10286
20150925,13195,13115,13140,13220,13120,13175,13170,60,55,1532,10360
20150928,13175,13170,13175,13175,13030,13030,13110,-140,-60,1406,10986
20150929,13030,13110,12810,13090,12805,13035,12985,-75,-125,1702,11532
20150930,13035,12985,13125,13500,13100,13465,13250,480,265,3142,11828
20151008,13465,13250,13420,13485,13320,13320,13375,70,125,2374,11982
20151009,13320,13375,13300,13630,13280,13550,13475,175,100,5476,13514
20151012,13550,13475,13650,13825,13515,13655,13650,180,175,6598,14394
20151013,13655,13650,13750,13750,13480,13590,13580,-60,-70,5548,14788
20151014,13590,13580,13540,13600,13515,13560,13565,-20,-15,3632,15294
20151015,13560,13565,13580,13665,13485,13490,13580,-75,15,4062,15368
20151016,13490,13580,13555,13575,13380,13390,13495,-190,-85,4662,15134
20151019,13390,13495,13425,13540,13410,13480,13475,-15,-20,3888,15590
20151020,13480,13475,13470,13880,13400,13435,13450,-40,-25,4004,15074
20151021,13435,13450,13460,13485,13180,13185,13380,-265,-70,5592,15562
20151022,13185,13380,13180,13350,13030,13215,13170,-165,-210,11872,14330
20151023,13215,13170,13290,13385,13125,13270,13235,100,65,7058,14192
20151026,13270,13235,13280,13340,13165,13235,13230,0,-5,5270,13968
20151027,13235,13230,13235,13350,13195,13330,13275,100,45,7110,13788
20151028,13330,13275,13305,13330,13220,13270,13270,-5,-5,3632,13934
20151029,13270,13270,13230,13410,13210,13365,13335,95,65,8370,14236
20151030,13365,13335,13300,13360,13170,13220,13270,-115,-65,6850,13518
20151102,13220,13270,13175,13205,13045,13055,13145,-215,-125,6690,12084
20151103,13055,13145,13060,13175,13040,13070,13105,-75,-40,2894,11480
20151104,13070,13105,13005,13240,12910,13205,13100,100,-5,3470,11336
20151105,13205,13100,13175,13290,13010,13025,13105,-75,5,3676,10906
20151106,13025,13105,12970,13060,12950,13035,12985,-70,-120,4148,10218
20151109,13035,12985,13035,13070,12955,12985,13005,0,20,2160,9772
20151110,12985,13005,13095,13095,12760,12870,12900,-135,-105,3998,9070
20151111,12870,12900,12895,12895,12680,12770,12785,-130,-115,3248,8702
20151112,12770,12785,12865,12895,12600,12790,12770,5,-15,4346,7526
20151113,12790,12770,12670,12860,12625,12725,12750,-45,-20,2638,6934
20151116,12725,12750,12700,12840,12600,12600,12745,-150,-5,1562,6642
20151117,12600,12745,12540,12640,12275,12450,12430,-295,-315,1484,6262
20151118,12450,12430,12470,12545,12155,12270,12275,-160,-155,1336,5956
20151119,12270,12275,12265,12265,12020,12135,12150,-140,-125,1554,5580
20151120,12135,12150,12035,12500,12000,12470,12220,320,70,1050,5216
20151123,12470,12220,12490,12565,12090,12185,12215,-35,-5,1178,4788
20151124,12185,12215,12130,12640,12110,12590,12480,375,265,918,4204
20151125,12590,12480,12600,12770,12520,12770,12625,290,145,748,3756
20151126,12770,12625,12635,13110,12600,12960,12950,335,325,930,3280
20151127,12960,12950,12980,12980,12705,12780,12805,-170,-145,416,3078
20151130,12780,12805,12835,12900,12605,12900,12755,95,-50,592,2690
pb1601,20150116,12245,12245,,,,12595,12595,350,350,0,0
20150119,12595,12595,,,,12460,12460,-135,-135,0,0
20150120,12460,12460,,,,12460,12460,0,0,0,0
20150121,12460,12460,,,,12505,12505,45,45,0,0
20150122,12505,12505,12640,12890,12640,12845,12800,340,295,8,4
20150123,12845,12800,,,,12770,12770,-30,-30,0,4
20150126,12770,12770,12640,12640,12640,12640,12640,-130,-130,2,6
20150127,12640,12640,12710,12710,12600,12645,12670,5,30,12,4
20150128,12645,12670,,,,12635,12635,-35,-35,0,4
20150129,12635,12635,,,,12665,12665,30,30,0,4
20150130,12665,12665,,,,12635,12635,-30,-30,0,4
20150202,12635,12635,,,,12695,12695,60,60,0,4
20150203,12695,12695,12670,12670,12670,12670,12670,-25,-25,2,4
20150204,12670,12670,,,,12720,12720,50,50,0,4
20150205,12720,12720,,,,12690,12690,-30,-30,0,4
20150206,12690,12690,,,,12680,12680,-10,-10,0,4
20150209,12680,12680,,,,12875,12875,195,195,0,4
20150210,12875,12875,,,,12785,12785,-90,-90,0,4
20150211,12785,12785,12645,12645,12645,12645,12645,-140,-140,2,4
20150212,12645,12645,,,,12540,12540,-105,-105,0,4
20150213,12540,12540,12695,12695,12695,12695,12695,155,155,2,4
20150216,12695,12695,,,,12805,12805,110,110,0,4
20150217,12805,12805,12655,12655,12645,12645,12650,-160,-155,14,16
20150225,12645,12650,,,,12410,12410,-240,-240,0,16
20150226,12410,12410,12425,12425,12380,12380,12390,-30,-20,8,10
20150227,12380,12390,12440,12440,12395,12395,12405,5,15,8,14
20150302,12395,12405,12325,12325,12305,12310,12310,-95,-95,10,18
20150303,12310,12310,12310,12380,12260,12380,12350,70,40,50,56
20150304,12380,12350,12360,12360,12320,12335,12345,-15,-5,86,120
20150305,12335,12345,12350,12350,12350,12350,12350,5,5,12,124
20150306,12350,12350,12325,12325,12200,12200,12245,-150,-105,98,116
20150309,12200,12245,12245,12250,12245,12250,12245,5,0,8,116
20150310,12250,12245,12290,12315,12290,12315,12300,70,55,10,118
20150311,12315,12300,,,,12300,12300,0,0,0,118
20150312,12300,12300,,,,12340,12340,40,40,0,118
20150313,12340,12340,,,,12340,12340,0,0,0,118
20150316,12340,12340,12210,12260,12100,12260,12170,-80,-170,172,198
20150317,12260,12170,12220,12230,12195,12195,12210,25,40,32,212
20150318,12195,12210,12190,12190,12190,12190,12190,-20,-20,2,210
20150319,12190,12190,,,,12170,12170,-20,-20,0,210
20150320,12170,12170,12105,12105,12105,12105,12105,-65,-65,4,210
20150323,12105,12105,12240,12330,12195,12300,12260,195,155,28,206
20150324,12300,12260,12400,12440,12400,12410,12415,150,155,10,206
20150325,12410,12415,12430,12435,12365,12420,12415,5,0,30,210
20150326,12420,12415,12465,12465,12465,12465,12465,50,50,2,210
20150327,12465,12465,,,,12465,12465,0,0,0,210
20150330,12465,12465,12390,12390,12390,12390,12390,-75,-75,2,210
20150331,12390,12390,12360,12360,12360,12360,12360,-30,-30,2,210
20150401,12360,12360,12310,12415,12305,12415,12350,55,-10,10,210
20150402,12415,12350,12405,12405,12405,12405,12405,55,55,10,206
20150403,12405,12405,12545,12545,12520,12520,12535,115,130,8,206
20150407,12520,12535,12665,12665,12665,12665,12665,130,130,2,208
20150408,12665,12665,12715,12715,12645,12645,12695,-20,30,8,210
20150409,12645,12695,12715,12735,12715,12735,12725,40,30,14,214
20150410,12735,12725,12855,13230,12855,13230,13110,505,385,18,216
20150413,13230,13110,13490,13560,13375,13375,13525,265,415,98,144
20150414,13375,13525,13345,13350,13050,13055,13325,-470,-200,150,106
20150415,13055,13325,13160,13215,13160,13215,13190,-110,-135,6,106
20150416,13215,13190,13295,13410,13295,13410,13355,220,165,10,104
20150417,13410,13355,13600,13720,13600,13720,13640,365,285,24,100
20150420,13720,13640,13615,13660,13615,13660,13635,20,-5,12,106
20150421,13660,13635,,,,13540,13540,-95,-95,0,106
20150422,13540,13540,13660,13730,13660,13730,13675,190,135,8,100
20150423,13730,13675,13580,13580,13580,13580,13580,-95,-95,10,100
20150424,13580,13580,13550,13600,13550,13600,13575,20,-5,4,100
20150427,13600,13575,,,,13575,13575,0,0,0,100
20150428,13575,13575,13860,13975,13860,13975,13925,400,350,26,86
20150429,13975,13925,13775,13885,13775,13885,13800,-40,-125,8,84
20150430,13885,13800,13885,13885,13885,13885,13885,85,85,4,80
20150504,13885,13885,13925,13950,13925,13950,13935,65,50,8,78
20150505,13950,13935,13900,13900,13900,13900,13900,-35,-35,2,78
20150506,13900,13900,14010,14050,14000,14050,14015,150,115,14,80
20150507,14050,14015,14145,14145,13700,13700,13920,-315,-95,8,82
20150508,13700,13920,13645,13645,13645,13645,13645,-275,-275,20,82
20150511,13645,13645,13710,13715,13640,13645,13680,0,35,34,76
20150512,13645,13680,13520,13520,13520,13520,13520,-160,-160,2,76
20150513,13520,13520,,,,13520,13520,0,0,0,76
20150514,13520,13520,13645,13660,13645,13660,13655,140,135,6,72
20150515,13660,13655,13440,13440,13440,13440,13440,-215,-215,2,72
20150518,13440,13440,13430,13585,13420,13585,13480,145,40,12,68
20150519,13585,13480,13485,13485,13470,13470,13475,-10,-5,22,48
20150520,13470,13475,,,,13475,13475,0,0,0,48
20150521,13475,13475,13220,13310,13220,13310,13235,-165,-240,10,54
20150522,13310,13235,13485,13485,13460,13460,13475,225,240,6,48
20150525,13460,13475,,,,13475,13475,0,0,0,48
20150526,13475,13475,,,,13505,13505,30,30,0,48
20150527,13505,13505,,,,13530,13530,25,25,0,48
20150528,13530,13530,,,,13590,13590,60,60,0,48
20150529,13590,13590,13360,13360,13360,13360,13360,-230,-230,2,48
20150601,13360,13360,13320,13415,13320,13410,13395,50,35,28,56
20150602,13410,13395,13255,13255,13230,13230,13250,-165,-145,22,42
20150603,13230,13250,,,,13290,13290,40,40,0,42
20150604,13290,13290,,,,13290,13290,0,0,0,42
20150605,13290,13290,,,,13290,13290,0,0,0,42
20150608,13290,13290,,,,13290,13290,0,0,0,42
20150609,13290,13290,13235,13235,13235,13235,13235,-55,-55,10,50
20150610,13235,13235,,,,13305,13305,70,70,0,50
20150611,13305,13305,,,,13325,13325,20,20,0,50
20150612,13325,13325,12880,12880,12880,12880,12880,-445,-445,2,52
20150615,12880,12880,12865,12865,12815,12815,12840,-65,-40,4,52
20150616,12815,12840,12775,12775,12680,12680,12725,-160,-115,4,50
20150617,12680,12725,,,,12720,12720,-5,-5,0,50
20150618,12720,12720,12670,12775,12670,12775,12740,55,20,6,52
20150619,12775,12740,12850,12850,12850,12850,12850,110,110,2,54
20150623,12850,12850,,,,12850,12850,0,0,0,54
20150624,12850,12850,13000,13120,13000,13120,13075,270,225,6,52
20150625,13120,13075,,,,13075,13075,0,0,0,52
20150626,13075,13075,,,,12980,12980,-95,-95,0,52
20150629,12980,12980,,,,12865,12865,-115,-115,0,52
20150630,12865,12865,12800,12800,12800,12800,12800,-65,-65,2,50
20150701,12800,12800,12600,12685,12600,12605,12600,-195,-200,96,136
20150702,12605,12600,,,,12860,12860,260,260,0,136
20150703,12860,12860,,,,12890,12890,30,30,0,136
20150706,12890,12890,12685,12685,12600,12600,12625,-290,-265,24,130
20150707,12600,12625,12435,12700,12435,12700,12565,75,-60,4,130
20150708,12700,12565,12115,12380,12115,12380,12245,-185,-320,4,128
20150709,12380,12245,12630,12630,12570,12570,12600,325,355,4,128
20150710,12570,12600,13010,13010,12700,12700,12855,100,255,8,128
20150713,12700,12855,,,,12855,12855,0,0,0,128
20150714,12855,12855,,,,13205,13205,350,350,0,128
20150715,13205,13205,13245,13245,12940,12940,13090,-265,-115,4,128
20150716,12940,13090,,,,13090,13090,0,0,0,128
20150717,13090,13090,12655,13210,12655,12935,12930,-155,-160,24,132
20150720,12935,12930,12890,12890,12885,12885,12885,-45,-45,8,134
20150721,12885,12885,12900,12900,12900,12900,12900,15,15,16,150
20150722,12900,12900,12625,12625,12625,12625,12625,-275,-275,4,152
20150723,12625,12625,12675,12675,12570,12570,12620,-55,-5,4,152
20150724,12570,12620,12750,12750,12475,12475,12610,-145,-10,4,152
20150727,12475,12610,12615,12615,12615,12615,12615,5,5,2,154
20150728,12615,12615,12535,12540,12535,12535,12535,-80,-80,46,198
20150729,12535,12535,12780,12875,12780,12875,12795,340,260,12,202
20150730,12875,12795,12960,12990,12750,12750,12800,-45,5,30,224
20150731,12750,12800,12640,12720,12590,12720,12690,-80,-110,44,254
20150803,12720,12690,12725,12735,12505,12505,12690,-185,0,16,252
20150804,12505,12690,12345,12345,12340,12340,12340,-350,-350,12,258
20150805,12340,12340,12550,12740,12550,12740,12645,400,305,4,256
20150806,12740,12645,12605,12605,12520,12530,12550,-115,-95,12,254
20150807,12530,12550,12450,12450,12430,12430,12435,-120,-115,60,314
20150810,12430,12435,12420,12420,12420,12420,12420,-15,-15,6,314
20150811,12420,12420,12720,12735,12720,12735,12725,315,305,4,316
20150812,12735,12725,12830,12830,12830,12830,12830,105,105,2,314
20150813,12830,12830,13180,13180,12840,13060,12965,230,135,68,326
20150814,13060,12965,12835,12835,12835,12835,12835,-130,-130,2,326
20150817,12835,12835,12995,12995,12740,12915,12780,80,-55,102,334
20150818,12915,12780,12985,12995,12885,12970,12980,190,200,106,318
20150819,12970,12980,12815,12815,12800,12800,12805,-180,-175,6,322
20150820,12800,12805,13080,13080,12975,12975,13015,170,210,6,324
20150821,12975,13015,13015,13100,12900,12900,13015,-115,0,8,320
20150824,12900,13015,,,,12680,12680,-335,-335,0,320
20150825,12680,12680,12550,12785,12490,12735,12750,55,70,128,378
20150826,12735,12750,12895,12895,12810,12850,12855,100,105,14,372
20150827,12850,12855,,,,12855,12855,0,0,0,372
20150828,12855,12855,13080,13200,13000,13000,13035,145,180,92,386
20150831,13000,13035,13235,13235,12820,13115,13070,80,35,8,390
20150901,13115,13070,12850,12945,12850,12915,12890,-155,-180,8,390
20150902,12915,12890,12890,13065,12890,13065,13020,175,130,8,388
20150907,13065,13020,13155,13155,13020,13055,13075,35,55,16,386
20150908,13055,13075,12970,12980,12855,12855,12920,-220,-155,118,450
20150909,12855,12920,12995,13105,12995,13055,13050,135,130,378,618
20150910,13055,13050,13095,13115,13010,13100,13050,50,0,496,870
20150911,13100,13050,13150,13150,13080,13080,13125,30,75,298,986
20150914,13080,13125,13080,13080,12950,12950,13035,-175,-90,146,1042
20150915,12950,13035,12930,13000,12915,12930,12960,-105,-75,286,1188
20150916,12930,12960,12990,13100,12985,13040,13015,80,55,294,1264
20150917,13040,13015,13090,13095,13015,13020,13040,5,25,500,1520
20150918,13020,13040,13080,13160,13015,13075,13045,35,5,492,1722
20150921,13075,13045,13030,13085,12760,13020,12890,-25,-155,1172,2154
20150922,13020,12890,12935,13115,12855,12910,12900,20,10,1006,2606
20150923,12910,12900,12855,12990,12785,12975,12885,75,-15,1226,3124
20150924,12975,12885,13015,13100,12940,13095,13000,210,115,600,3260
20150925,13095,13000,13000,13175,13000,13060,13070,60,70,516,3414
20150928,13060,13070,13110,13295,12975,12975,13015,-95,-55,538,3706
20150929,12975,13015,12830,13000,12830,12985,12915,-30,-100,1190,4018
20150930,12985,12915,13050,13405,13030,13255,13170,340,255,832,4228
20151008,13255,13170,13400,13425,13235,13245,13285,75,115,686,4508
20151009,13245,13285,13250,13515,13205,13460,13365,175,80,718,4810
20151012,13460,13365,13675,13750,13445,13620,13555,255,190,1284,5218
20151013,13620,13555,13655,13655,13450,13565,13530,10,-25,1016,5504
20151014,13565,13530,13500,13580,13480,13550,13535,20,5,340,5576
20151015,13550,13535,13565,13620,13460,13470,13540,-65,5,520,5756
20151016,13470,13540,13430,13545,13405,13415,13485,-125,-55,620,5788
20151019,13415,13485,13445,13500,13385,13450,13445,-35,-40,322,5902
20151020,13450,13445,13420,13530,13350,13385,13410,-60,-35,492,6064
20151021,13385,13410,13420,13445,13150,13170,13375,-240,-35,858,6442
20151022,13170,13375,13100,13300,12990,13165,13140,-210,-235,1628,6834
20151023,13165,13140,13250,13345,13090,13230,13190,90,50,934,6948
20151026,13230,13190,13270,13270,13145,13185,13185,-5,-5,1038,7214
20151027,13185,13185,13200,13305,13145,13300,13230,115,45,1124,7616
20151028,13300,13230,13270,13275,13185,13225,13220,-5,-10,616,7830
20151029,13225,13220,13190,13375,13165,13335,13290,115,70,1946,8602
20151030,13335,13290,13270,13320,13120,13155,13225,-135,-65,1534,8930
20151102,13155,13225,13115,13155,13000,13010,13085,-215,-140,2260,9266
20151103,13010,13085,13015,13110,13000,13030,13060,-55,-25,1770,9378
20151104,13030,13060,13000,13140,12860,13125,13035,65,-25,1964,9600
20151105,13125,13035,13080,13175,12950,12980,13025,-55,-10,3154,9632
20151106,12980,13025,12925,13050,12915,12975,12945,-50,-80,2892,9790
20151109,12975,12945,12945,12990,12910,12930,12950,-15,5,2098,10034
20151110,12930,12950,12930,12960,12655,12765,12805,-185,-145,3672,10468
20151111,12765,12805,12735,12765,12570,12660,12675,-145,-130,3744,10684
20151112,12660,12675,12650,12750,12450,12675,12630,0,-45,9020,11626
20151113,12675,12630,12590,12750,12495,12600,12630,-30,0,7206,11760
20151116,12600,12630,12600,12700,12470,12480,12620,-150,-10,5718,12492
20151117,12480,12620,12495,12535,12125,12260,12300,-360,-320,12764,12956
20151118,12260,12300,12330,12385,12005,12150,12155,-150,-145,12848,13998
20151119,12150,12155,12150,12275,11835,11960,12005,-195,-150,15788,15754
20151120,11960,12005,11965,12365,11800,12280,12090,275,85,20844,15970
20151123,12280,12090,12295,12420,11900,11980,12120,-110,30,19272,15160
20151124,11980,12120,11960,12505,11910,12455,12260,335,140,19372,14846
20151125,12455,12260,12540,12660,12360,12565,12520,305,260,15294,14244
20151126,12565,12520,12505,13020,12390,12815,12740,295,220,17934,13224
20151127,12815,12740,12885,13020,12515,12605,12700,-135,-40,14884,12886
20151130,12605,12700,12530,12725,12485,12690,12585,-10,-115,12024,13036
pb1602,20150216,12695,12695,,,,12805,12805,110,110,0,0
20150217,12805,12805,,,,12650,12650,-155,-155,0,0
20150225,12650,12650,,,,12500,12500,-150,-150,0,0
20150226,12500,12500,,,,12480,12480,-20,-20,0,0
20150227,12480,12480,,,,12480,12480,0,0,0,0
20150302,12480,12480,,,,12385,12385,-95,-95,0,0
20150303,12385,12385,,,,12425,12425,40,40,0,0
20150304,12425,12425,,,,12410,12410,-15,-15,0,0
20150305,12410,12410,12390,12390,12225,12225,12305,-185,-105,4,2
20150306,12225,12305,,,,12305,12305,0,0,0,2
20150309,12305,12305,,,,12305,12305,0,0,0,2
20150310,12305,12305,,,,12305,12305,0,0,0,2
20150311,12305,12305,,,,12305,12305,0,0,0,2
20150312,12305,12305,,,,12345,12345,40,40,0,2
20150313,12345,12345,,,,12355,12355,10,10,0,2
20150316,12355,12355,12040,12215,12000,12210,12095,-145,-260,196,100
20150317,12210,12095,12150,12165,12150,12165,12150,70,55,8,100
20150318,12165,12150,,,,12130,12130,-20,-20,0,100
20150319,12130,12130,,,,12110,12110,-20,-20,0,100
20150320,12110,12110,,,,12130,12130,20,20,0,100
20150323,12130,12130,,,,12255,12255,125,125,0,100
20150324,12255,12255,,,,12450,12450,195,195,0,100
20150325,12450,12450,,,,12450,12450,0,0,0,100
20150326,12450,12450,12470,12470,12470,12470,12470,20,20,2,100
20150327,12470,12470,,,,12470,12470,0,0,0,100
20150330,12470,12470,12470,12470,12470,12470,12470,0,0,2,100
20150331,12470,12470,,,,12470,12470,0,0,0,100
20150401,12470,12470,,,,12435,12435,-35,-35,0,100
20150402,12435,12435,12405,12405,12405,12405,12405,-30,-30,8,100
20150403,12405,12405,12485,12485,12485,12485,12485,80,80,2,100
20150407,12485,12485,,,,12660,12660,175,175,0,100
20150408,12660,12660,12770,12770,12745,12745,12750,85,90,6,100
20150409,12745,12750,,,,12750,12750,0,0,0,100
20150410,12750,12750,12965,13260,12965,13260,13250,510,500,68,100
20150413,13260,13250,13500,13500,13345,13345,13375,95,125,10,104
20150414,13345,13375,13075,13075,13075,13075,13075,-300,-300,4,108
20150415,13075,13075,13125,13125,13125,13125,13125,50,50,2,106
20150416,13125,13125,13490,13500,13445,13445,13485,320,360,146,32
20150417,13445,13485,13570,13780,13570,13780,13650,295,165,14,26
20150420,13780,13650,13705,13710,13540,13540,13650,-110,0,6,24
20150421,13540,13650,,,,13555,13555,-95,-95,0,24
20150422,13555,13555,,,,13680,13680,125,125,0,24
20150423,13680,13680,,,,13580,13580,-100,-100,0,24
20150424,13580,13580,,,,13575,13575,-5,-5,0,24
20150427,13575,13575,,,,13825,13825,250,250,0,24
20150428,13825,13825,,,,14180,14180,355,355,0,24
20150429,14180,14180,13720,13990,13720,13990,13855,-190,-325,4,24
20150430,13990,13855,13865,13870,13865,13870,13865,15,10,4,22
20150504,13870,13865,,,,13915,13915,50,50,0,22
20150505,13915,13915,,,,13880,13880,-35,-35,0,22
20150506,13880,13880,,,,13990,13990,110,110,0,22
20150507,13990,13990,,,,13750,13750,-240,-240,0,22
20150508,13750,13750,13650,13650,13650,13650,13650,-100,-100,14,22
20150511,13650,13650,13640,13750,13640,13750,13735,100,85,16,24
20150512,13750,13735,13560,13560,13465,13465,13525,-270,-210,12,24
20150513,13465,13525,13790,13790,13595,13705,13695,180,170,8,22
20150514,13705,13695,,,,13830,13830,135,135,0,22
20150515,13830,13830,,,,13600,13600,-230,-230,0,22
20150518,13600,13600,13465,13465,13465,13465,13465,-135,-135,2,20
20150519,13465,13465,,,,13460,13460,-5,-5,0,20
20150520,13460,13460,,,,13250,13250,-210,-210,0,20
20150521,13250,13250,13305,13305,13230,13230,13265,-20,15,4,20
20150522,13230,13265,,,,13505,13505,240,240,0,20
20150525,13505,13505,13300,13300,13300,13300,13300,-205,-205,4,20
20150526,13300,13300,,,,13330,13330,30,30,0,20
20150527,13330,13330,,,,13355,13355,25,25,0,20
20150528,13355,13355,,,,13415,13415,60,60,0,20
20150529,13415,13415,,,,13185,13185,-230,-230,0,20
20150601,13185,13185,13340,13370,13340,13370,13355,185,170,6,18
20150602,13370,13355,,,,13210,13210,-145,-145,0,18
20150603,13210,13210,13360,13360,13260,13260,13305,50,95,10,22
20150604,13260,13305,,,,13310,13310,5,5,0,22
20150605,13310,13310,,,,13335,13335,25,25,0,22
20150608,13335,13335,,,,13290,13290,-45,-45,0,22
20150609,13290,13290,,,,13235,13235,-55,-55,0,22
20150610,13235,13235,,,,13305,13305,70,70,0,22
20150611,13305,13305,,,,13325,13325,20,20,0,22
20150612,13325,13325,,,,12880,12880,-445,-445,0,22
20150615,12880,12880,12870,12870,12870,12870,12870,-10,-10,4,22
20150616,12870,12870,,,,12800,12800,-70,-70,0,22
20150617,12800,12800,12740,12740,12740,12740,12740,-60,-60,2,24
20150618,12740,12740,,,,12760,12760,20,20,0,24
20150619,12760,12760,,,,12870,12870,110,110,0,24
20150623,12870,12870,,,,13000,13000,130,130,0,24
20150624,13000,13000,,,,13230,13230,230,230,0,24
20150625,13230,13230,,,,13100,13100,-130,-130,0,24
20150626,13100,13100,,,,13005,13005,-95,-95,0,24
20150629,13005,13005,,,,12800,12800,-205,-205,0,24
20150630,12800,12800,12605,12820,12605,12820,12710,20,-90,4,24
20150701,12820,12710,,,,12510,12510,-200,-200,0,24
20150702,12510,12510,,,,12765,12765,255,255,0,24
20150703,12765,12765,,,,12790,12790,25,25,0,24
20150706,12790,12790,,,,12530,12530,-260,-260,0,24
20150707,12530,12530,,,,12470,12470,-60,-60,0,24
20150708,12470,12470,,,,12250,12250,-220,-220,0,24
20150709,12250,12250,,,,12605,12605,355,355,0,24
20150710,12605,12605,,,,12605,12605,0,0,0,24
20150713,12605,12605,,,,12520,12520,-85,-85,0,24
20150714,12520,12520,,,,12810,12810,290,290,0,24
20150715,12810,12810,,,,12700,12700,-110,-110,0,24
20150716,12700,12700,,,,12700,12700,0,0,0,24
20150717,12700,12700,,,,12545,12545,-155,-155,0,24
20150720,12545,12545,,,,12650,12650,105,105,0,24
20150721,12650,12650,,,,12660,12660,10,10,0,24
20150722,12660,12660,,,,12390,12390,-270,-270,0,24
20150723,12390,12390,,,,12385,12385,-5,-5,0,24
20150724,12385,12385,,,,12375,12375,-10,-10,0,24
20150727,12375,12375,,,,12375,12375,0,0,0,24
20150728,12375,12375,12400,12400,12400,12400,12400,25,25,2,26
20150729,12400,12400,,,,12655,12655,255,255,0,26
20150730,12655,12655,12800,13045,12785,12800,12825,145,170,28,46
20150731,12800,12825,12660,12700,12620,12700,12685,-125,-140,96,130
20150803,12700,12685,12680,12680,12480,12480,12535,-205,-150,10,136
20150804,12480,12535,12425,12520,12280,12520,12360,-15,-175,82,136
20150805,12520,12360,12540,12540,12540,12540,12540,180,180,10,146
20150806,12540,12540,12445,12445,12445,12445,12445,-95,-95,2,146
20150807,12445,12445,12400,12400,12260,12260,12330,-185,-115,4,146
20150810,12260,12330,,,,12315,12315,-15,-15,0,146
20150811,12315,12315,12700,12700,12500,12500,12685,185,370,32,176
20150812,12500,12685,12850,12850,12515,12515,12680,-170,-5,4,178
20150813,12515,12680,13050,13185,12625,12625,12910,-55,230,10,178
20150814,12625,12910,12705,12705,12705,12705,12705,-205,-205,2,178
20150817,12705,12705,12600,12600,12600,12600,12600,-105,-105,2,178
20150818,12600,12600,,,,12690,12690,90,90,0,178
20150819,12690,12690,12525,12525,12525,12525,12525,-165,-165,2,178
20150820,12525,12525,,,,12730,12730,205,205,0,178
20150821,12730,12730,,,,12730,12730,0,0,0,178
20150824,12730,12730,12600,12895,12500,12500,12690,-230,-40,12,180
20150825,12500,12690,12250,12250,12250,12250,12250,-440,-440,2,180
20150826,12250,12250,,,,12350,12350,100,100,0,180
20150827,12350,12350,12720,12720,12665,12665,12700,315,350,6,186
20150828,12665,12700,12895,12895,12895,12895,12895,195,195,2,186
20150831,12895,12895,,,,12895,12895,0,0,0,186
20150901,12895,12895,12615,12615,12615,12615,12615,-280,-280,2,186
20150902,12615,12615,,,,12650,12650,35,35,0,186
20150907,12650,12650,12810,13240,12810,12955,13000,305,350,6,188
20150908,12955,13000,12705,12705,12705,12705,12705,-295,-295,2,190
20150909,12705,12705,,,,12705,12705,0,0,0,190
20150910,12705,12705,,,,12705,12705,0,0,0,190
20150911,12705,12705,,,,12810,12810,105,105,0,190
20150914,12810,12810,12925,12925,12925,12925,12925,115,115,2,188
20150915,12925,12925,,,,12925,12925,0,0,0,188
20150916,12925,12925,,,,12925,12925,0,0,0,188
20150917,12925,12925,12975,12975,12975,12975,12975,50,50,10,198
20150918,12975,12975,,,,12975,12975,0,0,0,198
20150921,12975,12975,12770,12975,12755,12755,12830,-220,-145,30,198
20150922,12755,12830,12840,12920,12840,12895,12880,65,50,200,266
20150923,12895,12880,12805,12880,12790,12880,12825,0,-55,228,346
20150924,12880,12825,12945,12970,12935,12960,12945,135,120,182,398
20150925,12960,12945,12980,13010,12980,13005,12985,60,40,112,458
20150928,13005,12985,13000,13000,13000,13000,13000,15,15,2,460
20150929,13000,13000,12800,12900,12775,12870,12850,-130,-150,18,456
20150930,12870,12850,13050,13300,13050,13300,13185,450,335,100,464
20151008,13300,13185,13240,13240,13210,13210,13225,25,40,16,458
20151009,13210,13225,13185,13450,13185,13450,13250,225,25,16,448
20151012,13450,13250,13490,13550,13480,13535,13520,285,270,108,444
20151013,13535,13520,13580,13580,13500,13550,13555,30,35,34,456
20151014,13550,13555,13505,13505,13430,13430,13490,-125,-65,12,452
20151015,13430,13490,13520,13520,13480,13480,13510,-10,20,36,470
20151016,13480,13510,13450,13460,13380,13380,13415,-130,-95,34,486
20151019,13380,13415,13370,13400,13325,13380,13360,-35,-55,120,540
20151020,13380,13360,13390,13390,13290,13315,13330,-45,-30,210,652
20151021,13315,13330,13390,13390,13250,13250,13305,-80,-25,266,782
20151022,13250,13305,12930,13230,12930,13120,13105,-185,-200,412,984
20151023,13120,13105,13280,13280,13015,13100,13070,-5,-35,108,1038
20151026,13100,13070,13090,13145,13055,13135,13085,65,15,700,1356
20151027,13135,13085,13135,13220,13050,13220,13105,135,20,480,1586
20151028,13220,13105,13175,13195,13095,13115,13120,10,15,532,1860
20151029,13115,13120,13050,13330,13050,13265,13230,145,110,1440,2604
20151030,13265,13230,13130,13180,13120,13140,13125,-90,-105,202,2706
20151102,13140,13125,13045,13060,12985,13025,13030,-100,-95,676,2952
20151103,13025,13030,12900,13035,12900,12980,12985,-50,-45,304,3094
20151104,12980,12985,12900,13050,12900,13040,12960,55,-25,188,3158
20151105,13040,12960,13100,13100,12925,12925,12960,-35,0,58,3178
20151106,12925,12960,12855,12895,12835,12870,12865,-90,-95,172,3238
20151109,12870,12865,12850,12950,12820,12885,12855,20,-10,296,3370
20151110,12885,12855,12850,12850,12500,12645,12665,-210,-190,694,3658
20151111,12645,12665,12665,12665,12490,12580,12565,-85,-100,928,4018
20151112,12580,12565,12550,12650,12360,12590,12560,25,-5,1844,4814
20151113,12590,12560,12455,12600,12390,12485,12515,-75,-45,1128,5200
20151116,12485,12515,12535,12580,12375,12385,12525,-130,10,1126,5690
20151117,12385,12525,12395,12405,12035,12180,12170,-345,-355,1224,6070
20151118,12180,12170,12255,12265,11930,12070,12055,-100,-115,1786,6768
20151119,12070,12055,12105,12105,11780,11880,11910,-175,-145,2306,7678
20151120,11880,11910,11860,12285,11725,12215,12045,305,135,2968,8486
20151123,12215,12045,12245,12310,11790,11905,11945,-140,-100,3594,9164
20151124,11905,11945,11880,12375,11820,12345,12165,400,220,3824,9502
20151125,12345,12165,12330,12500,12275,12440,12405,275,240,2968,9296
20151126,12440,12405,12400,12900,12310,12670,12650,265,245,5840,9680
20151127,12670,12650,12720,12785,12410,12495,12530,-155,-120,4120,9430
20151130,12495,12530,12405,12600,12335,12550,12460,20,-70,3872,10256
pb1603,20150317,12095,12095,,,,12095,12095,0,0,0,0
20150318,12095,12095,,,,12075,12075,-20,-20,0,0
20150319,12075,12075,,,,12055,12055,-20,-20,0,0
20150320,12055,12055,,,,11990,11990,-65,-65,0,0
20150323,11990,11990,,,,12250,12250,260,260,0,0
20150324,12250,12250,,,,12375,12375,125,125,0,0
20150325,12375,12375,,,,12375,12375,0,0,0,0
20150326,12375,12375,,,,12375,12375,0,0,0,0
20150327,12375,12375,12575,12575,12575,12575,12575,200,200,2,2
20150330,12575,12575,12505,12505,12505,12505,12505,-70,-70,2,4
20150331,12505,12505,,,,12505,12505,0,0,0,4
20150401,12505,12505,12380,12380,12380,12380,12380,-125,-125,2,4
20150402,12380,12380,,,,12350,12350,-30,-30,0,4
20150403,12350,12350,,,,12425,12425,75,75,0,4
20150407,12425,12425,,,,12550,12550,125,125,0,4
20150408,12550,12550,12775,12775,12775,12775,12775,225,225,2,6
20150409,12775,12775,12805,12810,12785,12795,12795,20,20,8,8
20150410,12795,12795,13010,13305,13010,13305,13210,510,415,12,18
20150413,13305,13210,13420,13530,13420,13510,13475,300,265,20,20
20150414,13510,13475,13100,13100,13100,13100,13100,-375,-375,4,20
20150415,13100,13100,13120,13120,13120,13120,13120,20,20,6,18
20150416,13120,13120,13390,13390,13390,13390,13390,270,270,2,16
20150417,13390,13390,,,,13525,13525,135,135,0,16
20150420,13525,13525,13780,13780,13655,13655,13725,130,200,14,16
20150421,13655,13725,,,,13630,13630,-95,-95,0,16
20150422,13630,13630,13675,13675,13675,13675,13675,45,45,2,16
20150423,13675,13675,,,,13580,13580,-95,-95,0,16
20150424,13580,13580,,,,13575,13575,-5,-5,0,16
20150427,13575,13575,,,,13825,13825,250,250,0,16
20150428,13825,13825,,,,14180,14180,355,355,0,16
20150429,14180,14180,,,,14180,14180,0,0,0,16
20150430,14180,14180,13910,13910,13910,13910,13910,-270,-270,2,18
20150504,13910,13910,,,,13960,13960,50,50,0,18
20150505,13960,13960,13960,13960,13960,13960,13960,0,0,2,20
20150506,13960,13960,14075,14075,14075,14075,14075,115,115,2,20
20150507,14075,14075,13760,13760,13695,13695,13725,-380,-350,8,28
20150508,13695,13725,,,,13625,13625,-100,-100,0,28
20150511,13625,13625,,,,13650,13650,25,25,0,28
20150512,13650,13650,13595,13595,13595,13595,13595,-55,-55,2,28
20150513,13595,13595,,,,13765,13765,170,170,0,28
20150514,13765,13765,13740,13740,13740,13740,13740,-25,-25,2,28
20150515,13740,13740,13600,13600,13600,13600,13600,-140,-140,2,30
20150518,13600,13600,,,,13600,13600,0,0,0,30
20150519,13600,13600,,,,13595,13595,-5,-5,0,30
20150520,13595,13595,,,,13380,13380,-215,-215,0,30
20150521,13380,13380,,,,13380,13380,0,0,0,30
20150522,13380,13380,,,,13420,13420,40,40,0,30
20150525,13420,13420,,,,13215,13215,-205,-205,0,30
20150526,13215,13215,,,,13245,13245,30,30,0,30
20150527,13245,13245,,,,13350,13350,105,105,0,30
20150528,13350,13350,,,,13410,13410,60,60,0,30
20150529,13410,13410,13300,13475,13300,13475,13415,65,5,6,24
20150601,13475,13415,,,,13585,13585,170,170,0,24
20150602,13585,13585,,,,13585,13585,0,0,0,24
20150603,13585,13585,,,,13585,13585,0,0,0,24
20150604,13585,13585,,,,13585,13585,0,0,0,24
20150605,13585,13585,,,,13585,13585,0,0,0,24
20150608,13585,13585,,,,13540,13540,-45,-45,0,24
20150609,13540,13540,,,,13540,13540,0,0,0,24
20150610,13540,13540,13300,13300,13300,13300,13300,-240,-240,2,24
20150611,13300,13300,,,,13300,13300,0,0,0,24
20150612,13300,13300,,,,13300,13300,0,0,0,24
20150615,13300,13300,,,,13300,13300,0,0,0,24
20150616,13300,13300,12765,12820,12765,12820,12790,-480,-510,4,24
20150617,12820,12790,,,,12790,12790,0,0,0,24
20150618,12790,12790,,,,12810,12810,20,20,0,24
20150619,12810,12810,,,,12920,12920,110,110,0,24
20150623,12920,12920,,,,13050,13050,130,130,0,24
20150624,13050,13050,,,,13280,13280,230,230,0,24
20150625,13280,13280,,,,13335,13335,55,55,0,24
20150626,13335,13335,,,,13235,13235,-100,-100,0,24
20150629,13235,13235,,,,13115,13115,-120,-120,0,24
20150630,13115,13115,12675,12675,12675,12675,12675,-440,-440,2,22
20150701,12675,12675,,,,12475,12475,-200,-200,0,22
20150702,12475,12475,,,,12730,12730,255,255,0,22
20150703,12730,12730,,,,12755,12755,25,25,0,22
20150706,12755,12755,12850,12850,12850,12850,12850,95,95,2,24
20150707,12850,12850,,,,12790,12790,-60,-60,0,24
20150708,12790,12790,12280,12285,12280,12285,12280,-505,-510,4,26
20150709,12285,12280,12650,12650,12650,12650,12650,370,370,2,24
20150710,12650,12650,,,,12905,12905,255,255,0,24
20150713,12905,12905,,,,12815,12815,-90,-90,0,24
20150714,12815,12815,,,,13160,13160,345,345,0,24
20150715,13160,13160,,,,13045,13045,-115,-115,0,24
20150716,13045,13045,,,,13045,13045,0,0,0,24
20150717,13045,13045,,,,12885,12885,-160,-160,0,24
20150720,12885,12885,,,,12840,12840,-45,-45,0,24
20150721,12840,12840,,,,12850,12850,10,10,0,24
20150722,12850,12850,,,,12575,12575,-275,-275,0,24
20150723,12575,12575,,,,12570,12570,-5,-5,0,24
20150724,12570,12570,,,,12560,12560,-10,-10,0,24
20150727,12560,12560,,,,12560,12560,0,0,0,24
20150728,12560,12560,12290,12825,12290,12825,12555,265,-5,4,24
20150729,12825,12555,12825,12825,12825,12825,12825,270,270,2,22
20150730,12825,12825,12800,12800,12750,12765,12770,-60,-55,10,30
20150731,12765,12770,12600,12600,12600,12600,12600,-170,-170,4,30
20150803,12600,12600,12480,12480,12480,12480,12480,-120,-120,2,30
20150804,12480,12480,,,,12310,12310,-170,-170,0,30
20150805,12310,12310,,,,12485,12485,175,175,0,30
20150806,12485,12485,,,,12390,12390,-95,-95,0,30
20150807,12390,12390,,,,12275,12275,-115,-115,0,30
20150810,12275,12275,,,,12260,12260,-15,-15,0,30
20150811,12260,12260,,,,12405,12405,145,145,0,30
20150812,12405,12405,12900,12900,12900,12900,12900,495,495,4,26
20150813,12900,12900,13050,13050,12800,12800,12925,-100,25,4,26
20150814,12800,12925,,,,12715,12715,-210,-210,0,26
20150817,12715,12715,,,,12715,12715,0,0,0,26
20150818,12715,12715,,,,12910,12910,195,195,0,26
20150819,12910,12910,,,,12740,12740,-170,-170,0,26
20150820,12740,12740,,,,12740,12740,0,0,0,26
20150821,12740,12740,,,,12740,12740,0,0,0,26
20150824,12740,12740,,,,12600,12600,-140,-140,0,26
20150825,12600,12600,12360,12360,12360,12360,12360,-240,-240,2,26
20150826,12360,12360,,,,12460,12460,100,100,0,26
20150827,12460,12460,,,,12810,12810,350,350,0,26
20150828,12810,12810,,,,12810,12810,0,0,0,26
20150831,12810,12810,,,,12845,12845,35,35,0,26
20150901,12845,12845,,,,12565,12565,-280,-280,0,26
20150902,12565,12565,,,,12690,12690,125,125,0,26
20150907,12690,12690,,,,13040,13040,350,350,0,26
20150908,13040,13040,,,,12740,12740,-300,-300,0,26
20150909,12740,12740,,,,12870,12870,130,130,0,26
20150910,12870,12870,,,,12870,12870,0,0,0,26
20150911,12870,12870,,,,12945,12945,75,75,0,26
20150914,12945,12945,,,,13060,13060,115,115,0,26
20150915,13060,13060,,,,12985,12985,-75,-75,0,26
20150916,12985,12985,,,,13040,13040,55,55,0,26
20150917,13040,13040,,,,13090,13090,50,50,0,26
20150918,13090,13090,,,,13095,13095,5,5,0,26
20150921,13095,13095,,,,12950,12950,-145,-145,0,26
20150922,12950,12950,,,,13000,13000,50,50,0,26
20150923,13000,13000,,,,12880,12880,-120,-120,0,26
20150924,12880,12880,,,,12880,12880,0,0,0,26
20150925,12880,12880,,,,12920,12920,40,40,0,26
20150928,12920,12920,,,,12930,12930,10,10,0,26
20150929,12930,12930,,,,12780,12780,-150,-150,0,26
20150930,12780,12780,,,,13115,13115,335,335,0,26
20151008,13115,13115,,,,13155,13155,40,40,0,26
20151009,13155,13155,,,,13180,13180,25,25,0,26
20151012,13180,13180,13425,13425,13425,13425,13425,245,245,4,26
20151013,13425,13425,13420,13510,13420,13420,13445,-5,20,14,24
20151014,13420,13445,,,,13380,13380,-65,-65,0,24
20151015,13380,13380,,,,13400,13400,20,20,0,24
20151016,13400,13400,13355,13420,13355,13420,13385,20,-15,4,20
20151019,13420,13385,,,,13385,13385,0,0,0,20
20151020,13385,13385,13420,13420,13340,13340,13365,-45,-20,6,20
20151021,13340,13365,,,,13340,13340,-25,-25,0,20
20151022,13340,13340,12925,12925,12925,12925,12925,-415,-415,2,20
20151023,12925,12925,,,,13060,13060,135,135,0,20
20151026,13060,13060,,,,13060,13060,0,0,0,20
20151027,13060,13060,,,,13080,13080,20,20,0,20
20151028,13080,13080,13120,13120,13120,13120,13120,40,40,10,26
20151029,13120,13120,,,,13170,13170,50,50,0,26
20151030,13170,13170,,,,13160,13160,-10,-10,0,26
20151102,13160,13160,12920,12920,12920,12920,12920,-240,-240,2,26
20151103,12920,12920,,,,12920,12920,0,0,0,26
20151104,12920,12920,,,,12895,12895,-25,-25,0,26
20151105,12895,12895,,,,12895,12895,0,0,0,26
20151106,12895,12895,,,,12895,12895,0,0,0,26
20151109,12895,12895,12790,12855,12790,12855,12820,-40,-75,4,30
20151110,12855,12820,,,,12630,12630,-190,-190,0,30
20151111,12630,12630,12450,12450,12450,12450,12450,-180,-180,2,30
20151112,12450,12450,,,,12445,12445,-5,-5,0,30
20151113,12445,12445,12380,12450,12380,12420,12420,-25,-25,10,38
20151116,12420,12420,12515,12565,12330,12330,12345,-90,-75,140,146
20151117,12330,12345,12345,12375,11950,12095,12055,-250,-290,596,496
20151118,12095,12055,12100,12195,11850,12065,11955,10,-100,442,660
20151119,12065,11955,11850,12095,11720,11760,11845,-195,-110,700,976
20151120,11760,11845,11705,12125,11615,12035,11870,190,25,1038,1522
20151123,12035,11870,12185,12240,11690,11735,11845,-135,-25,708,1798
20151124,11735,11845,11780,12225,11735,12200,11980,355,135,1340,2442
20151125,12200,11980,12285,12450,12115,12265,12235,285,255,1054,3020
20151126,12265,12235,12155,12720,12130,12555,12490,320,255,1442,3392
20151127,12555,12490,12465,12625,12270,12350,12370,-140,-120,912,3782
20151130,12350,12370,12250,12440,12230,12420,12320,50,-50,1466,4278
pb1604,20150416,13120,13120,,,,13120,13120,0,0,0,0
20150417,13120,13120,,,,13280,13280,160,160,0,0
20150420,13280,13280,,,,13445,13445,165,165,0,0
20150421,13445,13445,,,,13350,13350,-95,-95,0,0
20150422,13350,13350,,,,13390,13390,40,40,0,0
20150423,13390,13390,,,,13295,13295,-95,-95,0,0
20150424,13295,13295,,,,13290,13290,-5,-5,0,0
20150427,13290,13290,,,,13535,13535,245,245,0,0
20150428,13535,13535,,,,13885,13885,350,350,0,0
20150429,13885,13885,12800,13945,12800,13860,13555,-25,-330,26,0
20150430,13860,13555,,,,13645,13645,90,90,0,0
20150504,13645,13645,,,,13695,13695,50,50,0,0
20150505,13695,13695,,,,13695,13695,0,0,0,0
20150506,13695,13695,14135,14135,14090,14090,14110,395,415,4,4
20150507,14090,14110,13705,13705,13705,13705,13705,-405,-405,2,6
20150508,13705,13705,,,,13605,13605,-100,-100,0,6
20150511,13605,13605,13690,13690,13690,13690,13690,85,85,2,8
20150512,13690,13690,13630,13630,13630,13630,13630,-60,-60,2,10
20150513,13630,13630,13660,13660,13660,13660,13660,30,30,2,12
20150514,13660,13660,13690,13690,13690,13690,13690,30,30,2,10
20150515,13690,13690,13625,13625,13520,13520,13570,-170,-120,4,10
20150518,13520,13570,,,,13435,13435,-135,-135,0,10
20150519,13435,13435,,,,13435,13435,0,0,0,10
20150520,13435,13435,,,,13225,13225,-210,-210,0,10
20150521,13225,13225,13390,13390,13275,13275,13330,50,105,4,10
20150522,13275,13330,,,,13330,13330,0,0,0,10
20150525,13330,13330,,,,13125,13125,-205,-205,0,10
20150526,13125,13125,,,,13155,13155,30,30,0,10
20150527,13155,13155,,,,13180,13180,25,25,0,10
20150528,13180,13180,,,,13240,13240,60,60,0,10
20150529,13240,13240,,,,13245,13245,5,5,0,10
20150601,13245,13245,,,,13415,13415,170,170,0,10
20150602,13415,13415,,,,13270,13270,-145,-145,0,10
20150603,13270,13270,13350,13350,13350,13350,13350,80,80,2,12
20150604,13350,13350,,,,13355,13355,5,5,0,12
20150605,13355,13355,13325,13325,13325,13325,13325,-30,-30,2,12
20150608,13325,13325,13290,13290,13290,13290,13290,-35,-35,2,12
20150609,13290,13290,,,,13235,13235,-55,-55,0,12
20150610,13235,13235,,,,13000,13000,-235,-235,0,12
20150611,13000,13000,,,,13020,13020,20,20,0,12
20150612,13020,13020,13155,13155,13155,13155,13155,135,135,2,14
20150615,13155,13155,12930,12935,12900,12900,12920,-255,-235,16,24
20150616,12900,12920,,,,12425,12425,-495,-495,0,24
20150617,12425,12425,,,,12365,12365,-60,-60,0,24
20150618,12365,12365,12850,12855,12850,12855,12850,490,485,6,22
20150619,12855,12850,12930,12930,12930,12930,12930,80,80,2,22
20150623,12930,12930,,,,13060,13060,130,130,0,22
20150624,13060,13060,13100,13100,13100,13100,13100,40,40,2,20
20150625,13100,13100,13190,13190,12995,12995,13090,-105,-10,4,22
20150626,12995,13090,,,,12995,12995,-95,-95,0,22
20150629,12995,12995,,,,12880,12880,-115,-115,0,22
20150630,12880,12880,,,,12445,12445,-435,-435,0,22
20150701,12445,12445,12600,12620,12600,12610,12600,165,155,18,34
20150702,12610,12600,,,,12860,12860,260,260,0,34
20150703,12860,12860,,,,12890,12890,30,30,0,34
20150706,12890,12890,12640,12640,12640,12640,12640,-250,-250,4,38
20150707,12640,12640,,,,12580,12580,-60,-60,0,38
20150708,12580,12580,12160,12160,12160,12160,12160,-420,-420,2,38
20150709,12160,12160,12645,12645,12645,12645,12645,485,485,2,40
20150710,12645,12645,12855,12855,12855,12855,12855,210,210,2,40
20150713,12855,12855,,,,12765,12765,-90,-90,0,40
20150714,12765,12765,,,,13110,13110,345,345,0,40
20150715,13110,13110,,,,12995,12995,-115,-115,0,40
20150716,12995,12995,,,,12995,12995,0,0,0,40
20150717,12995,12995,,,,12835,12835,-160,-160,0,40
20150720,12835,12835,,,,12835,12835,0,0,0,40
20150721,12835,12835,,,,12845,12845,10,10,0,40
20150722,12845,12845,,,,12845,12845,0,0,0,40
20150723,12845,12845,,,,12845,12845,0,0,0,40
20150724,12845,12845,,,,12845,12845,0,0,0,40
20150727,12845,12845,12840,12840,12540,12540,12690,-305,-155,24,40
20150728,12540,12690,,,,12685,12685,-5,-5,0,40
20150729,12685,12685,,,,12955,12955,270,270,0,40
20150730,12955,12955,,,,12900,12900,-55,-55,0,40
20150731,12900,12900,,,,12900,12900,0,0,0,40
20150803,12900,12900,12615,12615,12380,12380,12435,-520,-465,16,52
20150804,12380,12435,,,,12435,12435,0,0,0,52
20150805,12435,12435,,,,12615,12615,180,180,0,52
20150806,12615,12615,12260,12260,12260,12260,12260,-355,-355,2,52
20150807,12260,12260,,,,12260,12260,0,0,0,52
20150810,12260,12260,,,,12245,12245,-15,-15,0,52
20150811,12245,12245,12580,12580,12580,12580,12580,335,335,2,52
20150812,12580,12580,,,,13080,13080,500,500,0,52
20150813,13080,13080,12655,12880,12655,12880,12800,-200,-280,6,52
20150814,12880,12800,,,,12800,12800,0,0,0,52
20150817,12800,12800,,,,12800,12800,0,0,0,52
20150818,12800,12800,,,,13000,13000,200,200,0,52
20150819,13000,13000,,,,13000,13000,0,0,0,52
20150820,13000,13000,,,,13210,13210,210,210,0,52
20150821,13210,13210,,,,13210,13210,0,0,0,52
20150824,13210,13210,,,,12680,12680,-530,-530,0,52
20150825,12680,12680,12300,12300,12300,12300,12300,-380,-380,2,52
20150826,12300,12300,,,,12500,12500,200,200,0,52
20150827,12500,12500,,,,12855,12855,355,355,0,52
20150828,12855,12855,12875,12875,12875,12875,12875,20,20,2,52
20150831,12875,12875,,,,12875,12875,0,0,0,52
20150901,12875,12875,,,,12595,12595,-280,-280,0,52
20150902,12595,12595,,,,12720,12720,125,125,0,52
20150907,12720,12720,,,,13070,13070,350,350,0,52
20150908,13070,13070,,,,12770,12770,-300,-300,0,52
20150909,12770,12770,,,,12900,12900,130,130,0,52
20150910,12900,12900,12790,12790,12790,12790,12790,-110,-110,2,54
20150911,12790,12790,,,,12865,12865,75,75,0,54
20150914,12865,12865,,,,12980,12980,115,115,0,54
20150915,12980,12980,,,,12905,12905,-75,-75,0,54
20150916,12905,12905,,,,12960,12960,55,55,0,54
20150917,12960,12960,,,,13010,13010,50,50,0,54
20150918,13010,13010,,,,13015,13015,5,5,0,54
20150921,13015,13015,,,,12870,12870,-145,-145,0,54
20150922,12870,12870,,,,12920,12920,50,50,0,54
20150923,12920,12920,12675,12675,12675,12675,12675,-245,-245,2,52
20150924,12675,12675,,,,12795,12795,120,120,0,52
20150925,12795,12795,,,,12835,12835,40,40,0,52
20150928,12835,12835,,,,12845,12845,10,10,0,52
20150929,12845,12845,,,,12845,12845,0,0,0,52
20150930,12845,12845,,,,13180,13180,335,335,0,52
20151008,13180,13180,,,,13220,13220,40,40,0,52
20151009,13220,13220,,,,13220,13220,0,0,0,52
20151012,13220,13220,,,,13220,13220,0,0,0,52
20151013,13220,13220,,,,13330,13330,110,110,0,52
20151014,13330,13330,13450,13450,13450,13450,13450,120,120,8,44
20151015,13450,13450,,,,13450,13450,0,0,0,44
20151016,13450,13450,13450,13450,13450,13450,13450,0,0,6,38
20151019,13450,13450,,,,13450,13450,0,0,0,38
20151020,13450,13450,,,,13430,13430,-20,-20,0,38
20151021,13430,13430,,,,13405,13405,-25,-25,0,38
20151022,13405,13405,,,,12985,12985,-420,-420,0,38
20151023,12985,12985,,,,12985,12985,0,0,0,38
20151026,12985,12985,,,,12985,12985,0,0,0,38
20151027,12985,12985,,,,13005,13005,20,20,0,38
20151028,13005,13005,,,,13040,13040,35,35,0,38
20151029,13040,13040,,,,13150,13150,110,110,0,38
20151030,13150,13150,,,,13045,13045,-105,-105,0,38
20151102,13045,13045,,,,12805,12805,-240,-240,0,38
20151103,12805,12805,,,,12760,12760,-45,-45,0,38
20151104,12760,12760,,,,12735,12735,-25,-25,0,38
20151105,12735,12735,,,,12735,12735,0,0,0,38
20151106,12735,12735,,,,12735,12735,0,0,0,38
20151109,12735,12735,,,,12660,12660,-75,-75,0,38
20151110,12660,12660,12650,12650,12650,12650,12650,-10,-10,2,40
20151111,12650,12650,,,,12650,12650,0,0,0,40
20151112,12650,12650,,,,12645,12645,-5,-5,0,40
20151113,12645,12645,,,,12620,12620,-25,-25,0,40
20151116,12620,12620,,,,12595,12595,-25,-25,0,40
20151117,12595,12595,,,,12300,12300,-295,-295,0,40
20151118,12300,12300,12040,12040,11805,11895,11910,-405,-390,6,42
20151119,11895,11910,11750,11750,11750,11750,11750,-160,-160,2,44
20151120,11750,11750,11750,11850,11750,11850,11800,100,50,4,46
20151123,11850,11800,11790,11790,11720,11720,11755,-80,-45,4,48
20151124,11720,11755,11785,11800,11785,11800,11790,45,35,4,46
20151125,11800,11790,12100,12100,12100,12100,12100,310,310,2,48
20151126,12100,12100,,,,12305,12305,205,205,0,48
20151127,12305,12305,12250,12250,12250,12250,12250,-55,-55,2,48
20151130,12250,12250,12255,12255,12255,12255,12255,5,5,2,48
pb1605,20150518,13570,13570,,,,13435,13435,-135,-135,0,0
20150519,13435,13435,,,,13430,13430,-5,-5,0,0
20150520,13430,13430,,,,13220,13220,-210,-210,0,0
20150521,13220,13220,,,,13325,13325,105,105,0,0
20150522,13325,13325,,,,13565,13565,240,240,0,0
20150525,13565,13565,,,,13355,13355,-210,-210,0,0
20150526,13355,13355,,,,13385,13385,30,30,0,0
20150527,13385,13385,,,,13410,13410,25,25,0,0
20150528,13410,13410,13475,13475,13475,13475,13475,65,65,2,2
20150529,13475,13475,13540,13540,13540,13540,13540,65,65,2,2
20150601,13540,13540,13470,13470,13470,13470,13470,-70,-70,4,6
20150602,13470,13470,,,,13325,13325,-145,-145,0,6
20150603,13325,13325,13400,13400,13400,13400,13400,75,75,2,6
20150604,13400,13400,,,,13405,13405,5,5,0,6
20150605,13405,13405,,,,13370,13370,-35,-35,0,6
20150608,13370,13370,,,,13330,13330,-40,-40,0,6
20150609,13330,13330,,,,13270,13270,-60,-60,0,6
20150610,13270,13270,,,,13030,13030,-240,-240,0,6
20150611,13030,13030,,,,13050,13050,20,20,0,6
20150612,13050,13050,,,,13185,13185,135,135,0,6
20150615,13185,13185,13080,13110,13080,13110,13095,-75,-90,4,4
20150616,13110,13095,,,,12595,12595,-500,-500,0,4
20150617,12595,12595,,,,12535,12535,-60,-60,0,4
20150618,12535,12535,,,,13030,13030,495,495,0,4
20150619,13030,13030,,,,13110,13110,80,80,0,4
20150623,13110,13110,,,,13240,13240,130,130,0,4
20150624,13240,13240,13160,13160,13160,13160,13160,-80,-80,6,10
20150625,13160,13160,,,,13150,13150,-10,-10,0,10
20150626,13150,13150,13100,13100,13100,13100,13100,-50,-50,2,12
20150629,13100,13100,,,,12985,12985,-115,-115,0,12
20150630,12985,12985,12760,12760,12760,12760,12760,-225,-225,2,14
20150701,12760,12760,12660,12730,12655,12730,12680,-30,-80,6,14
20150702,12730,12680,12925,12925,12925,12925,12925,245,245,2,16
20150703,12925,12925,,,,12955,12955,30,30,0,16
20150706,12955,12955,12780,12780,12660,12660,12690,-295,-265,8,24
20150707,12660,12690,,,,12630,12630,-60,-60,0,24
20150708,12630,12630,12405,12405,12190,12190,12330,-440,-300,6,24
20150709,12190,12330,,,,12820,12820,490,490,0,24
20150710,12820,12820,,,,13030,13030,210,210,0,24
20150713,13030,13030,12775,12775,12760,12760,12765,-270,-265,4,26
20150714,12760,12765,,,,13110,13110,345,345,0,26
20150715,13110,13110,,,,12995,12995,-115,-115,0,26
20150716,12995,12995,,,,12995,12995,0,0,0,26
20150717,12995,12995,,,,12835,12835,-160,-160,0,26
20150720,12835,12835,,,,12790,12790,-45,-45,0,26
20150721,12790,12790,,,,12800,12800,10,10,0,26
20150722,12800,12800,,,,12525,12525,-275,-275,0,26
20150723,12525,12525,,,,12520,12520,-5,-5,0,26
20150724,12520,12520,,,,12510,12510,-10,-10,0,26
20150727,12510,12510,,,,12355,12355,-155,-155,0,26
20150728,12355,12355,,,,12350,12350,-5,-5,0,26
20150729,12350,12350,,,,12615,12615,265,265,0,26
20150730,12615,12615,12755,12785,12750,12755,12755,140,140,28,44
20150731,12755,12755,12600,12600,12585,12585,12590,-170,-165,10,38
20150803,12585,12590,12480,12480,12450,12450,12465,-140,-125,4,42
20150804,12450,12465,12320,12320,12290,12290,12295,-175,-170,8,40
20150805,12290,12295,12400,12400,12250,12325,12340,30,45,66,74
20150806,12325,12340,12260,12260,12250,12250,12255,-90,-85,4,72
20150807,12250,12255,,,,12255,12255,0,0,0,72
20150810,12255,12255,,,,12300,12300,45,45,0,72
20150811,12300,12300,12550,12550,12415,12415,12480,115,180,4,72
20150812,12415,12480,,,,12975,12975,495,495,0,72
20150813,12975,12975,12650,12650,12650,12650,12650,-325,-325,2,72
20150814,12650,12650,12605,12605,12605,12605,12605,-45,-45,2,72
20150817,12605,12605,12520,12720,12520,12555,12585,-50,-20,8,72
20150818,12555,12585,12695,12695,12565,12565,12610,-20,25,6,72
20150819,12565,12610,12385,12600,12385,12600,12420,-10,-190,40,36
20150820,12600,12420,,,,12620,12620,200,200,0,36
20150821,12620,12620,,,,12620,12620,0,0,0,36
20150824,12620,12620,12545,12745,12375,12695,12565,75,-55,20,32
20150825,12695,12565,12355,12560,12350,12515,12480,-50,-85,12,32
20150826,12515,12480,12845,12890,12845,12890,12875,410,395,6,32
20150827,12890,12875,12565,12620,12565,12620,12590,-255,-285,4,32
20150828,12620,12590,,,,12590,12590,0,0,0,32
20150831,12590,12590,,,,12625,12625,35,35,0,32
20150901,12625,12625,,,,12350,12350,-275,-275,0,32
20150902,12350,12350,,,,12470,12470,120,120,0,32
20150907,12470,12470,,,,12815,12815,345,345,0,32
20150908,12815,12815,,,,12520,12520,-295,-295,0,32
20150909,12520,12520,,,,12645,12645,125,125,0,32
20150910,12645,12645,,,,12535,12535,-110,-110,0,32
20150911,12535,12535,13025,13025,13025,13025,13025,490,490,4,34
20150914,13025,13025,13035,13035,12565,12715,12820,-310,-205,18,40
20150915,12715,12820,,,,12745,12745,-75,-75,0,40
20150916,12745,12745,,,,12795,12795,50,50,0,40
20150917,12795,12795,12740,12740,12740,12740,12740,-55,-55,2,42
20150918,12740,12740,,,,12745,12745,5,5,0,42
20150921,12745,12745,12745,12745,12745,12745,12745,0,0,2,40
20150922,12745,12745,,,,12795,12795,50,50,0,40
20150923,12795,12795,12595,12595,12595,12595,12595,-200,-200,2,38
20150924,12595,12595,,,,12595,12595,0,0,0,38
20150925,12595,12595,,,,12635,12635,40,40,0,38
20150928,12635,12635,,,,12645,12645,10,10,0,38
20150929,12645,12645,,,,12500,12500,-145,-145,0,38
20150930,12500,12500,,,,12830,12830,330,330,0,38
20151008,12830,12830,13380,13380,12700,12700,13040,-130,210,8,40
20151009,12700,13040,,,,13040,13040,0,0,0,40
20151012,13040,13040,13535,13535,13535,13535,13535,495,495,4,44
20151013,13535,13535,13355,13355,13300,13300,13340,-235,-195,8,38
20151014,13300,13340,13500,13500,13355,13440,13440,100,100,14,36
20151015,13440,13440,13405,13405,13405,13405,13405,-35,-35,2,36
20151016,13405,13405,13415,13450,13415,13450,13420,45,15,12,34
20151019,13450,13420,13420,13425,13420,13420,13420,0,0,18,26
20151020,13420,13420,,,,13420,13420,0,0,0,26
20151021,13420,13420,,,,13420,13420,0,0,0,26
20151022,13420,13420,12885,13085,12885,13085,12985,-335,-435,4,26
20151023,13085,12985,12905,13100,12905,13095,13030,110,45,6,28
20151026,13095,13030,,,,13045,13045,15,15,0,28
20151027,13045,13045,,,,13065,13065,20,20,0,28
20151028,13065,13065,,,,13100,13100,35,35,0,28
20151029,13100,13100,,,,13210,13210,110,110,0,28
20151030,13210,13210,,,,13105,13105,-105,-105,0,28
20151102,13105,13105,,,,12865,12865,-240,-240,0,28
20151103,12865,12865,,,,12820,12820,-45,-45,0,28
20151104,12820,12820,,,,12795,12795,-25,-25,0,28
20151105,12795,12795,13115,13115,12695,12695,12960,-100,165,12,32
20151106,12695,12960,,,,12960,12960,0,0,0,32
20151109,12960,12960,,,,12885,12885,-75,-75,0,32
20151110,12885,12885,12795,12795,12640,12640,12700,-245,-185,10,32
20151111,12640,12700,,,,12700,12700,0,0,0,32
20151112,12700,12700,,,,12695,12695,-5,-5,0,32
20151113,12695,12695,,,,12670,12670,-25,-25,0,32
20151116,12670,12670,,,,12590,12590,-80,-80,0,32
20151117,12590,12590,12085,12100,12085,12100,12090,-490,-500,8,40
20151118,12100,12090,,,,12090,12090,0,0,0,40
20151119,12090,12090,12090,12090,11705,11710,11855,-380,-235,54,64
20151120,11710,11855,11520,11900,11520,11800,11625,-55,-230,36,68
20151123,11800,11625,12085,12085,11635,11695,11760,70,135,22,76
20151124,11695,11760,11765,12045,11765,12045,11860,285,100,6,78
20151125,12045,11860,12100,12100,12050,12050,12075,190,215,4,78
20151126,12050,12075,12100,12410,12100,12410,12275,335,200,18,76
20151127,12410,12275,12195,12375,12150,12165,12200,-110,-75,12,76
20151130,12165,12200,,,,12200,12200,0,0,0,76
pb1606,20150616,13095,13095,,,,12595,12595,-500,-500,0,0
20150617,12595,12595,,,,12535,12535,-60,-60,0,0
20150618,12535,12535,,,,13030,13030,495,495,0,0
20150619,13030,13030,,,,13110,13110,80,80,0,0
20150623,13110,13110,,,,13240,13240,130,130,0,0
20150624,13240,13240,,,,13160,13160,-80,-80,0,0
20150625,13160,13160,,,,13150,13150,-10,-10,0,0
20150626,13150,13150,,,,13100,13100,-50,-50,0,0
20150629,13100,13100,,,,12985,12985,-115,-115,0,0
20150630,12985,12985,,,,12760,12760,-225,-225,0,0
20150701,12760,12760,,,,12680,12680,-80,-80,0,0
20150702,12680,12680,,,,12925,12925,245,245,0,0
20150703,12925,12925,,,,12955,12955,30,30,0,0
20150706,12955,12955,12660,12665,12605,12605,12640,-350,-315,16,16
20150707,12605,12640,,,,12580,12580,-60,-60,0,16
20150708,12580,12580,,,,12280,12280,-300,-300,0,16
20150709,12280,12280,,,,12765,12765,485,485,0,16
20150710,12765,12765,,,,12975,12975,210,210,0,16
20150713,12975,12975,,,,12710,12710,-265,-265,0,16
20150714,12710,12710,,,,13055,13055,345,345,0,16
20150715,13055,13055,,,,12940,12940,-115,-115,0,16
20150716,12940,12940,,,,12940,12940,0,0,0,16
20150717,12940,12940,,,,12780,12780,-160,-160,0,16
20150720,12780,12780,,,,12735,12735,-45,-45,0,16
20150721,12735,12735,,,,12745,12745,10,10,0,16
20150722,12745,12745,,,,12470,12470,-275,-275,0,16
20150723,12470,12470,,,,12465,12465,-5,-5,0,16
20150724,12465,12465,,,,12455,12455,-10,-10,0,16
20150727,12455,12455,,,,12305,12305,-150,-150,0,16
20150728,12305,12305,,,,12300,12300,-5,-5,0,16
20150729,12300,12300,,,,12560,12560,260,260,0,16
20150730,12560,12560,12765,12765,12765,12765,12765,205,205,2,18
20150731,12765,12765,,,,12600,12600,-165,-165,0,18
20150803,12600,12600,,,,12470,12470,-130,-130,0,18
20150804,12470,12470,,,,12300,12300,-170,-170,0,18
20150805,12300,12300,,,,12345,12345,45,45,0,18
20150806,12345,12345,,,,12255,12255,-90,-90,0,18
20150807,12255,12255,,,,12140,12140,-115,-115,0,18
20150810,12140,12140,,,,12125,12125,-15,-15,0,18
20150811,12125,12125,,,,12300,12300,175,175,0,18
20150812,12300,12300,,,,12790,12790,490,490,0,18
20150813,12790,12790,,,,12465,12465,-325,-325,0,18
20150814,12465,12465,,,,12420,12420,-45,-45,0,18
20150817,12420,12420,,,,12400,12400,-20,-20,0,18
20150818,12400,12400,,,,12425,12425,25,25,0,18
20150819,12425,12425,,,,12240,12240,-185,-185,0,18
20150820,12240,12240,,,,12440,12440,200,200,0,18
20150821,12440,12440,,,,12440,12440,0,0,0,18
20150824,12440,12440,12925,12935,12315,12320,12675,-120,235,32,18
20150825,12320,12675,12235,12690,12235,12690,12360,15,-315,10,16
20150826,12690,12360,,,,12750,12750,390,390,0,16
20150827,12750,12750,12555,12555,12550,12550,12550,-200,-200,4,16
20150828,12550,12550,,,,12565,12565,15,15,0,16
20150831,12565,12565,,,,12595,12595,30,30,0,16
20150901,12595,12595,,,,12320,12320,-275,-275,0,16
20150902,12320,12320,,,,12440,12440,120,120,0,16
20150907,12440,12440,,,,12785,12785,345,345,0,16
20150908,12785,12785,12775,12775,12775,12775,12775,-10,-10,2,16
20150909,12775,12775,,,,12905,12905,130,130,0,16
20150910,12905,12905,,,,12790,12790,-115,-115,0,16
20150911,12790,12790,,,,13285,13285,495,495,0,16
20150914,13285,13285,,,,13075,13075,-210,-210,0,16
20150915,13075,13075,,,,13000,13000,-75,-75,0,16
20150916,13000,13000,,,,13055,13055,55,55,0,16
20150917,13055,13055,,,,12995,12995,-60,-60,0,16
20150918,12995,12995,,,,13000,13000,5,5,0,16
20150921,13000,13000,,,,13000,13000,0,0,0,16
20150922,13000,13000,,,,13050,13050,50,50,0,16
20150923,13050,13050,,,,12845,12845,-205,-205,0,16
20150924,12845,12845,,,,12965,12965,120,120,0,16
20150925,12965,12965,,,,12965,12965,0,0,0,16
20150928,12965,12965,,,,12975,12975,10,10,0,16
20150929,12975,12975,,,,12825,12825,-150,-150,0,16
20150930,12825,12825,,,,13160,13160,335,335,0,16
20151008,13160,13160,,,,13150,13150,-10,-10,0,16
20151009,13150,13150,13100,13395,12695,13105,13045,-45,-105,30,16
20151012,13105,13045,13190,13190,13190,13190,13190,145,145,2,16
20151013,13190,13190,13200,13200,13200,13200,13200,10,10,2,16
20151014,13200,13200,,,,13295,13295,95,95,0,16
20151015,13295,13295,,,,13260,13260,-35,-35,0,16
20151016,13260,13260,13395,13415,13395,13415,13405,155,145,6,14
20151019,13415,13405,,,,13405,13405,0,0,0,14
20151020,13405,13405,13345,13345,13340,13340,13340,-65,-65,10,14
20151021,13340,13340,,,,13315,13315,-25,-25,0,14
20151022,13315,13315,,,,12880,12880,-435,-435,0,14
20151023,12880,12880,12910,12910,12910,12910,12910,30,30,2,12
20151026,12910,12910,,,,12925,12925,15,15,0,12
20151027,12925,12925,,,,12945,12945,20,20,0,12
20151028,12945,12945,,,,12980,12980,35,35,0,12
20151029,12980,12980,,,,13090,13090,110,110,0,12
20151030,13090,13090,12800,13125,12800,13125,12960,35,-130,4,12
20151102,13125,12960,13185,13340,12760,12760,13000,-200,40,20,16
20151103,12760,13000,12835,12835,12835,12835,12835,-165,-165,2,14
20151104,12835,12835,,,,12835,12835,0,0,0,14
20151105,12835,12835,12885,12885,12885,12885,12885,50,50,2,14
20151106,12885,12885,,,,12790,12790,-95,-95,0,14
20151109,12790,12790,,,,12790,12790,0,0,0,14
20151110,12790,12790,,,,12715,12715,-75,-75,0,14
20151111,12715,12715,,,,12715,12715,0,0,0,14
20151112,12715,12715,,,,12710,12710,-5,-5,0,14
20151113,12710,12710,12310,12310,12310,12310,12310,-400,-400,2,16
20151116,12310,12310,12440,12440,12065,12150,12215,-160,-95,6,16
20151117,12150,12215,,,,12115,12115,-100,-100,0,16
20151118,12115,12115,,,,11730,11730,-385,-385,0,16
20151119,11730,11730,,,,11500,11500,-230,-230,0,16
20151120,11500,11500,,,,11710,11710,210,210,0,16
20151123,11710,11710,11705,11705,11705,11705,11705,-5,-5,2,18
20151124,11705,11705,,,,11805,11805,100,100,0,18
20151125,11805,11805,,,,11805,11805,0,0,0,18
20151126,11805,11805,,,,12000,12000,195,195,0,18
20151127,12000,12000,,,,12000,12000,0,0,0,18
20151130,12000,12000,,,,12000,12000,0,0,0,18
pb1607,20150716,12940,12940,,,,12940,12940,0,0,0,0
20150717,12940,12940,,,,12780,12780,-160,-160,0,0
20150720,12780,12780,,,,12735,12735,-45,-45,0,0
20150721,12735,12735,,,,12745,12745,10,10,0,0
20150722,12745,12745,,,,12470,12470,-275,-275,0,0
20150723,12470,12470,,,,12465,12465,-5,-5,0,0
20150724,12465,12465,,,,12455,12455,-10,-10,0,0
20150727,12455,12455,,,,12305,12305,-150,-150,0,0
20150728,12305,12305,12560,12560,12560,12560,12560,255,255,2,2
20150729,12560,12560,,,,12830,12830,270,270,0,2
20150730,12830,12830,,,,13035,13035,205,205,0,2
20150731,13035,13035,12845,12845,12845,12845,12845,-190,-190,2,4
20150803,12845,12845,12685,12685,12685,12685,12685,-160,-160,2,6
20150804,12685,12685,,,,12510,12510,-175,-175,0,6
20150805,12510,12510,,,,12555,12555,45,45,0,6
20150806,12555,12555,,,,12465,12465,-90,-90,0,6
20150807,12465,12465,,,,12345,12345,-120,-120,0,6
20150810,12345,12345,,,,12330,12330,-15,-15,0,6
20150811,12330,12330,,,,12510,12510,180,180,0,6
20150812,12510,12510,,,,13005,13005,495,495,0,6
20150813,13005,13005,,,,12675,12675,-330,-330,0,6
20150814,12675,12675,,,,12625,12625,-50,-50,0,6
20150817,12625,12625,,,,12605,12605,-20,-20,0,6
20150818,12605,12605,,,,12630,12630,25,25,0,6
20150819,12630,12630,,,,12440,12440,-190,-190,0,6
20150820,12440,12440,,,,12640,12640,200,200,0,6
20150821,12640,12640,,,,12640,12640,0,0,0,6
20150824,12640,12640,,,,12880,12880,240,240,0,6
20150825,12880,12880,12360,12845,12360,12365,12520,-515,-360,6,8
20150826,12365,12520,,,,12915,12915,395,395,0,8
20150827,12915,12915,,,,12710,12710,-205,-205,0,8
20150828,12710,12710,12740,12740,12740,12740,12740,30,30,2,10
20150831,12740,12740,13215,13215,12565,12565,12890,-175,150,4,10
20150901,12565,12890,,,,12610,12610,-280,-280,0,10
20150902,12610,12610,,,,12735,12735,125,125,0,10
20150907,12735,12735,,,,13085,13085,350,350,0,10
20150908,13085,13085,12815,12815,12815,12815,12815,-270,-270,2,10
20150909,12815,12815,,,,12945,12945,130,130,0,10
20150910,12945,12945,,,,12830,12830,-115,-115,0,10
20150911,12830,12830,,,,13330,13330,500,500,0,10
20150914,13330,13330,,,,13120,13120,-210,-210,0,10
20150915,13120,13120,12665,12665,12665,12665,12665,-455,-455,2,12
20150916,12665,12665,,,,12715,12715,50,50,0,12
20150917,12715,12715,12740,12740,12740,12740,12740,25,25,2,14
20150918,12740,12740,,,,12745,12745,5,5,0,14
20150921,12745,12745,12745,12745,12745,12745,12745,0,0,2,12
20150922,12745,12745,,,,12795,12795,50,50,0,12
20150923,12795,12795,,,,12595,12595,-200,-200,0,12
20150924,12595,12595,,,,12715,12715,120,120,0,12
20150925,12715,12715,,,,12755,12755,40,40,0,12
20150928,12755,12755,,,,12765,12765,10,10,0,12
20150929,12765,12765,,,,12615,12615,-150,-150,0,12
20150930,12615,12615,,,,12945,12945,330,330,0,12
20151008,12945,12945,,,,12945,12945,0,0,0,12
20151009,12945,12945,13100,13100,13100,13100,13100,155,155,2,12
20151012,13100,13100,,,,13100,13100,0,0,0,12
20151013,13100,13100,13400,13400,13400,13400,13400,300,300,2,10
20151014,13400,13400,,,,13400,13400,0,0,0,10
20151015,13400,13400,,,,13365,13365,-35,-35,0,10
20151016,13365,13365,,,,13510,13510,145,145,0,10
20151019,13510,13510,13405,13405,13405,13405,13405,-105,-105,2,10
20151020,13405,13405,13300,13300,13300,13300,13300,-105,-105,6,10
20151021,13300,13300,,,,13275,13275,-25,-25,0,10
20151022,13275,13275,,,,12840,12840,-435,-435,0,10
20151023,12840,12840,,,,12865,12865,25,25,0,10
20151026,12865,12865,,,,12880,12880,15,15,0,10
20151027,12880,12880,,,,12900,12900,20,20,0,10
20151028,12900,12900,,,,12935,12935,35,35,0,10
20151029,12935,12935,,,,13040,13040,105,105,0,10
20151030,13040,13040,,,,12910,12910,-130,-130,0,10
20151102,12910,12910,,,,12950,12950,40,40,0,10
20151103,12950,12950,,,,12785,12785,-165,-165,0,10
20151104,12785,12785,,,,12785,12785,0,0,0,10
20151105,12785,12785,,,,12830,12830,45,45,0,10
20151106,12830,12830,,,,12735,12735,-95,-95,0,10
20151109,12735,12735,,,,12660,12660,-75,-75,0,10
20151110,12660,12660,,,,12480,12480,-180,-180,0,10
20151111,12480,12480,,,,12300,12300,-180,-180,0,10
20151112,12300,12300,12325,12470,12080,12460,12310,160,10,12,16
20151113,12460,12310,12225,12225,12225,12225,12225,-85,-85,2,18
20151116,12225,12225,,,,12130,12130,-95,-95,0,18
20151117,12130,12130,11770,11770,11770,11770,11770,-360,-360,2,18
20151118,11770,11770,,,,11395,11395,-375,-375,0,18
20151119,11395,11395,11645,11645,11645,11645,11645,250,250,2,18
20151120,11645,11645,11775,11775,11775,11775,11775,130,130,2,18
20151123,11775,11775,11670,11670,11660,11660,11665,-115,-110,4,18
20151124,11660,11665,11745,11745,11745,11745,11745,80,80,2,18
20151125,11745,11745,12165,12165,12165,12165,12165,420,420,2,18
20151126,12165,12165,12300,12300,12300,12300,12300,135,135,2,16
20151127,12300,12300,,,,12225,12225,-75,-75,0,16
20151130,12225,12225,,,,12225,12225,0,0,0,16
pb1608,20150818,12605,12605,,,,12630,12630,25,25,0,0
20150819,12630,12630,,,,12440,12440,-190,-190,0,0
20150820,12440,12440,,,,12640,12640,200,200,0,0
20150821,12640,12640,,,,12640,12640,0,0,0,0
20150824,12640,12640,,,,12880,12880,240,240,0,0
20150825,12880,12880,,,,12520,12520,-360,-360,0,0
20150826,12520,12520,,,,12915,12915,395,395,0,0
20150827,12915,12915,,,,12710,12710,-205,-205,0,0
20150828,12710,12710,,,,12740,12740,30,30,0,0
20150831,12740,12740,,,,12890,12890,150,150,0,0
20150901,12890,12890,,,,12610,12610,-280,-280,0,0
20150902,12610,12610,,,,12735,12735,125,125,0,0
20150907,12735,12735,,,,13085,13085,350,350,0,0
20150908,13085,13085,,,,12815,12815,-270,-270,0,0
20150909,12815,12815,,,,12945,12945,130,130,0,0
20150910,12945,12945,,,,12830,12830,-115,-115,0,0
20150911,12830,12830,,,,13330,13330,500,500,0,0
20150914,13330,13330,12645,12645,12645,12645,12645,-685,-685,4,4
20150915,12645,12645,,,,12205,12205,-440,-440,0,4
20150916,12205,12205,,,,12255,12255,50,50,0,4
20150917,12255,12255,12740,12745,12740,12745,12740,490,485,4,8
20150918,12745,12740,,,,12745,12745,5,5,0,8
20150921,12745,12745,12745,12745,12745,12745,12745,0,0,2,6
20150922,12745,12745,,,,12795,12795,50,50,0,6
20150923,12795,12795,12495,12495,12495,12495,12495,-300,-300,4,2
20150924,12495,12495,,,,12610,12610,115,115,0,2
20150925,12610,12610,,,,12650,12650,40,40,0,2
20150928,12650,12650,,,,12660,12660,10,10,0,2
20150929,12660,12660,,,,12515,12515,-145,-145,0,2
20150930,12515,12515,,,,12845,12845,330,330,0,2
20151008,12845,12845,,,,13055,13055,210,210,0,2
20151009,13055,13055,,,,13210,13210,155,155,0,2
20151012,13210,13210,12825,13455,12750,13385,13230,175,20,14,10
20151013,13385,13230,13305,13330,13305,13330,13315,100,85,4,8
20151014,13330,13315,13420,13420,13420,13420,13420,105,105,2,10
20151015,13420,13420,,,,13385,13385,-35,-35,0,10
20151016,13385,13385,,,,13530,13530,145,145,0,10
20151019,13530,13530,,,,13420,13420,-110,-110,0,10
20151020,13420,13420,13350,13350,13350,13350,13350,-70,-70,2,10
20151021,13350,13350,,,,13325,13325,-25,-25,0,10
20151022,13325,13325,,,,12890,12890,-435,-435,0,10
20151023,12890,12890,,,,12920,12920,30,30,0,10
20151026,12920,12920,,,,12935,12935,15,15,0,10
20151027,12935,12935,13015,13015,13015,13015,13015,80,80,2,10
20151028,13015,13015,13135,13135,12990,12990,13060,-25,45,4,10
20151029,12990,13060,13005,13005,13005,13005,13005,-55,-55,2,10
20151030,13005,13005,13000,13000,13000,13000,13000,-5,-5,2,12
20151102,13000,13000,,,,13000,13000,0,0,0,12
20151103,13000,13000,,,,12835,12835,-165,-165,0,12
20151104,12835,12835,,,,12810,12810,-25,-25,0,12
20151105,12810,12810,,,,12855,12855,45,45,0,12
20151106,12855,12855,,,,12760,12760,-95,-95,0,12
20151109,12760,12760,,,,12685,12685,-75,-75,0,12
20151110,12685,12685,,,,12500,12500,-185,-185,0,12
20151111,12500,12500,12425,12425,12425,12425,12425,-75,-75,2,14
20151112,12425,12425,,,,12435,12435,10,10,0,14
20151113,12435,12435,,,,12345,12345,-90,-90,0,14
20151116,12345,12345,,,,12250,12250,-95,-95,0,14
20151117,12250,12250,12150,12150,12030,12030,12070,-220,-180,6,18
20151118,12030,12070,11815,11815,11815,11815,11815,-255,-255,2,18
20151119,11815,11815,11725,11725,11725,11725,11725,-90,-90,2,18
20151120,11725,11725,,,,11725,11725,0,0,0,18
20151123,11725,11725,,,,11615,11615,-110,-110,0,18
20151124,11615,11615,,,,11690,11690,75,75,0,18
20151125,11690,11690,12150,12150,12145,12150,12145,460,455,6,16
20151126,12150,12145,,,,12275,12275,130,130,0,16
20151127,12275,12275,12215,12215,12215,12215,12215,-60,-60,2,18
20151130,12215,12215,,,,12215,12215,0,0,0,18
pb1609,20150916,12205,12205,13135,13135,13135,13135,13135,930,930,6,6
20150917,13135,13135,13115,13115,12755,12850,12930,-285,-205,46,26
20150918,12850,12930,12800,12800,12700,12700,12760,-230,-170,8,28
20150921,12700,12760,12505,12505,12250,12250,12310,-510,-450,8,28
20150922,12250,12310,12415,12415,12415,12415,12415,105,105,4,28
20150923,12415,12415,12170,12250,12170,12250,12235,-165,-180,14,18
20150924,12250,12235,,,,12350,12350,115,115,0,18
20150925,12350,12350,,,,12390,12390,40,40,0,18
20150928,12390,12390,,,,12400,12400,10,10,0,18
20150929,12400,12400,12400,12400,12315,12315,12370,-85,-30,6,18
20150930,12315,12370,12595,12595,12595,12595,12595,225,225,2,18
20151008,12595,12595,,,,12800,12800,205,205,0,18
20151009,12800,12800,,,,12950,12950,150,150,0,18
20151012,12950,12950,13250,13250,13250,13250,13250,300,300,2,20
20151013,13250,13250,13250,13350,13250,13350,13310,100,60,30,22
20151014,13350,13310,13375,13375,13305,13305,13340,-5,30,4,22
20151015,13305,13340,,,,13340,13340,0,0,0,22
20151016,13340,13340,,,,13340,13340,0,0,0,22
20151019,13340,13340,,,,13340,13340,0,0,0,22
20151020,13340,13340,,,,13340,13340,0,0,0,22
20151021,13340,13340,13255,13255,13250,13250,13250,-90,-90,4,24
20151022,13250,13250,,,,13250,13250,0,0,0,24
20151023,13250,13250,13035,13035,13010,13010,13015,-240,-235,10,16
20151026,13010,13015,,,,13030,13030,15,15,0,16
20151027,13030,13030,,,,13110,13110,80,80,0,16
20151028,13110,13110,12960,12960,12705,12705,12855,-405,-255,12,26
20151029,12705,12855,12945,12945,12945,12945,12945,90,90,2,26
20151030,12945,12945,,,,12945,12945,0,0,0,26
20151102,12945,12945,12830,12830,12830,12830,12830,-115,-115,4,24
20151103,12830,12830,,,,12665,12665,-165,-165,0,24
20151104,12665,12665,,,,12640,12640,-25,-25,0,24
20151105,12640,12640,,,,12685,12685,45,45,0,24
20151106,12685,12685,,,,12590,12590,-95,-95,0,24
20151109,12590,12590,,,,12590,12590,0,0,0,24
20151110,12590,12590,,,,12590,12590,0,0,0,24
20151111,12590,12590,,,,12590,12590,0,0,0,24
20151112,12590,12590,,,,12600,12600,10,10,0,24
20151113,12600,12600,,,,12300,12300,-300,-300,0,24
20151116,12300,12300,,,,12300,12300,0,0,0,24
20151117,12300,12300,11805,12155,11805,12155,11920,-145,-380,6,26
20151118,12155,11920,,,,11920,11920,0,0,0,26
20151119,11920,11920,,,,11825,11825,-95,-95,0,26
20151120,11825,11825,11495,11965,11495,11965,11730,140,-95,4,30
20151123,11965,11730,11650,11650,11650,11650,11650,-80,-80,2,30
20151124,11650,11650,11950,11950,11950,11950,11950,300,300,2,30
20151125,11950,11950,12165,12165,12165,12165,12165,215,215,10,24
20151126,12165,12165,12480,12480,12480,12480,12480,315,315,2,22
20151127,12480,12480,12005,12005,12005,12005,12005,-475,-475,2,22
20151130,12005,12005,12080,12080,12080,12080,12080,75,75,2,24
pb1610,20151016,13340,13340,,,,13485,13485,145,145,0,0
20151019,13485,13485,,,,13485,13485,0,0,0,0
20151020,13485,13485,,,,13410,13410,-75,-75,0,0
20151021,13410,13410,,,,13320,13320,-90,-90,0,0
20151022,13320,13320,,,,12885,12885,-435,-435,0,0
20151023,12885,12885,,,,12655,12655,-230,-230,0,0
20151026,12655,12655,,,,12670,12670,15,15,0,0
20151027,12670,12670,,,,12745,12745,75,75,0,0
20151028,12745,12745,,,,12495,12495,-250,-250,0,0
20151029,12495,12495,,,,12580,12580,85,85,0,0
20151030,12580,12580,,,,12575,12575,-5,-5,0,0
20151102,12575,12575,,,,12460,12460,-115,-115,0,0
20151103,12460,12460,,,,12300,12300,-160,-160,0,0
20151104,12300,12300,,,,12500,12500,200,200,0,0
20151105,12500,12500,,,,12545,12545,45,45,0,0
20151106,12545,12545,,,,12450,12450,-95,-95,0,0
20151109,12450,12450,,,,12380,12380,-70,-70,0,0
20151110,12380,12380,12450,12450,12450,12450,12450,70,70,2,2
20151111,12450,12450,12370,12370,12370,12370,12370,-80,-80,2,4
20151112,12370,12370,,,,12370,12370,0,0,0,4
20151113,12370,12370,12180,12180,12180,12180,12180,-190,-190,2,6
20151116,12180,12180,,,,12180,12180,0,0,0,6
20151117,12180,12180,,,,12000,12000,-180,-180,0,6
20151118,12000,12000,,,,11745,11745,-255,-255,0,6
20151119,11745,11745,,,,11655,11655,-90,-90,0,6
20151120,11655,11655,11545,11550,11545,11550,11545,-105,-110,8,14
20151123,11550,11545,,,,11465,11465,-80,-80,0,14
20151124,11465,11465,,,,11760,11760,295,295,0,14
20151125,11760,11760,,,,11970,11970,210,210,0,14
20151126,11970,11970,12445,12445,12085,12085,12265,115,295,4,14
20151127,12085,12265,,,,12265,12265,0,0,0,14
20151130,12265,12265,,,,12340,12340,75,75,0,14
pb1611,20151117,12180,12180,12110,12125,12040,12040,12100,-140,-80,10,10
20151118,12040,12100,,,,11840,11840,-260,-260,0,10
20151119,11840,11840,11520,11520,11520,11520,11520,-320,-320,4,14
20151120,11520,11520,11480,11480,11480,11480,11480,-40,-40,4,18
20151123,11480,11480,,,,11400,11400,-80,-80,0,18
20151124,11400,11400,11795,11795,11795,11795,11795,395,395,2,20
20151125,11795,11795,,,,11795,11795,0,0,0,20
20151126,11795,11795,,,,12085,12085,290,290,0,20
20151127,12085,12085,,,,12085,12085,0,0,0,20
20151130,12085,12085,12000,12000,12000,12000,12000,-85,-85,2,22
rb1501,20150105,2595,2607,2640,2640,2551,2580,2569,-27,-38,3556,23040
20150106,2580,2569,2565,2620,2560,2620,2589,51,20,6300,21360
20150107,2620,2589,2600,2600,2570,2580,2577,-9,-12,1860,19560
20150108,2580,2577,2577,2590,2561,2561,2575,-16,-2,3000,16800
20150109,2561,2575,2590,2590,2550,2550,2564,-25,-11,2640,14280
20150112,2550,2564,2550,2560,2461,2461,2518,-103,-46,5040,11940
20150113,2461,2518,2440,2499,2440,2480,2471,-38,-47,840,11700
20150114,2480,2471,2498,2498,2372,2450,2457,-21,-14,1740,10860
20150115,2450,2457,2370,2370,2370,2370,2370,-87,-87,120,10740
rb1502,20150105,2563,2567,2528,2554,2528,2554,2540,-13,-27,542,2090
20150106,2554,2540,2552,2565,2535,2561,2553,21,13,1900,2382
20150107,2561,2553,2538,2556,2511,2552,2541,-1,-12,694,1950
20150108,2552,2541,2557,2557,2539,2547,2546,6,5,270,1804
20150109,2547,2546,2544,2557,2525,2543,2537,-3,-9,368,1774
20150112,2543,2537,2535,2535,2444,2444,2472,-93,-65,312,1972
20150113,2444,2472,2445,2450,2433,2434,2444,-38,-28,608,2420
20150114,2434,2444,2391,2455,2381,2386,2425,-58,-19,1406,2454
20150115,2386,2425,2394,2416,2389,2412,2405,-13,-20,406,2494
20150116,2412,2405,2395,2432,2363,2378,2388,-27,-17,506,2518
20150119,2378,2388,2356,2358,2324,2342,2341,-46,-47,1244,2888
20150120,2342,2341,2364,2364,2313,2317,2330,-24,-11,406,2890
20150121,2317,2330,2327,2333,2302,2302,2323,-28,-7,268,2932
20150122,2302,2323,2307,2313,2295,2295,2300,-28,-23,140,2928
20150123,2295,2300,2306,2306,2291,2295,2296,-5,-4,386,2928
20150126,2295,2296,2215,2300,2204,2205,2238,-91,-58,394,2924
20150127,2205,2238,2215,2230,2200,2209,2220,-29,-18,512,2962
20150128,2209,2220,2215,2217,2195,2209,2204,-11,-16,654,2962
20150129,2209,2204,2218,2228,2201,2206,2212,2,8,568,2908
20150130,2206,2212,2202,2220,2172,2175,2188,-37,-24,1572,2700
20150202,2175,2188,2160,2190,2160,2190,2175,2,-13,420,2400
20150203,2190,2175,2195,2200,2195,2200,2197,25,22,240,2400
20150204,2200,2197,2214,2214,2202,2202,2208,5,11,960,2820
20150205,2202,2208,2180,2181,2150,2170,2174,-38,-34,1440,2400
20150206,2170,2174,2170,2180,2170,2180,2173,6,-1,1020,2400
20150209,2180,2173,2180,2250,2180,2250,2201,77,28,1200,3120
20150210,2250,2201,2200,2200,2200,2200,2200,-1,-1,60,3120
rb1503,20150105,2573,2595,2564,2564,2543,2555,2549,-40,-46,82,942
20150106,2555,2549,2565,2619,2565,2612,2605,63,56,72,946
20150107,2612,2605,2597,2599,2553,2562,2565,-43,-40,274,842
20150108,2562,2565,2561,2573,2545,2553,2559,-12,-6,94,816
20150109,2553,2559,2554,2561,2536,2550,2551,-9,-8,54,812
20150112,2550,2551,2552,2578,2485,2485,2522,-66,-29,312,956
20150113,2485,2522,2473,2486,2462,2467,2471,-55,-51,176,954
20150114,2467,2471,2468,2481,2425,2450,2451,-21,-20,74,942
20150115,2450,2451,2439,2455,2412,2441,2442,-10,-9,380,1012
20150116,2441,2442,2442,2470,2405,2413,2432,-29,-10,558,1132
20150119,2413,2432,2411,2411,2371,2405,2388,-27,-44,1796,2364
20150120,2405,2388,2414,2414,2340,2340,2358,-48,-30,1250,3416
20150121,2340,2358,2347,2363,2338,2347,2354,-11,-4,216,3424
20150122,2347,2354,2354,2362,2317,2317,2339,-37,-15,148,3492
20150123,2317,2339,2320,2350,2320,2338,2336,-1,-3,210,3460
20150126,2338,2336,2330,2341,2265,2272,2301,-64,-35,1150,4050
20150127,2272,2301,2289,2299,2281,2286,2289,-15,-12,550,4000
20150128,2286,2289,2290,2294,2265,2270,2274,-19,-15,672,4288
20150129,2270,2274,2275,2298,2271,2282,2282,8,8,320,4258
20150130,2282,2282,2284,2292,2270,2272,2274,-10,-8,790,4694
20150202,2272,2274,2288,2288,2251,2264,2265,-10,-9,436,4884
20150203,2264,2265,2265,2265,2242,2242,2252,-23,-13,440,5008
20150204,2242,2252,2234,2256,2224,2227,2241,-25,-11,1124,5404
20150205,2227,2241,2237,2246,2229,2230,2232,-11,-9,356,5454
20150206,2230,2232,2233,2239,2228,2232,2232,0,0,100,5454
20150209,2232,2232,2235,2238,2210,2229,2229,-3,-3,222,5458
20150210,2229,2229,2223,2254,2223,2243,2242,14,13,428,5210
20150211,2243,2242,2237,2243,2233,2241,2242,-1,0,736,5230
20150212,2241,2242,2236,2239,2231,2237,2233,-5,-9,238,5228
20150213,2237,2233,2226,2248,2222,2238,2240,5,7,364,5228
20150216,2238,2240,2236,2255,2233,2247,2247,7,7,332,5208
20150217,2247,2247,2242,2255,2232,2255,2243,8,-4,440,5220
20150225,2255,2243,2243,2243,2183,2220,2217,-23,-26,312,5172
20150226,2220,2217,2212,2225,2212,2222,2221,5,4,1708,5192
20150227,2222,2221,2201,2227,2109,2109,2208,-112,-13,4066,5160
20150302,2109,2208,2131,2180,2115,2180,2132,-28,-76,2160,5160
20150303,2180,2132,2131,2155,2131,2155,2141,23,9,240,5160
20150304,2155,2141,2140,2178,2140,2152,2157,11,16,840,5160
20150305,2152,2157,2148,2148,2148,2148,2148,-9,-9,120,5160
20150306,2148,2148,2126,2126,2126,2126,2126,-22,-22,120,5160
20150309,2126,2126,2152,2152,2134,2134,2139,8,13,300,5160
20150310,2134,2139,2037,2124,2037,2120,2105,-19,-34,360,5160
20150311,2120,2105,2115,2120,2100,2109,2111,4,6,780,5160
20150312,2109,2111,2139,2160,2130,2160,2146,49,35,420,5160
20150313,2160,2146,2160,2160,2160,2160,2160,14,14,480,4740
20150316,2160,2160,2160,2200,2160,2200,2186,40,26,180,4680
rb1504,20150105,2600,2604,2578,2632,2501,2564,2560,-40,-44,1318,552
20150106,2564,2560,2561,2629,2561,2626,2620,66,60,580,776
20150107,2626,2620,2600,2600,2573,2586,2585,-34,-35,156,750
20150108,2586,2585,2591,2601,2530,2569,2577,-16,-8,232,704
20150109,2569,2577,2582,2584,2550,2560,2561,-17,-16,478,702
20150112,2560,2561,2560,2570,2503,2503,2528,-58,-33,130,684
20150113,2503,2528,2488,2507,2483,2496,2497,-32,-31,170,696
20150114,2496,2497,2504,2510,2453,2481,2486,-16,-11,106,684
20150115,2481,2486,2482,2513,2462,2512,2487,26,1,50,678
20150116,2512,2487,2511,2511,2466,2499,2494,12,7,258,740
20150119,2499,2494,2490,2501,2459,2500,2477,6,-17,536,878
20150120,2500,2477,2495,2495,2468,2477,2478,0,1,52,880
20150121,2477,2478,2468,2489,2451,2458,2471,-20,-7,202,962
20150122,2458,2471,2460,2467,2451,2461,2461,-10,-10,136,986
20150123,2461,2461,2459,2473,2447,2456,2457,-5,-4,1338,1382
20150126,2456,2457,2450,2455,2367,2407,2415,-50,-42,1056,1798
20150127,2407,2415,2411,2426,2409,2413,2415,-2,0,586,1904
20150128,2413,2415,2415,2432,2398,2400,2411,-15,-4,626,1898
20150129,2400,2411,2406,2436,2405,2435,2414,24,3,178,1894
20150130,2435,2414,2430,2430,2410,2410,2411,-4,-3,58,1886
20150202,2410,2411,2425,2437,2400,2424,2429,13,18,478,1848
20150203,2424,2429,2413,2439,2413,2420,2426,-9,-3,248,1774
20150204,2420,2426,2416,2439,2401,2401,2413,-25,-13,224,1724
20150205,2401,2413,2413,2429,2400,2408,2405,-5,-8,100,1736
20150206,2408,2405,2400,2416,2400,2405,2406,0,1,330,1720
20150209,2405,2406,2406,2412,2375,2377,2390,-29,-16,742,1678
20150210,2377,2390,2386,2394,2378,2391,2386,1,-4,486,1854
20150211,2391,2386,2392,2404,2387,2396,2397,10,11,232,1826
20150212,2396,2397,2410,2414,2387,2395,2396,-2,-1,46,1834
20150213,2395,2396,2397,2438,2397,2431,2422,35,26,184,1784
20150216,2431,2422,2433,2486,2433,2468,2474,46,52,428,1684
20150217,2468,2474,2474,2484,2451,2451,2463,-23,-11,212,1758
20150225,2451,2463,2428,2428,2410,2414,2414,-49,-49,428,1956
20150226,2414,2414,2411,2429,2410,2421,2419,7,5,262,1822
20150227,2421,2419,2410,2439,2370,2372,2402,-47,-17,778,1926
20150302,2372,2402,2369,2369,2317,2355,2349,-47,-53,662,1800
20150303,2355,2349,2368,2368,2329,2343,2346,-6,-3,40,1796
20150304,2343,2346,2342,2368,2325,2364,2347,18,1,164,1850
20150305,2364,2347,2364,2400,2346,2395,2380,48,33,2146,3078
20150306,2395,2380,2390,2399,2368,2375,2382,-5,2,678,3152
20150309,2375,2382,2374,2377,2321,2329,2344,-53,-38,1624,3898
20150310,2329,2344,2329,2334,2266,2283,2303,-61,-41,698,4286
20150311,2283,2303,2256,2283,2245,2270,2272,-33,-31,1962,3042
20150312,2270,2272,2270,2270,2238,2242,2259,-30,-13,1586,2044
20150313,2242,2259,2255,2274,2241,2258,2252,-1,-7,484,1706
20150316,2258,2252,2260,2285,2251,2282,2267,30,15,256,1580
20150317,2282,2267,2292,2306,2292,2293,2295,26,28,164,1518
20150318,2293,2295,2288,2303,2279,2296,2289,1,-6,888,1082
20150319,2296,2289,2304,2307,2282,2288,2296,-1,7,108,1032
20150320,2288,2296,2387,2387,2288,2305,2299,9,3,236,824
20150323,2305,2299,2326,2398,2304,2398,2344,99,45,182,784
20150324,2398,2344,2366,2410,2300,2399,2353,55,9,264,784
20150325,2399,2353,2377,2420,2367,2381,2382,28,29,74,804
20150326,2381,2382,2407,2407,2362,2375,2380,-7,-2,98,790
20150327,2375,2380,2373,2373,2346,2359,2355,-21,-25,74,756
20150330,2359,2355,2361,2370,2350,2351,2355,-4,0,42,734
20150331,2351,2355,2335,2456,2243,2280,2287,-75,-68,270,720
20150401,2280,2287,2231,2299,2231,2299,2265,12,-22,120,720
20150402,2299,2265,2300,2300,2300,2300,2300,35,35,60,720
20150403,2300,2300,,,,2300,2300,0,0,0,720
20150407,2300,2300,2185,2220,2185,2220,2202,-80,-98,120,720
20150408,2220,2202,2220,2220,2200,2200,2210,-2,8,180,720
20150409,2200,2210,,,,2210,2210,0,0,0,720
20150410,2210,2210,,,,2210,2210,0,0,0,720
20150413,2210,2210,2199,2320,2199,2320,2259,110,49,120,600
20150414,2320,2259,,,,2259,2259,0,0,0,600
20150415,2259,2259,,,,2259,2259,0,0,0,600
rb1505,20150105,2594,2593,2550,2570,2540,2560,2556,-33,-37,2891694,2212768
20150106,2560,2556,2551,2647,2548,2619,2612,63,56,7434538,2279112
20150107,2619,2612,2615,2615,2568,2585,2586,-27,-26,4317868,2225372
20150108,2585,2586,2585,2603,2563,2579,2580,-7,-6,3696668,2206252
20150109,2579,2580,2584,2588,2546,2557,2564,-23,-16,3561070,2156408
20150112,2557,2564,2557,2585,2501,2502,2537,-62,-27,5204600,2193666
20150113,2502,2537,2498,2514,2483,2511,2503,-26,-34,3337222,2189134
20150114,2511,2503,2499,2520,2456,2487,2487,-16,-16,5060470,2181418
20150115,2487,2487,2483,2524,2472,2519,2495,32,8,4426394,2191982
20150116,2519,2495,2519,2532,2497,2510,2512,15,17,3898388,2247512
20150119,2510,2512,2499,2526,2470,2516,2501,4,-11,5840042,2161770
20150120,2516,2501,2512,2528,2486,2488,2502,-13,1,3804648,2224690
20150121,2488,2502,2485,2513,2470,2472,2493,-30,-9,4067256,2226796
20150122,2472,2493,2461,2491,2460,2479,2481,-14,-12,3426746,2207310
20150123,2479,2481,2478,2496,2471,2484,2483,3,2,3686640,2299782
20150126,2484,2483,2482,2486,2441,2450,2462,-33,-21,4693054,2326654
20150127,2450,2462,2454,2467,2449,2455,2457,-7,-5,2345892,2285488
20150128,2455,2457,2463,2475,2454,2474,2465,17,8,2453880,2243590
20150129,2474,2465,2472,2513,2470,2507,2495,42,30,3767108,2260960
20150130,2507,2495,2514,2514,2491,2498,2500,3,5,2275316,2208752
20150202,2498,2500,2503,2526,2486,2492,2496,-8,-4,2749940,2057418
20150203,2492,2496,2496,2504,2473,2474,2488,-22,-8,2576944,1912324
20150204,2474,2488,2480,2512,2466,2467,2484,-21,-4,2889450,1794316
20150205,2467,2484,2480,2492,2472,2472,2480,-12,-4,1784504,1728068
20150206,2472,2480,2476,2497,2475,2496,2487,16,7,1633356,1588346
20150209,2496,2487,2495,2509,2465,2478,2480,-9,-7,1506170,1597580
20150210,2478,2480,2477,2495,2476,2489,2486,9,6,826546,1507600
20150211,2489,2486,2492,2495,2480,2490,2485,4,-1,605922,1471758
20150212,2490,2485,2490,2495,2474,2489,2483,4,-2,691294,1460666
20150213,2489,2483,2488,2520,2487,2514,2506,31,23,1430356,1521308
20150216,2514,2506,2514,2549,2509,2524,2532,18,26,1218768,1552574
20150217,2524,2532,2524,2530,2504,2521,2515,-11,-17,804402,1527150
20150225,2521,2515,2513,2514,2475,2483,2489,-32,-26,890868,1463886
20150226,2483,2489,2486,2509,2485,2505,2496,16,7,863160,1547910
20150227,2505,2496,2510,2510,2462,2464,2487,-32,-9,1378260,1612236
20150302,2464,2487,2462,2483,2426,2472,2456,-15,-31,2769934,1673788
20150303,2472,2456,2466,2482,2452,2468,2466,12,10,1199714,1592766
20150304,2468,2466,2464,2470,2454,2464,2461,-2,-5,693690,1584954
20150305,2464,2461,2466,2467,2428,2447,2443,-14,-18,1213754,1519172
20150306,2447,2443,2445,2448,2416,2418,2433,-25,-10,585192,1495696
20150309,2418,2433,2417,2431,2385,2400,2406,-33,-27,1240642,1491716
20150310,2400,2406,2400,2404,2352,2353,2377,-53,-29,887642,1527800
20150311,2353,2377,2354,2375,2350,2369,2363,-8,-14,568076,1417234
20150312,2369,2363,2371,2399,2362,2386,2382,23,19,643664,1304910
20150313,2386,2382,2403,2403,2376,2388,2389,6,7,434066,1276322
20150316,2388,2389,2388,2418,2380,2413,2398,24,9,506856,1217072
20150317,2413,2398,2414,2422,2407,2410,2413,12,15,306086,1149468
20150318,2410,2413,2408,2426,2400,2410,2411,-3,-2,650988,998638
20150319,2410,2411,2407,2423,2401,2412,2412,1,1,290954,969330
20150320,2412,2412,2415,2420,2408,2410,2414,-2,2,197098,938092
20150323,2410,2414,2412,2470,2408,2469,2444,55,30,634862,765832
20150324,2469,2444,2472,2485,2463,2468,2474,24,30,456390,662806
20150325,2468,2474,2470,2475,2445,2446,2461,-28,-13,328812,608612
20150326,2446,2461,2445,2452,2416,2418,2435,-43,-26,309356,577662
20150327,2418,2435,2420,2428,2361,2426,2396,-9,-39,641282,518758
20150330,2426,2396,2421,2441,2411,2419,2425,23,29,434688,482894
20150331,2419,2425,2442,2442,2392,2392,2414,-33,-11,394652,424562
20150401,2392,2414,2390,2401,2367,2371,2384,-43,-30,311098,380470
20150402,2371,2384,2363,2404,2343,2351,2369,-33,-15,433616,312562
20150403,2351,2369,2351,2379,2345,2352,2360,-17,-9,233458,294744
20150407,2352,2360,2343,2352,2290,2290,2316,-70,-44,250514,292246
20150408,2290,2316,2287,2307,2257,2297,2282,-19,-34,213354,267968
20150409,2297,2282,2293,2296,2259,2261,2274,-21,-8,123868,255566
20150410,2261,2274,2259,2265,2214,2222,2232,-52,-42,159028,237680
20150413,2222,2232,2225,2274,2218,2269,2239,37,7,160718,223148
20150414,2269,2239,2269,2280,2242,2266,2259,27,20,117402,205026
20150415,2266,2259,2266,2278,2257,2267,2271,8,12,76132,190858
20150416,2267,2271,2260,2285,2259,2281,2273,10,2,57704,178594
20150417,2281,2273,2278,2300,2278,2296,2290,23,17,63026,162214
20150420,2296,2290,2289,2298,2275,2280,2285,-10,-5,55504,153352
20150421,2280,2285,2276,2278,2229,2239,2249,-46,-36,50348,148778
20150422,2239,2249,2239,2280,2239,2275,2258,26,9,35952,139320
20150423,2275,2258,2277,2278,2256,2260,2266,2,8,29746,131410
20150424,2260,2266,2264,2315,2262,2297,2286,31,20,46050,114292
20150427,2297,2286,2302,2310,2270,2283,2285,-3,-1,33762,103556
20150428,2283,2285,2289,2290,2260,2269,2278,-16,-7,33644,89156
20150429,2269,2278,2270,2272,2221,2230,2247,-48,-31,32588,76804
20150430,2230,2247,2279,2279,2183,2198,2206,-49,-41,49800,48464
20150504,2198,2206,2190,2224,2181,2211,2203,5,-3,8744,41340
20150505,2211,2203,2218,2220,2205,2220,2211,17,8,5580,39420
20150506,2220,2211,2210,2223,2200,2201,2208,-10,-3,3240,37020
20150507,2201,2208,2200,2201,2185,2185,2197,-23,-11,3120,34320
20150508,2185,2197,2190,2190,2170,2172,2174,-25,-23,4560,32400
20150511,2172,2174,2172,2188,2144,2145,2160,-29,-14,4560,30660
20150512,2145,2160,2131,2131,2052,2052,2084,-108,-76,12600,29340
20150513,2052,2084,2052,2099,2052,2080,2075,-4,-9,3480,26580
20150514,2080,2075,2088,2090,2073,2079,2080,4,5,3360,25500
20150515,2079,2080,2080,2088,2072,2088,2076,8,-4,1620,25500
rb1506,20150105,2583,2579,2536,2562,2536,2552,2553,-27,-26,1620,2368
20150106,2552,2553,2561,2654,2557,2612,2602,59,49,650,2314
20150107,2612,2602,2594,2594,2567,2577,2582,-25,-20,20116,3524
20150108,2577,2582,2580,2594,2559,2575,2574,-7,-8,1162,3350
20150109,2575,2574,2576,2579,2545,2559,2556,-15,-18,906,3786
20150112,2559,2556,2560,2578,2500,2503,2530,-53,-26,1948,3584
20150113,2503,2530,2483,2514,2483,2503,2502,-27,-28,328,3570
20150114,2503,2502,2506,2513,2448,2482,2479,-20,-23,1322,3782
20150115,2482,2479,2482,2514,2469,2507,2491,28,12,1026,3768
20150116,2507,2491,2513,2523,2489,2503,2507,12,16,402,3810
20150119,2503,2507,2503,2524,2473,2518,2500,11,-7,894,3826
20150120,2518,2500,2501,2523,2487,2488,2507,-12,7,670,3876
20150121,2488,2507,2489,2509,2479,2479,2489,-28,-18,598,4000
20150122,2479,2489,2471,2493,2471,2483,2487,-6,-2,674,3980
20150123,2483,2487,2486,2500,2476,2484,2489,-3,2,416,3946
20150126,2484,2489,2480,2491,2450,2457,2464,-32,-25,872,3964
20150127,2457,2464,2466,2474,2459,2466,2464,2,0,142,3962
20150128,2466,2464,2473,2476,2462,2475,2467,11,3,620,4148
20150129,2475,2467,2478,2504,2470,2499,2488,32,21,476,4138
20150130,2499,2488,2503,2503,2488,2490,2491,2,3,328,4154
20150202,2490,2491,2492,2502,2482,2486,2489,-5,-2,322,4176
20150203,2486,2489,2491,2498,2475,2479,2486,-10,-3,530,4284
20150204,2479,2486,2486,2509,2472,2472,2483,-14,-3,432,4312
20150205,2472,2483,2505,2511,2479,2479,2488,-4,5,662,4362
20150206,2479,2488,2489,2498,2486,2497,2494,9,6,528,4102
20150209,2497,2494,2497,2510,2476,2488,2490,-6,-4,608,4274
20150210,2488,2490,2487,2497,2487,2490,2491,0,1,590,4218
20150211,2490,2491,2491,2494,2483,2488,2488,-3,-3,296,4188
20150212,2488,2488,2490,2493,2481,2490,2487,2,-1,252,4154
20150213,2490,2487,2488,2518,2488,2515,2501,28,14,582,4154
20150216,2515,2501,2516,2545,2513,2528,2532,27,31,1136,4280
20150217,2528,2532,2528,2528,2502,2519,2511,-13,-21,354,4218
20150225,2519,2511,2502,2502,2480,2488,2486,-23,-25,412,4178
20150226,2488,2486,2490,2508,2488,2504,2494,18,8,742,4188
20150227,2504,2494,2505,2510,2466,2466,2490,-28,-4,1048,4520
20150302,2466,2490,2465,2488,2443,2480,2462,-10,-28,1806,4784
20150303,2480,2462,2483,2488,2463,2477,2474,15,12,570,4864
20150304,2477,2474,2475,2477,2465,2473,2471,-1,-3,466,4862
20150305,2473,2471,2468,2468,2440,2450,2452,-21,-19,732,5018
20150306,2450,2452,2447,2452,2424,2430,2442,-22,-10,756,5130
20150309,2430,2442,2417,2434,2394,2410,2412,-32,-30,1018,5438
20150310,2410,2412,2410,2411,2356,2361,2380,-51,-32,876,5660
20150311,2361,2380,2358,2382,2357,2376,2369,-4,-11,792,5750
20150312,2376,2369,2372,2404,2369,2396,2384,27,15,426,5670
20150313,2396,2384,2409,2409,2388,2397,2398,13,14,334,5726
20150316,2397,2398,2398,2427,2390,2422,2412,24,14,442,5692
20150317,2422,2412,2419,2448,2401,2424,2421,12,9,1618,5698
20150318,2424,2421,2427,2433,2409,2415,2419,-6,-2,360,5572
20150319,2415,2419,2416,2427,2410,2418,2418,-1,-1,814,5734
20150320,2418,2418,2416,2429,2416,2419,2422,1,4,280,5552
20150323,2419,2422,2415,2471,2415,2469,2453,47,31,1052,5374
20150324,2469,2453,2475,2500,2469,2476,2479,23,26,1450,5090
20150325,2476,2479,2474,2481,2456,2456,2467,-23,-12,622,4862
20150326,2456,2467,2430,2466,2430,2441,2454,-26,-13,654,4620
20150327,2441,2454,2438,2450,2366,2450,2410,-4,-44,950,4342
20150330,2450,2410,2465,2465,2428,2440,2441,30,31,394,4316
20150331,2440,2441,2448,2449,2407,2412,2426,-29,-15,500,4338
20150401,2412,2426,2405,2415,2382,2382,2399,-44,-27,510,4180
20150402,2382,2399,2374,2410,2360,2363,2380,-36,-19,796,4118
20150403,2363,2380,2364,2387,2364,2370,2369,-10,-11,556,4066
20150407,2370,2369,2360,2360,2326,2330,2341,-39,-28,1062,3864
20150408,2330,2341,2324,2340,2314,2327,2326,-14,-15,1014,3438
20150409,2327,2326,2337,2337,2300,2300,2313,-26,-13,522,3298
20150410,2300,2313,2276,2292,2223,2246,2267,-67,-46,772,3010
20150413,2246,2267,2248,2305,2248,2302,2276,35,9,476,2998
20150414,2302,2276,2309,2327,2291,2304,2314,28,38,1422,3252
20150415,2304,2314,2303,2309,2292,2293,2297,-21,-17,456,3032
20150416,2293,2297,2282,2299,2280,2293,2286,-4,-11,658,3142
20150417,2293,2286,2292,2309,2287,2292,2294,6,8,532,3154
20150420,2292,2294,2301,2303,2251,2256,2277,-38,-17,768,3292
20150421,2256,2277,2254,2254,2223,2228,2238,-49,-39,442,3376
20150422,2228,2238,2227,2282,2227,2270,2255,32,17,778,3442
20150423,2270,2255,2245,2273,2179,2268,2264,13,9,536,3596
20150424,2268,2264,2263,2307,2263,2301,2291,37,27,1090,3498
20150427,2301,2291,2302,2315,2287,2315,2302,24,11,504,3510
20150428,2315,2302,2322,2323,2293,2300,2306,-2,4,824,3600
20150429,2300,2306,2308,2314,2236,2245,2278,-61,-28,782,3594
20150430,2245,2278,2242,2276,2240,2249,2256,-29,-22,628,3692
20150504,2249,2256,2242,2310,2242,2280,2279,24,23,672,3686
20150505,2280,2279,2296,2306,2277,2291,2288,12,9,742,3760
20150506,2291,2288,2301,2303,2251,2267,2272,-21,-16,964,3712
20150507,2267,2272,2253,2270,2223,2241,2242,-31,-30,706,3650
20150508,2241,2242,2245,2246,2230,2233,2238,-9,-4,570,3674
20150511,2233,2238,2220,2243,2220,2230,2230,-8,-8,890,3836
20150512,2230,2230,2228,2231,2190,2192,2208,-38,-22,2218,4512
20150513,2192,2208,2185,2198,2175,2176,2185,-32,-23,384,4598
20150514,2176,2185,2180,2189,2168,2175,2174,-10,-11,514,4670
20150515,2175,2174,2170,2170,2154,2162,2163,-12,-11,456,4836
20150518,2162,2163,2154,2160,2150,2151,2154,-12,-9,546,4820
20150519,2151,2154,2145,2155,2141,2150,2149,-4,-5,438,4762
20150520,2150,2149,2133,2146,2101,2109,2121,-40,-28,338,4604
20150521,2109,2121,2090,2117,2088,2110,2104,-11,-17,336,4540
20150522,2110,2104,2111,2111,2100,2104,2102,0,-2,336,4562
20150525,2104,2102,2102,2113,2102,2108,2110,6,8,1524,4364
20150526,2108,2110,2106,2113,2093,2093,2100,-17,-10,414,4372
20150527,2093,2100,2071,2092,2064,2071,2073,-29,-27,836,4320
20150528,2071,2073,1999,2072,1978,2053,2054,-20,-19,1352,3506
20150529,2053,2054,2053,2068,2042,2042,2055,-12,1,1594,2674
20150601,2042,2055,2042,2090,2042,2090,2072,35,17,94,2580
20150602,2090,2072,2070,2070,2070,2070,2070,-2,-2,60,2520
20150603,2070,2070,2030,2054,2030,2054,2042,-16,-28,360,2280
20150604,2054,2042,2082,2082,2056,2056,2069,14,27,120,2220
20150605,2056,2069,2136,2136,2053,2053,2097,-16,28,660,2160
20150608,2053,2097,2111,2111,2061,2061,2086,-36,-11,120,2100
20150609,2061,2086,2045,2050,2045,2050,2047,-36,-39,120,2040
20150610,2050,2047,2045,2055,2045,2048,2049,1,2,360,2040
20150611,2048,2049,2036,2036,2029,2029,2032,-20,-17,480,1920
20150612,2029,2032,2021,2021,2021,2021,2021,-11,-11,60,1920
20150615,2021,2021,2000,2000,2000,2000,2000,-21,-21,60,1920
rb1507,20150105,2609,2596,2504,2591,2504,2556,2563,-40,-33,64,422
20150106,2556,2563,2614,2657,2613,2632,2630,69,67,30,398
20150107,2632,2630,2603,2603,2575,2589,2592,-41,-38,54,396
20150108,2589,2592,2595,2595,2572,2580,2576,-12,-16,26,394
20150109,2580,2576,2579,2589,2558,2574,2562,-2,-14,116,330
20150112,2574,2562,2462,2580,2462,2530,2555,-32,-7,212,338
20150113,2530,2555,2521,2523,2521,2523,2522,-32,-33,6,338
20150114,2523,2522,2526,2526,2483,2501,2497,-21,-25,28,344
20150115,2501,2497,2502,2530,2493,2530,2512,33,15,18,336
20150116,2530,2512,2519,2522,2517,2520,2519,8,7,60,336
20150119,2520,2519,2495,2524,2487,2524,2504,5,-15,18,334
20150120,2524,2504,2510,2524,2504,2504,2507,0,3,42,320
20150121,2504,2507,2510,2522,2502,2502,2508,-5,1,28,310
20150122,2502,2508,2498,2504,2494,2496,2498,-12,-10,32,312
20150123,2496,2498,2510,2510,2506,2508,2508,10,10,10,310
20150126,2508,2508,2495,2500,2468,2472,2479,-36,-29,60,302
20150127,2472,2479,2476,2489,2476,2485,2483,6,4,34,316
20150128,2485,2483,2487,2494,2482,2494,2486,11,3,30,310
20150129,2494,2486,2499,2530,2499,2519,2518,33,32,80,296
20150130,2519,2518,2517,2525,2510,2516,2513,-2,-5,50,264
20150202,2516,2513,2532,2532,2504,2511,2511,-2,-2,50,266
20150203,2511,2511,2513,2519,2498,2502,2508,-9,-3,40,254
20150204,2502,2508,2508,2508,2497,2497,2501,-11,-7,34,260
20150205,2497,2501,2514,2515,2504,2510,2510,9,9,246,472
20150206,2510,2510,2515,2521,2514,2514,2517,4,7,36,452
20150209,2514,2517,2517,2517,2503,2517,2511,0,-6,22,460
20150210,2517,2511,2517,2518,2511,2514,2513,3,2,76,450
20150211,2514,2513,2510,2515,2510,2515,2511,2,-2,28,448
20150212,2515,2511,2505,2515,2486,2515,2505,4,-6,18,440
20150213,2515,2505,2513,2549,2510,2541,2532,36,27,54,452
20150216,2541,2532,2556,2569,2545,2550,2559,18,27,84,440
20150217,2550,2559,2543,2544,2534,2544,2539,-15,-20,8,440
20150225,2544,2539,,,,2515,2515,-24,-24,0,440
20150226,2515,2515,2512,2529,2512,2529,2518,14,3,14,434
20150227,2529,2518,2528,2528,2505,2505,2516,-13,-2,98,522
20150302,2505,2516,2502,2538,2478,2523,2509,7,-7,322,510
20150303,2523,2509,2521,2533,2511,2518,2517,9,8,72,516
20150304,2518,2517,2511,2516,2503,2509,2506,-8,-11,132,552
20150305,2509,2506,2491,2493,2474,2487,2482,-19,-24,218,656
20150306,2487,2482,2487,2488,2465,2466,2477,-16,-5,48,662
20150309,2466,2477,2454,2454,2434,2446,2449,-31,-28,24,660
20150310,2446,2449,2449,2449,2407,2410,2422,-39,-27,72,718
20150311,2410,2422,2409,2423,2401,2416,2415,-6,-7,38,716
20150312,2416,2415,2415,2442,2409,2428,2429,13,14,46,710
20150313,2428,2429,2428,2436,2425,2431,2430,2,1,70,716
20150316,2431,2430,2433,2450,2432,2447,2444,17,14,70,670
20150317,2447,2444,2445,2452,2445,2451,2449,7,5,6,670
20150318,2451,2449,2426,2452,2424,2452,2441,3,-8,28,672
20150319,2452,2441,2453,2457,2445,2446,2447,5,6,32,658
20150320,2446,2447,2444,2460,2444,2459,2458,12,11,56,696
20150323,2459,2458,2457,2500,2457,2500,2481,42,23,44,674
20150324,2500,2481,2510,2525,2510,2510,2515,29,34,28,680
20150325,2510,2515,2504,2517,2474,2474,2502,-41,-13,144,660
20150326,2474,2502,2486,2490,2460,2465,2470,-37,-32,76,680
20150327,2465,2470,2460,2465,2413,2465,2434,-5,-36,164,648
20150330,2465,2434,2487,2487,2439,2466,2463,32,29,104,640
20150331,2466,2463,2453,2477,2441,2441,2462,-22,-1,94,668
20150401,2441,2462,2417,2437,2417,2417,2427,-45,-35,36,672
20150402,2417,2427,2398,2424,2378,2387,2400,-40,-27,82,692
20150403,2387,2400,2391,2411,2379,2392,2391,-8,-9,54,696
20150407,2392,2391,2366,2366,2332,2340,2347,-51,-44,94,696
20150408,2340,2347,2329,2343,2314,2343,2325,-4,-22,86,696
20150409,2343,2325,2324,2344,2324,2344,2337,19,12,6,702
20150410,2344,2337,2303,2304,2222,2281,2263,-56,-74,164,674
20150413,2281,2263,2273,2318,2268,2318,2286,55,23,136,636
20150414,2318,2286,2312,2341,2308,2326,2316,40,30,122,680
20150415,2326,2316,2315,2336,2315,2315,2326,-1,10,136,664
20150416,2315,2326,2320,2329,2310,2321,2320,-5,-6,74,636
20150417,2321,2320,2342,2342,2324,2324,2332,4,12,38,626
20150420,2324,2332,2306,2334,2306,2323,2319,-9,-13,12,624
20150421,2323,2319,2282,2313,2280,2280,2289,-39,-30,44,616
20150422,2280,2289,2288,2323,2286,2305,2294,16,5,62,602
20150423,2305,2294,,,,2294,2294,0,0,0,602
20150424,2294,2294,2324,2358,2320,2330,2324,36,30,128,570
20150427,2330,2324,2360,2371,2316,2325,2329,1,5,162,576
20150428,2325,2329,2349,2388,2337,2339,2355,10,26,108,566
20150429,2339,2355,2326,2356,2251,2251,2328,-104,-27,206,630
20150430,2251,2328,2297,2321,2274,2276,2288,-52,-40,138,626
20150504,2276,2288,2297,2352,2294,2344,2327,56,39,62,644
20150505,2344,2327,2335,2352,2326,2349,2339,22,12,104,592
20150506,2349,2339,2333,2364,2333,2356,2352,17,13,96,596
20150507,2356,2352,2354,2365,2315,2333,2348,-19,-4,162,626
20150508,2333,2348,2330,2330,2316,2317,2324,-31,-24,64,650
20150511,2317,2324,2301,2327,2294,2314,2307,-10,-17,230,766
20150512,2314,2307,2320,2320,2269,2269,2291,-38,-16,134,804
20150513,2269,2291,2280,2280,2251,2252,2268,-39,-23,58,802
20150514,2252,2268,2268,2268,2227,2250,2250,-18,-18,96,834
20150515,2250,2250,2268,2268,2222,2224,2234,-26,-16,96,842
20150518,2224,2234,2221,2240,2202,2216,2222,-18,-12,106,874
20150519,2216,2222,2216,2220,2201,2220,2213,-2,-9,102,890
20150520,2220,2213,2210,2215,2183,2199,2200,-14,-13,272,892
20150521,2199,2200,2175,2178,2161,2175,2172,-25,-28,706,1448
20150522,2175,2172,2152,2176,2140,2157,2159,-15,-13,214,1462
20150525,2157,2159,2153,2164,2150,2155,2154,-4,-5,230,1378
20150526,2155,2154,2160,2175,2153,2153,2165,-1,11,220,1424
20150527,2153,2165,2160,2161,2128,2137,2134,-28,-31,556,1572
20150528,2137,2134,2123,2136,2118,2120,2127,-14,-7,694,1558
20150529,2120,2127,2149,2149,2112,2124,2121,-3,-6,658,1844
20150601,2124,2121,2113,2135,2113,2125,2126,4,5,436,1702
20150602,2125,2126,2112,2138,2104,2123,2122,-3,-4,316,1682
20150603,2123,2122,2115,2124,2100,2105,2108,-17,-14,170,1658
20150604,2105,2108,2101,2125,2101,2103,2109,-5,1,630,1556
20150605,2103,2109,2109,2116,2100,2100,2104,-9,-5,246,1494
20150608,2100,2104,2103,2105,2096,2102,2100,-2,-4,242,1490
20150609,2102,2100,2083,2104,2083,2090,2094,-10,-6,92,1482
20150610,2090,2094,2083,2091,2082,2088,2087,-6,-7,210,1534
20150611,2088,2087,2088,2093,2082,2085,2087,-2,0,184,1560
20150612,2085,2087,2042,2077,2042,2065,2063,-22,-24,348,1560
20150615,2065,2063,2062,2064,2043,2043,2056,-20,-7,44,1562
20150616,2043,2056,2057,2092,2030,2044,2060,-12,4,232,1552
20150617,2044,2060,2052,2052,2023,2030,2032,-30,-28,224,1560
20150618,2030,2032,2037,2037,2016,2024,2027,-8,-5,200,1574
20150619,2024,2027,2036,2039,2017,2028,2028,1,1,76,1566
20150623,2028,2028,2016,2036,2008,2030,2018,2,-10,186,1556
20150624,2030,2018,2012,2030,2010,2010,2017,-8,-1,364,1544
20150625,2010,2017,2007,2019,1994,1996,2007,-21,-10,284,1534
20150626,1996,2007,1993,2013,1921,1921,1963,-86,-44,566,1536
20150629,1921,1963,1931,1944,1901,1901,1919,-62,-44,672,1494
20150630,1901,1919,1901,1918,1854,1854,1877,-65,-42,1172,1380
20150701,1854,1877,1854,1854,1850,1850,1852,-27,-25,120,1380
20150702,1850,1852,,,,1852,1852,0,0,0,1380
20150703,1852,1852,,,,1852,1852,0,0,0,1380
20150706,1852,1852,1820,1820,1780,1780,1800,-72,-52,180,1380
20150707,1780,1800,1712,1770,1710,1710,1735,-90,-65,540,1380
20150708,1710,1735,1711,1711,1711,1711,1711,-24,-24,120,1380
20150709,1711,1711,,,,1711,1711,0,0,0,1380
20150710,1711,1711,1720,1720,1720,1720,1720,9,9,60,1380
20150713,1720,1720,1740,1740,1740,1740,1740,20,20,60,1380
20150714,1740,1740,,,,1740,1740,0,0,0,1380
20150715,1740,1740,,,,1740,1740,0,0,0,1380
rb1508,20150105,2600,2598,2546,2597,2501,2584,2551,-14,-47,756,212
20150106,2584,2551,2565,2653,2565,2617,2620,66,69,138,192
20150107,2617,2620,2585,2612,2585,2601,2600,-19,-20,10,192
20150108,2601,2600,2601,2603,2594,2594,2600,-6,0,16,200
20150109,2594,2600,2602,2602,2601,2601,2601,1,1,4,202
20150112,2601,2601,2587,2608,2534,2534,2558,-67,-43,62,230
20150113,2534,2558,2527,2527,2527,2527,2527,-31,-31,2,228
20150114,2527,2527,2537,2547,2505,2505,2514,-22,-13,74,288
20150115,2505,2514,2530,2530,2530,2530,2530,16,16,2,288
20150116,2530,2530,2554,2554,2533,2549,2546,19,16,14,290
20150119,2549,2546,2532,2556,2523,2556,2537,10,-9,18,288
20150120,2556,2537,2550,2550,2519,2536,2532,-1,-5,56,282
20150121,2536,2532,2520,2540,2520,2529,2527,-3,-5,12,280
20150122,2529,2527,2518,2518,2496,2515,2510,-12,-17,40,264
20150123,2515,2510,2515,2517,2510,2515,2514,5,4,10,264
20150126,2515,2514,2490,2490,2490,2490,2490,-24,-24,20,264
20150127,2490,2490,2496,2496,2496,2496,2496,6,6,2,264
20150128,2496,2496,2485,2496,2485,2496,2490,0,-6,22,274
20150129,2496,2490,,,,2490,2490,0,0,0,274
20150130,2490,2490,2522,2522,2521,2521,2521,31,31,16,284
20150202,2521,2521,2602,2602,2497,2514,2534,-7,13,8,284
20150203,2514,2534,,,,2534,2534,0,0,0,284
20150204,2534,2534,2519,2519,2518,2518,2518,-16,-16,10,280
20150205,2518,2518,,,,2518,2518,0,0,0,280
20150206,2518,2518,,,,2518,2518,0,0,0,280
20150209,2518,2518,2558,2559,2530,2531,2544,13,26,44,280
20150210,2531,2544,,,,2544,2544,0,0,0,280
20150211,2544,2544,,,,2544,2544,0,0,0,280
20150212,2544,2544,,,,2535,2535,-9,-9,0,280
20150213,2535,2535,,,,2535,2535,0,0,0,280
20150216,2535,2535,2586,2598,2586,2598,2588,63,53,12,268
20150217,2598,2588,2572,2579,2563,2576,2573,-12,-15,80,288
20150225,2576,2573,2527,2535,2527,2535,2531,-38,-42,4,286
20150226,2535,2531,2556,2556,2547,2547,2551,16,20,6,284
20150227,2547,2551,2545,2569,2543,2543,2565,-8,14,234,466
20150302,2543,2565,2530,2559,2500,2556,2539,-9,-26,74,484
20150303,2556,2539,2578,2578,2547,2548,2555,9,16,56,458
20150304,2548,2555,,,,2555,2555,0,0,0,458
20150305,2555,2555,2535,2535,2515,2515,2522,-40,-33,50,460
20150306,2515,2522,2519,2519,2480,2480,2498,-42,-24,224,388
20150309,2480,2498,2477,2477,2456,2456,2474,-42,-24,72,438
20150310,2456,2474,2476,2476,2445,2445,2472,-29,-2,30,468
20150311,2445,2472,2460,2477,2459,2477,2463,5,-9,58,452
20150312,2477,2463,2481,2481,2481,2481,2481,18,18,20,432
20150313,2481,2481,,,,2481,2481,0,0,0,432
20150316,2481,2481,2517,2517,2517,2517,2517,36,36,14,438
20150317,2517,2517,2517,2540,2517,2522,2525,5,8,22,438
20150318,2522,2525,2504,2518,2491,2494,2504,-31,-21,22,444
20150319,2494,2504,2488,2498,2488,2498,2493,-6,-11,30,440
20150320,2498,2493,2499,2503,2487,2500,2495,7,2,44,442
20150323,2500,2495,2518,2521,2517,2521,2519,26,24,10,440
20150324,2521,2519,2547,2547,2547,2547,2547,28,28,4,436
20150325,2547,2547,2531,2532,2531,2532,2531,-15,-16,8,438
20150326,2532,2531,2519,2519,2496,2496,2511,-35,-20,8,438
20150327,2496,2511,2486,2486,2448,2471,2477,-40,-34,24,440
20150330,2471,2477,2471,2499,2450,2475,2470,-2,-7,866,460
20150331,2475,2470,2481,2481,2458,2458,2465,-12,-5,36,436
20150401,2458,2465,2459,2459,2424,2424,2441,-41,-24,18,434
20150402,2424,2441,2404,2413,2371,2371,2398,-70,-43,230,598
20150403,2371,2398,2395,2395,2370,2370,2388,-28,-10,18,598
20150407,2370,2388,2381,2381,2351,2351,2361,-37,-27,60,588
20150408,2351,2361,2341,2341,2323,2341,2340,-20,-21,44,588
20150409,2341,2340,2345,2345,2331,2331,2338,-9,-2,12,590
20150410,2331,2338,2311,2326,2281,2299,2302,-39,-36,134,586
20150413,2299,2302,2286,2364,2278,2344,2295,42,-7,80,556
20150414,2344,2295,,,,2303,2303,8,8,0,556
20150415,2303,2303,2334,2349,2283,2311,2320,8,17,62,506
20150416,2311,2320,2309,2335,2309,2335,2325,15,5,26,496
20150417,2335,2325,2312,2335,2312,2323,2322,-2,-3,44,468
20150420,2323,2322,2303,2343,2295,2295,2315,-27,-7,44,454
20150421,2295,2315,2289,2318,2281,2281,2296,-34,-19,6,454
20150422,2281,2296,2303,2330,2303,2330,2313,34,17,6,450
20150423,2330,2313,2340,2348,2314,2337,2337,24,24,38,428
20150424,2337,2337,2353,2363,2350,2363,2353,26,16,16,428
20150427,2363,2353,2396,2396,2386,2386,2391,33,38,12,430
20150428,2386,2391,2424,2424,2369,2399,2410,8,19,90,460
20150429,2399,2410,2378,2395,2338,2362,2372,-48,-38,128,460
20150430,2362,2372,2369,2375,2355,2368,2370,-4,-2,52,480
20150504,2368,2370,2418,2430,2383,2393,2406,23,36,20,488
20150505,2393,2406,2429,2434,2396,2421,2407,15,1,44,490
20150506,2421,2407,2423,2438,2420,2420,2424,13,17,90,570
20150507,2420,2424,2453,2453,2402,2410,2413,-14,-11,94,614
20150508,2410,2413,2407,2412,2380,2408,2403,-5,-10,138,634
20150511,2408,2403,2410,2422,2397,2409,2409,6,6,134,660
20150512,2409,2409,2409,2413,2340,2341,2375,-68,-34,368,598
20150513,2341,2375,2352,2352,2330,2336,2346,-39,-29,92,532
20150514,2336,2346,2338,2343,2303,2321,2318,-25,-28,134,572
20150515,2321,2318,2317,2321,2288,2299,2302,-19,-16,102,598
20150518,2299,2302,2301,2309,2282,2283,2291,-19,-11,194,732
20150519,2283,2291,2285,2289,2283,2284,2286,-7,-5,42,732
20150520,2284,2286,2271,2275,2251,2267,2261,-19,-25,78,716
20150521,2267,2261,2275,2284,2250,2277,2267,16,6,158,704
20150522,2277,2267,2267,2282,2247,2255,2261,-12,-6,130,750
20150525,2255,2261,2251,2267,2247,2255,2254,-6,-7,96,768
20150526,2255,2254,2261,2279,2261,2264,2268,10,14,32,780
20150527,2264,2268,2241,2255,2228,2230,2236,-38,-32,84,818
20150528,2230,2236,2220,2230,2201,2201,2212,-35,-24,280,888
20150529,2201,2212,2203,2220,2195,2218,2210,6,-2,138,934
20150601,2218,2210,2217,2248,2211,2229,2221,19,11,60,914
20150602,2229,2221,2222,2233,2220,2226,2225,5,4,94,922
20150603,2226,2225,2218,2225,2210,2217,2216,-8,-9,100,944
20150604,2217,2216,2203,2220,2191,2201,2205,-15,-11,64,942
20150605,2201,2205,2210,2213,2200,2202,2204,-3,-1,106,974
20150608,2202,2204,2201,2207,2195,2205,2201,1,-3,124,998
20150609,2205,2201,2205,2215,2200,2206,2210,5,9,184,884
20150610,2206,2210,2212,2212,2179,2179,2194,-31,-16,444,940
20150611,2179,2194,2183,2190,2161,2182,2176,-12,-18,126,896
20150612,2182,2176,2158,2173,2145,2151,2154,-25,-22,260,782
20150615,2151,2154,2162,2178,2155,2163,2167,9,13,476,678
20150616,2163,2167,2149,2174,2122,2155,2161,-12,-6,198,674
20150617,2155,2161,2128,2146,2115,2139,2140,-22,-21,336,868
20150618,2139,2140,2134,2153,2134,2144,2144,4,4,132,918
20150619,2144,2144,2146,2160,2146,2155,2154,11,10,184,964
20150623,2155,2154,2152,2156,2140,2150,2145,-4,-9,132,948
20150624,2150,2145,2142,2167,2142,2146,2149,1,4,44,940
20150625,2146,2149,2156,2162,2134,2134,2148,-15,-1,724,1390
20150626,2134,2148,2129,2132,2075,2078,2108,-70,-40,1120,1832
20150629,2078,2108,2063,2070,2046,2051,2060,-57,-48,652,2072
20150630,2051,2060,2041,2041,1965,2008,2004,-52,-56,536,1920
20150701,2008,2004,2000,2023,1992,1996,1999,-8,-5,460,2110
20150702,1996,1999,1981,2000,1976,1989,1986,-10,-13,480,2116
20150703,1989,1986,1990,2012,1990,2002,2003,16,17,258,2110
20150706,2002,2003,1987,1989,1904,1905,1942,-98,-61,572,2134
20150707,1905,1942,1904,1965,1855,1863,1894,-79,-48,1100,1746
20150708,1863,1894,1870,1927,1821,1824,1869,-70,-25,970,1530
20150709,1824,1869,1867,1962,1840,1941,1923,72,54,1056,1354
20150710,1941,1923,1965,1982,1930,1940,1953,17,30,578,1422
20150713,1940,1953,1929,1941,1903,1907,1919,-46,-34,262,1466
20150714,1907,1919,1925,1932,1910,1917,1922,-2,3,124,1464
20150715,1917,1922,1912,1945,1902,1917,1918,-5,-4,356,1490
20150716,1917,1918,1905,1937,1895,1930,1918,12,0,352,1452
20150717,1930,1918,1923,1931,1915,1924,1922,6,4,168,1448
20150720,1924,1922,1926,1955,1918,1952,1942,30,20,420,1526
20150721,1952,1942,1953,2020,1953,1980,1978,38,36,918,1522
20150722,1980,1978,1986,1989,1936,1942,1969,-36,-9,416,1410
20150723,1942,1969,1934,1969,1917,1933,1932,-36,-37,434,1390
20150724,1933,1932,1951,1953,1923,1932,1937,0,5,218,1374
20150727,1932,1937,1932,1965,1932,1960,1952,23,15,194,1368
20150728,1960,1952,1952,1997,1941,1988,1978,36,26,824,1242
20150729,1988,1978,2000,2035,1993,2021,2017,43,39,412,1078
20150730,2021,2017,2014,2033,2014,2029,2027,12,10,264,970
20150731,2029,2027,2113,2120,2014,2029,2043,2,16,634,782
20150803,2029,2043,2029,2034,2029,2034,2033,-9,-10,122,780
20150804,2034,2033,2134,2134,2132,2132,2133,99,100,120,720
20150805,2132,2133,2222,2222,2222,2222,2222,89,89,60,660
20150806,2222,2222,2130,2200,2130,2200,2165,-22,-57,120,660
20150807,2200,2165,2250,2250,2200,2200,2233,35,68,180,600
20150810,2200,2233,2180,2180,2180,2180,2180,-53,-53,60,600
20150811,2180,2180,2072,2072,2072,2072,2072,-108,-108,60,540
20150812,2072,2072,,,,2072,2072,0,0,0,540
20150813,2072,2072,,,,2100,2100,28,28,0,540
20150814,2100,2100,2150,2150,2150,2150,2150,50,50,60,540
20150817,2150,2150,,,,2150,2150,0,0,0,540
rb1509,20150105,2625,2624,2601,2608,2584,2592,2599,-32,-25,1260,3430
20150106,2592,2599,2590,2658,2588,2647,2639,48,40,2246,3440
20150107,2647,2639,2630,2679,2605,2623,2619,-16,-20,2102,3536
20150108,2623,2619,2626,2633,2600,2615,2613,-4,-6,594,3498
20150109,2615,2613,2619,2619,2589,2597,2600,-16,-13,1992,2984
20150112,2597,2600,2593,2617,2543,2543,2569,-57,-31,998,3120
20150113,2543,2569,2542,2554,2529,2545,2541,-24,-28,1350,3068
20150114,2545,2541,2536,2551,2494,2530,2523,-11,-18,1450,3042
20150115,2530,2523,2506,2554,2506,2552,2527,29,4,552,3058
20150116,2552,2527,2558,2563,2523,2550,2536,23,9,2236,3044
20150119,2550,2536,2539,2557,2515,2546,2536,10,0,1514,2930
20150120,2546,2536,2544,2550,2522,2528,2531,-8,-5,2942,2930
20150121,2528,2531,2528,2545,2514,2514,2530,-17,-1,594,2988
20150122,2514,2530,2514,2529,2507,2516,2520,-14,-10,952,2554
20150123,2516,2520,2521,2530,2510,2510,2521,-10,1,662,2636
20150126,2510,2521,2520,2521,2491,2493,2505,-28,-16,832,2382
20150127,2493,2505,2496,2515,2496,2506,2505,1,0,670,2620
20150128,2506,2505,2509,2515,2499,2511,2506,6,1,506,2340
20150129,2511,2506,2513,2555,2511,2541,2537,35,31,892,2208
20150130,2541,2537,2540,2550,2531,2533,2539,-4,2,238,2116
20150202,2533,2539,2541,2548,2523,2545,2538,6,-1,504,2244
20150203,2545,2538,2542,2559,2531,2544,2544,6,6,1778,2266
20150204,2544,2544,2545,2581,2542,2545,2560,1,16,868,2420
20150205,2545,2560,2559,2571,2552,2553,2560,-7,0,1700,3042
20150206,2553,2560,2553,2572,2544,2563,2558,3,-2,1144,2922
20150209,2563,2558,2559,2587,2530,2554,2549,-4,-9,7266,3230
20150210,2554,2549,2555,2569,2553,2566,2558,17,9,1266,2894
20150211,2566,2558,2564,2564,2555,2563,2560,5,2,354,2760
20150212,2563,2560,2565,2565,2544,2555,2551,-5,-9,330,2774
20150213,2555,2551,2559,2577,2551,2576,2563,25,12,396,2732
20150216,2576,2563,2569,2607,2569,2593,2590,30,27,756,2656
20150217,2593,2590,2593,2594,2574,2586,2583,-4,-7,878,2826
20150225,2586,2583,2579,2579,2549,2557,2560,-26,-23,464,2800
20150226,2557,2560,2564,2587,2562,2587,2577,27,17,4784,3784
20150227,2587,2577,2584,2596,2557,2557,2577,-20,0,1868,3152
20150302,2557,2577,2556,2588,2532,2588,2557,11,-20,4686,3328
20150303,2588,2557,2588,2598,2561,2575,2582,18,25,3486,3576
20150304,2575,2582,2580,2581,2563,2570,2572,-12,-10,1942,3012
20150305,2570,2572,2561,2564,2521,2528,2533,-44,-39,2280,3416
20150306,2528,2533,2522,2538,2490,2490,2514,-43,-19,1740,3486
20150309,2490,2514,2486,2508,2455,2494,2489,-20,-25,4078,3886
20150310,2494,2489,2490,2500,2457,2462,2484,-27,-5,1662,4426
20150311,2462,2484,2460,2483,2453,2476,2467,-8,-17,1216,4260
20150312,2476,2467,2516,2516,2474,2502,2496,35,29,2996,4248
20150313,2502,2496,2502,2523,2491,2500,2506,4,10,1210,4114
20150316,2500,2506,2496,2536,2423,2527,2503,21,-3,5356,3636
20150317,2527,2503,2524,2556,2515,2519,2523,16,20,1542,3778
20150318,2519,2523,2525,2541,2483,2492,2506,-31,-17,2442,4090
20150319,2492,2506,2485,2508,2484,2492,2495,-14,-11,2702,4112
20150320,2492,2495,2489,2506,2489,2496,2496,1,1,1436,4406
20150323,2496,2496,2497,2566,2487,2555,2527,59,31,3204,4266
20150324,2555,2527,2551,2580,2550,2553,2562,26,35,3666,3902
20150325,2553,2562,2554,2557,2517,2522,2539,-40,-23,1100,4104
20150326,2522,2539,2515,2526,2505,2510,2514,-29,-25,1756,4708
20150327,2510,2514,2510,2511,2431,2495,2472,-19,-42,3174,4588
20150330,2495,2472,2492,2515,2465,2485,2491,13,19,2394,5152
20150331,2485,2491,2493,2507,2455,2471,2478,-20,-13,2298,5736
20150401,2471,2478,2453,2466,2420,2425,2442,-53,-36,6668,5932
20150402,2425,2442,2401,2433,2386,2388,2406,-54,-36,4304,6682
20150403,2388,2406,2394,2418,2389,2393,2401,-13,-5,6020,6978
20150407,2393,2401,2420,2420,2363,2364,2382,-37,-19,6704,8326
20150408,2364,2382,2357,2384,2341,2374,2363,-8,-19,4250,8112
20150409,2374,2363,2368,2372,2326,2340,2346,-23,-17,3414,8218
20150410,2340,2346,2398,2398,2305,2305,2333,-41,-13,2964,8014
20150413,2305,2333,2296,2368,2295,2366,2330,33,-3,4412,8236
20150414,2366,2330,2359,2375,2340,2360,2354,30,24,3388,7818
20150415,2360,2354,2364,2364,2335,2335,2352,-19,-2,1648,8008
20150416,2335,2352,2328,2365,2328,2355,2345,3,-7,2372,7978
20150417,2355,2345,2359,2368,2345,2346,2354,1,9,2084,8096
20150420,2346,2354,2333,2349,2321,2325,2335,-29,-19,3738,8192
20150421,2325,2335,2334,2334,2315,2326,2322,-9,-13,1478,8254
20150422,2326,2322,2326,2376,2324,2370,2350,48,28,4812,8300
20150423,2370,2350,2368,2373,2350,2359,2363,9,13,3988,8252
20150424,2359,2363,2369,2402,2355,2400,2386,37,23,5202,8000
20150427,2400,2386,2400,2424,2392,2419,2407,33,21,5900,7958
20150428,2419,2407,2421,2435,2403,2414,2419,7,12,4086,8438
20150429,2414,2419,2410,2419,2355,2363,2391,-56,-28,5008,9018
20150430,2363,2391,2365,2393,2364,2380,2378,-11,-13,4222,8972
20150504,2380,2378,2386,2426,2386,2417,2411,39,33,5056,8642
20150505,2417,2411,2413,2448,2406,2431,2427,20,16,6250,8370
20150506,2431,2427,2432,2455,2421,2442,2437,15,10,5810,8854
20150507,2442,2437,2440,2445,2407,2412,2420,-25,-17,12250,8762
20150508,2412,2420,2409,2421,2389,2406,2406,-14,-14,5506,9122
20150511,2406,2406,2411,2457,2370,2425,2416,19,10,12204,8740
20150512,2425,2416,2420,2432,2387,2387,2401,-29,-15,5186,9324
20150513,2387,2401,2388,2402,2365,2365,2382,-36,-19,4258,10534
20150514,2365,2382,2371,2371,2318,2337,2338,-45,-44,8168,11130
20150515,2337,2338,2341,2348,2325,2346,2335,8,-3,4956,12000
20150518,2346,2335,2352,2352,2321,2326,2331,-9,-4,3142,12456
20150519,2326,2331,2326,2326,2313,2316,2320,-15,-11,3506,12882
20150520,2316,2320,2320,2320,2270,2282,2286,-38,-34,4506,12132
20150521,2282,2286,2287,2330,2280,2315,2303,29,17,3788,12002
20150522,2315,2303,2321,2327,2296,2319,2312,16,9,1900,11740
20150525,2319,2312,2315,2318,2303,2317,2310,5,-2,2314,12036
20150526,2317,2310,2317,2348,2316,2320,2335,10,25,4344,11720
20150527,2320,2335,2314,2324,2305,2308,2315,-27,-20,2048,11948
20150528,2308,2315,2305,2359,2290,2297,2315,-18,0,5040,12150
20150529,2297,2315,2296,2300,2282,2299,2290,-16,-25,2876,11926
20150601,2299,2290,2290,2330,2286,2304,2301,14,11,5122,11790
20150602,2304,2301,2310,2314,2287,2295,2298,-6,-3,2964,11918
20150603,2295,2298,2296,2301,2285,2285,2292,-13,-6,2562,12128
20150604,2285,2292,2291,2291,2265,2269,2273,-23,-19,3438,11892
20150605,2269,2273,2268,2295,2246,2260,2267,-13,-6,3412,12024
20150608,2260,2267,2256,2265,2250,2251,2254,-16,-13,1950,12000
20150609,2251,2254,2249,2270,2249,2256,2260,2,6,1804,11406
20150610,2256,2260,2259,2268,2241,2249,2256,-11,-4,2364,12110
20150611,2249,2256,2252,2270,2252,2267,2259,11,3,2032,11922
20150612,2267,2259,2266,2266,2219,2219,2237,-40,-22,4274,11746
20150615,2219,2237,2238,2264,2203,2211,2220,-26,-17,4728,11134
20150616,2211,2220,2213,2226,2197,2205,2210,-15,-10,2772,10786
20150617,2205,2210,2211,2211,2181,2181,2195,-29,-15,3266,10670
20150618,2181,2195,2193,2204,2185,2197,2195,2,0,1492,10626
20150619,2197,2195,2195,2238,2191,2191,2201,-4,6,2256,10536
20150623,2191,2201,2185,2218,2178,2187,2186,-14,-15,1414,10408
20150624,2187,2186,2183,2197,2178,2187,2187,1,1,1520,10278
20150625,2187,2187,2198,2198,2165,2170,2179,-17,-8,2178,10818
20150626,2170,2179,2170,2171,2134,2138,2153,-41,-26,3912,11340
20150629,2138,2153,2136,2140,2097,2097,2123,-56,-30,4578,12382
20150630,2097,2123,2114,2114,2016,2043,2054,-80,-69,7820,11272
20150701,2043,2054,2038,2051,2026,2026,2042,-28,-12,3260,11672
20150702,2026,2042,2030,2048,2010,2043,2030,1,-12,3258,11794
20150703,2043,2030,2040,2069,2034,2042,2053,12,23,3794,11494
20150706,2042,2053,2048,2048,1950,1950,2000,-103,-53,6872,11120
20150707,1950,2000,1925,1953,1875,1881,1911,-119,-89,10912,9172
20150708,1881,1911,1885,1948,1816,1828,1866,-83,-45,28006,8926
20150709,1828,1866,1849,1959,1825,1948,1920,82,54,17694,6276
20150710,1948,1920,1955,2014,1955,1961,1980,41,60,7538,6292
20150713,1961,1980,1962,1978,1940,1950,1959,-30,-21,3892,5970
20150714,1950,1959,1950,1967,1936,1943,1956,-16,-3,2484,6036
20150715,1943,1956,1955,1968,1927,1933,1946,-23,-10,5426,5862
20150716,1933,1946,1935,1960,1907,1948,1935,2,-11,2816,5756
20150717,1948,1935,1946,1956,1933,1941,1943,6,8,2206,5134
20150720,1941,1943,1939,2009,1926,2005,1981,62,38,4170,5510
20150721,2005,1981,1997,2035,1982,1990,2008,9,27,5150,5090
20150722,1990,2008,1991,1996,1951,1972,1978,-36,-30,2368,5088
20150723,1972,1978,1960,1966,1938,1961,1956,-17,-22,1874,4848
20150724,1961,1956,1961,1965,1951,1951,1957,-5,1,720,4794
20150727,1951,1957,1952,2038,1952,1970,1974,13,17,1208,4650
20150728,1970,1974,1977,2052,1957,1986,1985,12,11,1404,4414
20150729,1986,1985,2002,2048,1994,2048,2024,63,39,2154,4100
20150730,2048,2024,2058,2058,2026,2026,2033,2,9,942,3914
20150731,2026,2033,2034,2069,2025,2052,2047,19,14,1612,3788
20150803,2052,2047,2087,2123,2052,2073,2086,26,39,1898,3702
20150804,2073,2086,2077,2103,2072,2100,2089,14,3,1146,3528
20150805,2100,2089,2101,2115,2097,2113,2110,24,21,878,3288
20150806,2113,2110,2122,2124,2090,2105,2111,-5,1,936,3224
20150807,2105,2111,2110,2114,2085,2091,2097,-20,-14,902,3062
20150810,2091,2097,2084,2100,2051,2067,2074,-30,-23,408,2910
20150811,2067,2074,2060,2079,2053,2053,2064,-21,-10,1088,2862
20150812,2053,2064,2036,2073,2035,2063,2052,-1,-12,332,2840
20150813,2063,2052,2076,2092,2063,2088,2079,36,27,308,2786
20150814,2088,2079,2095,2103,2087,2100,2096,21,17,720,2438
20150817,2100,2096,2104,2114,2080,2086,2099,-10,3,682,2100
20150818,2086,2099,2094,2103,2084,2094,2094,-5,-5,618,1956
20150819,2094,2094,2090,2093,2076,2076,2082,-18,-12,366,1728
20150820,2076,2082,2080,2084,2046,2047,2055,-35,-27,428,1536
20150821,2047,2055,2055,2055,2026,2026,2040,-29,-15,268,1472
20150824,2026,2040,2022,2047,1940,1966,1967,-74,-73,574,1288
20150825,1966,1967,1922,1993,1922,1955,1963,-12,-4,520,1162
20150826,1955,1963,1964,1999,1944,1950,1974,-13,11,198,1116
20150827,1950,1974,1936,1980,1936,1976,1960,2,-14,416,1018
20150828,1976,1960,1994,1999,1902,1977,1969,17,9,1008,1022
20150831,1977,1969,1951,1984,1881,1972,1935,3,-34,698,966
20150901,1972,1935,2020,2020,2020,2020,2020,85,85,66,960
20150902,2020,2020,,,,1980,1980,-40,-40,0,960
20150907,1980,1980,1980,1980,1970,1970,1975,-10,-5,120,840
20150908,1970,1975,1970,2070,1950,1950,1978,-25,3,360,600
20150909,1950,1978,1960,1965,1960,1965,1963,-13,-15,180,600
20150910,1965,1963,1955,1999,1955,1999,1971,36,8,180,540
20150911,1999,1971,,,,1970,1970,-1,-1,0,540
20150914,1970,1970,,,,1970,1970,0,0,0,540
20150915,1970,1970,1901,1901,1901,1901,1901,-69,-69,60,540
rb1510,20150105,2617,2616,2583,2598,2574,2589,2587,-27,-29,159400,373514
20150106,2589,2587,2586,2658,2582,2639,2632,52,45,381522,412966
20150107,2639,2632,2640,2640,2596,2609,2610,-23,-22,244838,426810
20150108,2609,2610,2612,2626,2590,2602,2604,-8,-6,191572,431114
20150109,2602,2604,2605,2610,2572,2579,2588,-25,-16,226614,420142
20150112,2579,2588,2579,2603,2521,2521,2551,-67,-37,322214,416204
20150113,2521,2551,2512,2529,2504,2520,2519,-31,-32,182992,416720
20150114,2520,2519,2514,2532,2472,2506,2499,-13,-20,299684,415966
20150115,2506,2499,2506,2534,2491,2531,2511,32,12,246296,435844
20150116,2531,2511,2535,2541,2513,2528,2526,17,15,189006,439356
20150119,2528,2526,2519,2538,2494,2528,2520,2,-6,341826,447466
20150120,2528,2520,2525,2534,2503,2504,2515,-16,-5,200508,460264
20150121,2504,2515,2503,2524,2496,2496,2510,-19,-5,225174,471244
20150122,2496,2510,2493,2510,2487,2502,2501,-8,-9,188644,472922
20150123,2502,2501,2503,2517,2500,2506,2508,5,7,262406,490984
20150126,2506,2508,2500,2510,2480,2485,2493,-23,-15,297910,485628
20150127,2485,2493,2485,2510,2483,2495,2497,2,4,187090,500418
20150128,2495,2497,2500,2509,2491,2502,2502,5,5,158610,517100
20150129,2502,2502,2504,2550,2502,2536,2531,34,29,318434,555280
20150130,2536,2531,2538,2544,2524,2525,2532,-6,1,200216,593046
20150202,2525,2532,2525,2545,2519,2538,2530,6,-2,301502,647554
20150203,2538,2530,2537,2554,2532,2540,2541,10,11,474088,707214
20150204,2540,2541,2544,2577,2538,2538,2554,-3,13,797746,808856
20150205,2538,2554,2549,2565,2542,2542,2551,-12,-3,559858,829098
20150206,2542,2551,2542,2562,2532,2556,2548,5,-3,642274,831102
20150209,2556,2548,2557,2581,2536,2546,2553,-2,5,737512,869678
20150210,2546,2553,2547,2562,2544,2558,2555,5,2,339944,853104
20150211,2558,2555,2556,2561,2548,2558,2554,3,-1,259518,845356
20150212,2558,2554,2560,2560,2538,2548,2545,-6,-9,422212,857632
20150213,2548,2545,2549,2568,2543,2567,2557,22,12,651856,831120
20150216,2567,2557,2565,2603,2563,2586,2585,29,28,657396,869244
20150217,2586,2585,2589,2589,2565,2580,2574,-5,-11,371536,877762
20150225,2580,2574,2574,2574,2546,2552,2555,-22,-19,335242,871382
20150226,2552,2555,2555,2578,2553,2578,2565,23,10,454852,933490
20150227,2578,2565,2578,2591,2553,2555,2572,-10,7,902284,1004416
20150302,2555,2572,2556,2584,2527,2583,2554,11,-18,2084120,1247070
20150303,2583,2554,2582,2597,2561,2573,2579,19,25,1818088,1216020
20150304,2573,2579,2573,2579,2559,2565,2569,-14,-10,1204940,1253304
20150305,2565,2569,2563,2568,2514,2523,2533,-46,-36,2670808,1449742
20150306,2523,2533,2523,2535,2484,2485,2509,-48,-24,1954442,1552054
20150309,2485,2509,2478,2506,2462,2486,2484,-23,-25,3254646,1562434
20150310,2486,2484,2483,2493,2449,2453,2471,-31,-13,2391878,1599006
20150311,2453,2471,2451,2478,2449,2471,2464,0,-7,2204398,1579462
20150312,2471,2464,2474,2507,2464,2496,2487,32,23,2646136,1572834
20150313,2496,2487,2505,2516,2485,2493,2500,6,13,2484292,1594010
20150316,2493,2500,2491,2524,2480,2520,2503,20,3,2887758,1765824
20150317,2520,2503,2520,2524,2505,2512,2514,9,11,2039234,1737060
20150318,2512,2514,2511,2522,2473,2483,2498,-31,-16,4334196,1725474
20150319,2483,2498,2480,2502,2474,2482,2486,-16,-12,2041408,1706378
20150320,2482,2486,2482,2498,2477,2481,2487,-5,1,1774980,1725054
20150323,2481,2487,2483,2549,2471,2548,2519,61,32,4785718,1922120
20150324,2548,2519,2550,2574,2538,2542,2552,23,33,4221476,2103290
20150325,2542,2552,2538,2547,2505,2507,2526,-45,-26,3109514,2088390
20150326,2507,2526,2502,2514,2488,2491,2500,-35,-26,2949506,2092662
20150327,2491,2500,2495,2495,2407,2477,2455,-23,-45,6043130,2110134
20150330,2477,2455,2472,2498,2450,2451,2469,-4,14,4261190,2159268
20150331,2451,2469,2471,2477,2414,2431,2445,-38,-24,5247554,2429446
20150401,2431,2445,2423,2428,2381,2390,2406,-55,-39,5869210,2739722
20150402,2390,2406,2377,2399,2339,2342,2367,-64,-39,7905188,3041786
20150403,2342,2367,2343,2374,2336,2341,2353,-26,-14,6098706,3145268
20150407,2341,2353,2330,2343,2309,2311,2324,-42,-29,4374424,3624170
20150408,2311,2324,2306,2335,2284,2324,2308,0,-16,7162492,3625926
20150409,2324,2308,2323,2326,2287,2290,2302,-18,-6,4823818,3685426
20150410,2290,2302,2291,2298,2266,2266,2280,-36,-22,4749620,3800820
20150413,2266,2280,2263,2334,2262,2329,2292,49,12,8377910,3799408
20150414,2329,2292,2335,2341,2302,2324,2321,32,29,7287328,3703712
20150415,2324,2321,2327,2331,2294,2297,2315,-24,-6,4532636,3771342
20150416,2297,2315,2296,2329,2291,2318,2312,3,-3,5042842,3630552
20150417,2318,2312,2317,2335,2309,2311,2319,-1,7,4649630,3584152
20150420,2311,2319,2305,2314,2278,2279,2297,-40,-22,6266020,3845800
20150421,2279,2297,2277,2291,2270,2281,2280,-16,-17,4252402,3929950
20150422,2281,2280,2282,2334,2282,2327,2308,47,28,6974766,3866734
20150423,2327,2308,2328,2332,2306,2323,2322,15,14,5507632,3594430
20150424,2323,2322,2325,2388,2324,2378,2365,56,43,9322642,3359744
20150427,2378,2365,2384,2413,2366,2408,2389,43,24,8738302,3280756
20150428,2408,2389,2417,2430,2384,2398,2406,9,17,5879950,3175130
20150429,2398,2406,2398,2412,2331,2340,2373,-66,-33,7285772,3156726
20150430,2340,2373,2346,2377,2341,2365,2360,-8,-13,5412820,3017818
20150504,2365,2360,2383,2421,2371,2413,2400,53,40,4834698,3016110
20150505,2413,2400,2414,2442,2399,2428,2421,28,21,7536936,2980574
20150506,2428,2421,2430,2447,2418,2430,2431,9,10,6223092,2851946
20150507,2430,2431,2433,2437,2401,2407,2414,-24,-17,4835314,2842652
20150508,2407,2414,2410,2420,2386,2412,2404,-2,-10,5401672,2752800
20150511,2412,2404,2417,2434,2407,2421,2419,17,15,4298216,2782154
20150512,2421,2419,2420,2427,2389,2391,2403,-28,-16,3813042,2816192
20150513,2391,2403,2395,2407,2376,2383,2391,-20,-12,3721250,2808210
20150514,2383,2391,2384,2390,2342,2363,2363,-28,-28,5247184,2881492
20150515,2363,2363,2360,2373,2351,2372,2361,9,-2,2802208,2881486
20150518,2372,2361,2372,2374,2348,2349,2361,-12,0,2535766,2959456
20150519,2349,2361,2342,2355,2338,2342,2346,-19,-15,2609006,2918988
20150520,2342,2346,2337,2342,2302,2314,2320,-32,-26,3605960,2825762
20150521,2314,2320,2314,2353,2313,2344,2332,24,12,3321110,2808738
20150522,2344,2332,2346,2359,2326,2351,2342,19,10,3699272,2742096
20150525,2351,2342,2348,2350,2327,2347,2340,5,-2,3046606,2779526
20150526,2347,2340,2348,2378,2346,2351,2364,11,24,4809814,2723568
20150527,2351,2364,2350,2364,2342,2355,2355,-9,-9,2552564,2719244
20150528,2355,2355,2355,2373,2342,2355,2359,0,4,3100416,2634738
20150529,2355,2359,2355,2365,2335,2359,2349,0,-10,3197716,2516918
20150601,2359,2349,2356,2386,2347,2372,2365,23,16,4129768,2506374
20150602,2372,2365,2375,2379,2363,2375,2371,10,6,2592372,2453376
20150603,2375,2371,2378,2379,2348,2349,2363,-22,-8,2404222,2451870
20150604,2349,2363,2347,2359,2336,2356,2346,-7,-17,3077860,2355650
20150605,2356,2346,2356,2365,2325,2341,2341,-5,-5,2524844,2379106
20150608,2341,2341,2338,2341,2327,2334,2333,-7,-8,1898566,2375180
20150609,2334,2333,2330,2356,2328,2337,2344,4,11,2066772,2337004
20150610,2337,2344,2338,2348,2327,2336,2340,-8,-4,2709874,2434288
20150611,2336,2340,2344,2359,2340,2355,2349,15,9,3117692,2430106
20150612,2355,2349,2348,2351,2296,2299,2321,-50,-28,3983034,2759080
20150615,2299,2321,2298,2314,2276,2281,2293,-40,-28,3325350,2866710
20150616,2281,2293,2273,2288,2238,2243,2266,-50,-27,3921078,3088346
20150617,2243,2266,2240,2249,2218,2223,2231,-43,-35,4536168,3103402
20150618,2223,2231,2226,2252,2222,2245,2238,14,7,3378246,3063476
20150619,2245,2238,2245,2267,2244,2246,2251,8,13,3010142,2929690
20150623,2246,2251,2240,2242,2226,2239,2234,-12,-17,2102086,2977038
20150624,2239,2234,2239,2247,2230,2241,2239,7,5,2497894,3053352
20150625,2241,2239,2242,2246,2215,2218,2227,-21,-12,2870778,3091870
20150626,2218,2227,2217,2237,2203,2213,2221,-14,-6,3994394,3024568
20150629,2213,2221,2215,2226,2178,2181,2206,-40,-15,3658666,2995694
20150630,2181,2206,2180,2180,2095,2135,2131,-71,-75,7807732,2495642
20150701,2135,2131,2135,2140,2117,2124,2130,-7,-1,3659918,2552394
20150702,2124,2130,2120,2139,2089,2124,2114,-6,-16,4505638,2295538
20150703,2124,2114,2116,2155,2114,2121,2134,7,20,3551970,2287966
20150706,2121,2134,2116,2119,2027,2027,2065,-107,-69,3390786,2467546
20150707,2027,2065,2003,2028,1948,1957,1991,-108,-74,7005452,2189122
20150708,1957,1991,1965,2005,1891,1891,1939,-100,-52,9237660,1711600
20150709,1891,1939,1905,2035,1893,2004,1975,65,36,7051156,1542726
20150710,2004,1975,2020,2068,2007,2007,2033,32,58,4587426,1607812
20150713,2007,2033,2002,2032,1992,2008,2013,-25,-20,2661184,1573422
20150714,2008,2013,2018,2033,1999,2007,2018,-6,5,1806312,1537048
20150715,2007,2018,2006,2016,1983,1990,1997,-28,-21,1765154,1564474
20150716,1990,1997,1990,2021,1956,2005,1984,8,-13,2515104,1456178
20150717,2005,1984,2008,2015,1988,2006,2001,22,17,1423034,1428950
20150720,2006,2001,1999,2078,1989,2073,2046,72,45,2148588,1352176
20150721,2073,2046,2068,2088,2046,2047,2064,1,18,1227390,1295806
20150722,2047,2064,2043,2055,1980,2000,2022,-64,-42,1253014,1248876
20150723,2000,2022,2002,2015,1982,2011,1999,-11,-23,1036006,1232794
20150724,2011,1999,2015,2021,1995,1997,2006,-2,7,884520,1197062
20150727,1997,2006,1999,2045,1999,2027,2026,21,20,1132012,1063074
20150728,2027,2026,2026,2050,2006,2030,2027,4,1,953714,985402
20150729,2030,2027,2036,2085,2032,2083,2065,56,38,1190190,906094
20150730,2083,2065,2085,2088,2065,2073,2075,8,10,867286,874216
20150731,2073,2075,2070,2127,2069,2117,2102,42,27,1183606,898950
20150803,2117,2102,2111,2191,2111,2114,2141,12,39,1905406,845374
20150804,2114,2141,2119,2135,2112,2125,2122,-16,-19,759866,773938
20150805,2125,2122,2130,2138,2114,2127,2124,5,2,544324,687322
20150806,2127,2124,2127,2134,2105,2123,2118,-1,-6,532690,642096
20150807,2123,2118,2119,2129,2106,2116,2117,-2,-1,489788,588632
20150810,2116,2117,2115,2122,2072,2094,2098,-23,-19,492630,549292
20150811,2094,2098,2088,2112,2073,2074,2092,-24,-6,495966,520464
20150812,2074,2092,2074,2099,2066,2098,2083,6,-9,293336,487546
20150813,2098,2083,2101,2136,2093,2132,2112,49,29,465186,419866
20150814,2132,2112,2129,2131,2115,2123,2121,11,9,183522,402566
20150817,2123,2121,2121,2126,2098,2099,2112,-22,-9,141192,400424
20150818,2099,2112,2097,2109,2090,2099,2099,-13,-13,146674,384388
20150819,2099,2099,2093,2102,2082,2088,2093,-11,-6,247426,363898
20150820,2088,2093,2089,2095,2048,2052,2067,-41,-26,251366,362990
20150821,2052,2067,2055,2069,2028,2028,2051,-39,-16,224876,352352
20150824,2028,2051,2030,2031,1948,1959,1985,-92,-66,408472,290064
20150825,1959,1985,1959,1999,1950,1954,1970,-31,-15,334710,244742
20150826,1954,1970,1983,1995,1965,1969,1979,-1,9,182034,241520
20150827,1969,1979,1962,1990,1962,1978,1975,-1,-4,136900,231570
20150828,1978,1975,1977,2010,1970,1983,1986,8,11,169406,222990
20150831,1983,1986,1984,1984,1950,1963,1965,-23,-21,116044,201536
20150901,1963,1965,1965,1978,1960,1974,1969,9,4,60418,189268
20150902,1974,1969,1972,1976,1963,1967,1970,-2,1,34934,177172
20150907,1967,1970,1970,1972,1932,1936,1952,-34,-18,55342,164284
20150908,1936,1952,1930,1955,1930,1954,1940,2,-12,34988,154014
20150909,1954,1940,1955,1997,1954,1967,1976,27,36,77882,138812
20150910,1967,1976,1972,1985,1964,1978,1972,2,-4,27440,133644
20150911,1978,1972,1977,1990,1967,1967,1980,-5,8,29006,128244
20150914,1967,1980,1965,1972,1956,1959,1960,-21,-20,23852,121232
20150915,1959,1960,1960,1962,1946,1946,1955,-14,-5,24312,112586
20150916,1946,1955,1950,1970,1948,1966,1959,11,4,18344,107748
20150917,1966,1959,1969,1976,1955,1968,1966,9,7,27918,101956
20150918,1968,1966,1961,1971,1958,1960,1964,-6,-2,15760,98166
20150921,1960,1964,1960,1964,1951,1956,1957,-8,-7,18264,90372
20150922,1956,1957,1958,1964,1941,1951,1951,-6,-6,14988,82524
20150923,1951,1951,1951,1962,1948,1957,1956,6,5,17858,75002
20150924,1957,1956,1960,1962,1926,1933,1944,-23,-12,17596,65874
20150925,1933,1944,1927,1948,1919,1920,1934,-24,-10,19090,60308
20150928,1920,1934,1916,1920,1858,1872,1886,-62,-48,28596,50116
20150929,1872,1886,1870,1878,1841,1842,1856,-44,-30,28250,32456
20150930,1842,1856,1857,1857,1766,1767,1796,-89,-60,32908,18236
20151008,1767,1796,1765,1797,1765,1769,1779,-27,-17,7436,11580
20151009,1769,1779,1832,1832,1772,1781,1783,2,4,3960,9180
20151012,1781,1783,1767,1780,1703,1708,1752,-75,-31,5940,7680
20151013,1708,1752,1710,1780,1710,1780,1746,28,-6,1740,6960
20151014,1780,1746,1752,1780,1752,1774,1765,28,19,960,6960
20151015,1774,1765,1750,1777,1730,1755,1753,-10,-12,2520,6420
rb1511,20150105,2612,2611,2584,2588,2576,2578,2583,-33,-28,72,972
20150106,2578,2583,2587,2648,2584,2630,2619,47,36,326,1084
20150107,2630,2619,2614,2614,2595,2601,2604,-18,-15,30,1066
20150108,2601,2604,2625,2625,2590,2602,2596,-2,-8,250,1094
20150109,2602,2596,2599,2601,2574,2583,2580,-13,-16,186,1106
20150112,2583,2580,2592,2593,2516,2522,2542,-58,-38,226,1224
20150113,2522,2542,2509,2522,2509,2510,2515,-32,-27,94,1242
20150114,2510,2515,2510,2526,2469,2497,2492,-18,-23,264,1222
20150115,2497,2492,2495,2529,2486,2529,2499,37,7,54,1230
20150116,2529,2499,2527,2527,2516,2516,2520,17,21,16,1220
20150119,2516,2520,2504,2529,2498,2529,2508,9,-12,50,1236
20150120,2529,2508,2512,2519,2503,2503,2510,-5,2,24,1238
20150121,2503,2510,2500,2515,2495,2501,2501,-9,-9,124,1232
20150122,2501,2501,2501,2504,2497,2498,2499,-3,-2,58,1248
20150123,2498,2499,2508,2515,2498,2504,2502,5,3,32,1230
20150126,2504,2502,2504,2510,2482,2482,2497,-20,-5,44,1230
20150127,2482,2497,2500,2500,2495,2500,2498,3,1,8,1224
20150128,2500,2498,2502,2513,2502,2509,2505,11,7,16,1216
20150129,2509,2505,2506,2544,2502,2534,2530,29,25,88,1176
20150130,2534,2530,2538,2540,2519,2519,2523,-11,-7,84,1238
20150202,2519,2523,2533,2533,2517,2531,2524,8,1,106,1244
20150203,2531,2524,2533,2533,2532,2532,2532,8,8,6,1244
20150204,2532,2532,2548,2570,2536,2536,2552,4,20,58,1222
20150205,2536,2552,2543,2555,2541,2541,2547,-11,-5,32,1230
20150206,2541,2547,2541,2552,2531,2550,2547,3,0,52,1230
20150209,2550,2547,2559,2559,2541,2541,2549,-6,2,86,1248
20150210,2541,2549,2549,2560,2549,2560,2554,11,5,148,1264
20150211,2560,2554,2562,2562,2552,2558,2553,4,-1,116,1356
20150212,2558,2553,2549,2549,2545,2545,2545,-8,-8,22,1362
20150213,2545,2545,2544,2585,2544,2585,2566,40,21,320,1462
20150216,2585,2566,2577,2615,2572,2592,2588,26,22,124,1384
20150217,2592,2588,2577,2580,2572,2580,2577,-8,-11,40,1364
20150225,2580,2577,2554,2564,2554,2564,2556,-13,-21,8,1360
20150226,2564,2556,2565,2567,2563,2567,2564,11,8,30,1356
20150227,2567,2564,2575,2575,2554,2566,2567,2,3,10,1362
20150302,2566,2567,2550,2579,2550,2579,2565,12,-2,236,1552
20150303,2579,2565,2595,2599,2569,2583,2583,18,18,428,1336
20150304,2583,2583,2565,2575,2561,2565,2566,-18,-17,62,1320
20150305,2565,2566,2547,2549,2520,2524,2536,-42,-30,168,1412
20150306,2524,2536,2520,2533,2494,2494,2512,-42,-24,54,1398
20150309,2494,2512,2469,2494,2462,2494,2472,-18,-40,172,1386
20150310,2494,2472,2491,2497,2451,2451,2465,-21,-7,120,1368
20150311,2451,2465,2500,2500,2461,2477,2465,12,0,60,1376
20150312,2477,2465,2478,2500,2475,2500,2483,35,18,196,1310
20150313,2500,2483,2502,2510,2490,2495,2503,12,20,98,1350
20150316,2495,2503,2495,2520,2495,2520,2509,17,6,6,1350
20150317,2520,2509,2523,2523,2507,2509,2514,0,5,108,1416
20150318,2509,2514,2507,2524,2480,2490,2503,-24,-11,158,1404
20150319,2490,2503,2484,2497,2480,2489,2493,-14,-10,234,1538
20150320,2489,2493,2498,2501,2498,2501,2499,8,6,10,1538
20150323,2501,2499,2490,2545,2490,2545,2509,46,10,214,1526
20150324,2545,2509,2559,2570,2536,2543,2556,34,47,182,1482
20150325,2543,2556,2533,2533,2509,2509,2517,-47,-39,54,1482
20150326,2509,2517,2512,2516,2503,2505,2509,-12,-8,126,1428
20150327,2505,2509,2488,2491,2404,2490,2448,-19,-61,290,1402
20150330,2490,2448,2497,2497,2460,2482,2483,34,35,38,1404
20150331,2482,2483,2467,2478,2440,2453,2456,-30,-27,292,1434
20150401,2453,2456,2426,2439,2404,2404,2424,-52,-32,82,1420
20150402,2404,2424,2383,2409,2351,2351,2387,-73,-37,1186,1492
20150403,2351,2387,2366,2380,2343,2370,2373,-17,-14,1054,2368
20150407,2370,2373,2357,2357,2340,2348,2349,-25,-24,454,2542
20150408,2348,2349,2337,2363,2325,2357,2343,8,-6,204,2556
20150409,2357,2343,2355,2355,2328,2339,2340,-4,-3,130,2526
20150410,2339,2340,2329,2338,2306,2309,2320,-31,-20,266,2516
20150413,2309,2320,2309,2365,2305,2365,2312,45,-8,920,2596
20150414,2365,2312,2352,2374,2339,2356,2356,44,44,138,2590
20150415,2356,2356,2357,2357,2335,2335,2349,-21,-7,56,2590
20150416,2335,2349,2339,2361,2337,2350,2350,1,1,108,2550
20150417,2350,2350,2357,2369,2340,2344,2344,-6,-6,556,2506
20150420,2344,2344,2333,2340,2313,2313,2328,-31,-16,204,2524
20150421,2313,2328,2292,2308,2280,2301,2294,-27,-34,298,2618
20150422,2301,2294,2297,2347,2297,2344,2315,50,21,354,2838
20150423,2344,2315,2340,2342,2327,2337,2333,22,18,278,2846
20150424,2337,2333,2314,2400,2314,2394,2375,61,42,792,2902
20150427,2394,2375,2398,2433,2384,2426,2403,51,28,562,2928
20150428,2426,2403,2430,2439,2410,2417,2421,14,18,432,2810
20150429,2417,2421,2410,2430,2360,2372,2404,-49,-17,248,2862
20150430,2372,2404,2382,2401,2377,2388,2386,-16,-18,142,2854
20150504,2388,2386,2417,2440,2417,2436,2429,50,43,220,2840
20150505,2436,2429,2434,2454,2419,2452,2437,23,8,138,2790
20150506,2452,2437,2448,2457,2438,2450,2446,13,9,252,2904
20150507,2450,2446,2447,2456,2423,2431,2441,-15,-5,402,3080
20150508,2431,2441,2429,2440,2407,2432,2421,-9,-20,1492,3318
20150511,2432,2421,2439,2453,2431,2443,2444,22,23,302,3228
20150512,2443,2444,2430,2430,2413,2416,2421,-28,-23,40,3226
20150513,2416,2421,2412,2418,2400,2406,2409,-15,-12,78,3190
20150514,2406,2409,2404,2410,2370,2381,2383,-28,-26,398,3182
20150515,2381,2383,2388,2393,2378,2388,2388,5,5,200,3028
20150518,2388,2388,2380,2380,2371,2374,2373,-14,-15,334,3174
20150519,2374,2373,2355,2364,2350,2358,2357,-15,-16,344,3290
20150520,2358,2357,2346,2351,2309,2309,2330,-48,-27,842,3926
20150521,2309,2330,2321,2356,2319,2354,2335,24,5,566,3676
20150522,2354,2335,2346,2363,2335,2352,2348,17,13,110,3652
20150525,2352,2348,2347,2364,2336,2364,2348,16,0,778,3780
20150526,2364,2348,2361,2388,2361,2368,2370,20,22,266,3836
20150527,2368,2370,2359,2374,2355,2364,2364,-6,-6,150,3896
20150528,2364,2364,2367,2400,2365,2378,2376,14,12,1032,3958
20150529,2378,2376,2365,2378,2359,2373,2368,-3,-8,444,3986
20150601,2373,2368,2372,2393,2359,2386,2376,18,8,1730,3780
20150602,2386,2376,2387,2391,2370,2380,2379,4,3,180,3822
20150603,2380,2379,2382,2388,2360,2360,2372,-19,-7,546,4122
20150604,2360,2372,2358,2364,2342,2356,2351,-16,-21,94,4130
20150605,2356,2351,2353,2353,2338,2347,2345,-4,-6,210,4158
20150608,2347,2345,2339,2343,2330,2336,2333,-9,-12,644,4580
20150609,2336,2333,2336,2347,2334,2339,2339,6,6,1468,5362
20150610,2339,2339,2340,2342,2328,2328,2339,-11,0,294,5368
20150611,2328,2339,2340,2355,2337,2354,2345,15,6,448,5412
20150612,2354,2345,2341,2344,2305,2305,2319,-40,-26,826,5490
20150615,2305,2319,2297,2316,2280,2280,2295,-39,-24,556,5730
20150616,2280,2295,2276,2288,2242,2246,2262,-49,-33,764,5954
20150617,2246,2262,2242,2252,2220,2229,2231,-33,-31,1938,6628
20150618,2229,2231,2235,2250,2226,2247,2237,16,6,668,6724
20150619,2247,2237,2243,2262,2243,2251,2252,14,15,360,6802
20150623,2251,2252,2236,2243,2230,2240,2235,-12,-17,288,6858
20150624,2240,2235,2245,2249,2236,2244,2244,9,9,906,6932
20150625,2244,2244,2239,2242,2221,2221,2233,-23,-11,228,6946
20150626,2221,2233,2221,2240,2214,2223,2223,-10,-10,1230,7378
20150629,2223,2223,2218,2236,2183,2183,2211,-40,-12,896,7598
20150630,2183,2211,2181,2181,2100,2129,2128,-82,-83,3082,8288
20150701,2129,2128,2129,2138,2120,2121,2129,-7,1,2108,8546
20150702,2121,2129,2118,2140,2098,2129,2114,0,-15,1874,9074
20150703,2129,2114,2123,2154,2114,2123,2134,9,20,1268,9146
20150706,2123,2134,2110,2111,2027,2027,2060,-107,-74,2862,9550
20150707,2027,2060,2018,2018,1896,1933,1976,-127,-84,3552,9082
20150708,1933,1976,1939,1983,1877,1877,1912,-99,-64,4132,9138
20150709,1877,1912,1873,2007,1866,1986,1953,74,41,3596,9432
20150710,1986,1953,1994,2048,1991,1998,2022,45,69,2054,9120
20150713,1998,2022,2000,2021,1988,1999,2004,-23,-18,1552,9270
20150714,1999,2004,2008,2024,2005,2009,2011,5,7,1174,9440
20150715,2009,2011,2001,2013,1985,1992,1993,-19,-18,1454,9368
20150716,1992,1993,1990,2008,1957,1992,1981,-1,-12,1542,9298
20150717,1992,1981,2000,2005,1977,1992,1988,11,7,1064,9256
20150720,1992,1988,1991,2050,1984,2047,2025,59,37,2688,9356
20150721,2047,2025,2047,2057,2020,2023,2037,-2,12,1460,9324
20150722,2023,2037,2001,2035,1965,1984,1997,-53,-40,1628,9494
20150723,1984,1997,1986,1995,1969,1995,1979,-2,-18,640,9216
20150724,1995,1979,1996,2000,1975,1978,1986,-1,7,1882,8814
20150727,1978,1986,1985,2021,1984,2006,2006,20,20,2474,9418
20150728,2006,2006,2001,2027,1985,2009,2010,3,4,1190,8938
20150729,2009,2010,2018,2058,2018,2055,2039,45,29,1506,8826
20150730,2055,2039,2054,2061,2039,2042,2046,3,7,1116,8824
20150731,2042,2046,2045,2082,2040,2079,2066,33,20,2426,9166
20150803,2079,2066,2079,2111,2060,2066,2081,0,15,2046,9160
20150804,2066,2081,2078,2080,2062,2078,2069,-3,-12,590,9190
20150805,2078,2069,2093,2093,2075,2077,2081,8,12,262,9198
20150806,2077,2081,2085,2085,2065,2074,2073,-7,-8,472,9258
20150807,2074,2073,2070,2079,2051,2066,2059,-7,-14,376,9412
20150810,2066,2059,2062,2067,2027,2047,2050,-12,-9,336,9528
20150811,2047,2050,2048,2067,2041,2041,2050,-9,0,222,9524
20150812,2041,2050,2037,2059,2001,2051,2041,1,-9,580,9518
20150813,2051,2041,2065,2085,2057,2080,2076,39,35,1502,9532
20150814,2080,2076,2070,2077,2064,2067,2067,-9,-9,518,9530
20150817,2067,2067,2066,2074,2051,2051,2064,-16,-3,418,9508
20150818,2051,2064,2057,2063,2046,2048,2050,-16,-14,432,9386
20150819,2048,2050,2044,2045,2018,2038,2032,-12,-18,726,9284
20150820,2038,2032,2039,2049,2012,2020,2027,-12,-5,418,9156
20150821,2020,2027,2027,2027,2012,2012,2018,-15,-9,398,8878
20150824,2012,2018,2009,2013,1924,1935,1979,-83,-39,2012,7776
20150825,1935,1979,1920,1965,1920,1936,1940,-43,-39,758,7392
20150826,1936,1940,1955,1967,1937,1937,1955,-3,15,140,7406
20150827,1937,1955,1940,1962,1937,1959,1950,4,-5,216,7344
20150828,1959,1950,1962,1981,1953,1963,1964,13,14,934,7238
20150831,1963,1964,1948,1969,1945,1950,1950,-14,-14,498,7014
20150901,1950,1950,1950,1970,1950,1968,1961,18,11,492,6834
20150902,1968,1961,1963,1973,1963,1969,1968,8,7,300,6698
20150907,1969,1968,1958,1974,1872,1947,1946,-21,-22,574,6520
20150908,1947,1946,1948,1968,1945,1968,1949,22,3,590,6314
20150909,1968,1949,1964,1982,1959,1963,1969,14,20,578,6160
20150910,1963,1969,1969,1970,1953,1966,1965,-3,-4,558,5852
20150911,1966,1965,1966,1975,1953,1957,1964,-8,-1,222,5840
20150914,1957,1964,1951,1952,1942,1943,1947,-21,-17,150,5772
20150915,1943,1947,1942,1942,1920,1920,1932,-27,-15,388,5892
20150916,1920,1932,1920,1938,1916,1927,1926,-5,-6,506,6192
20150917,1927,1926,1932,1935,1918,1918,1926,-8,0,292,6274
20150918,1918,1926,1921,1932,1916,1919,1920,-7,-6,142,6246
20150921,1919,1920,1902,1925,1899,1900,1910,-20,-10,738,6330
20150922,1900,1910,1899,1906,1894,1895,1899,-15,-11,380,6240
20150923,1895,1899,1891,1902,1861,1873,1874,-26,-25,854,6062
20150924,1873,1874,1880,1889,1875,1876,1884,2,10,366,5846
20150925,1876,1884,1879,1886,1862,1875,1874,-9,-10,606,5694
20150928,1875,1874,1859,1861,1838,1838,1846,-36,-28,472,5614
20150929,1838,1846,1836,1838,1777,1791,1811,-55,-35,1192,5370
20150930,1791,1811,1801,1802,1750,1752,1777,-59,-34,2048,5106
20151008,1752,1777,1777,1792,1770,1778,1780,1,3,894,5046
20151009,1778,1780,1776,1792,1776,1784,1785,4,5,1234,4986
20151012,1784,1785,1781,1799,1776,1788,1788,3,3,1124,5238
20151013,1788,1788,1785,1792,1780,1790,1785,2,-3,740,4810
20151014,1790,1785,1785,1795,1782,1787,1790,2,5,282,4624
20151015,1787,1790,1784,1796,1784,1788,1791,-2,1,194,4452
20151016,1788,1791,1788,1788,1768,1769,1775,-22,-16,338,4376
20151019,1769,1775,1784,1785,1762,1762,1768,-13,-7,496,4258
20151020,1762,1768,1751,1774,1750,1755,1754,-13,-14,908,4130
20151021,1755,1754,1754,1758,1747,1752,1752,-2,-2,824,3844
20151022,1752,1752,1753,1768,1752,1762,1761,10,9,256,3706
20151023,1762,1761,1760,1777,1753,1762,1766,1,5,1004,3360
20151026,1762,1766,1759,1770,1753,1768,1760,2,-6,388,3116
20151027,1768,1760,1762,1780,1760,1770,1770,10,10,758,2684
20151028,1770,1770,1768,1776,1765,1770,1771,0,1,370,2346
20151029,1770,1771,1770,1775,1770,1770,1772,-1,1,242,2258
20151030,1770,1772,1770,1773,1752,1754,1764,-18,-8,726,1800
20151102,1754,1764,1773,1782,1772,1776,1777,12,13,840,1020
20151103,1776,1777,1790,1790,1779,1779,1784,2,7,120,900
20151104,1779,1784,1800,1833,1786,1809,1806,25,22,840,660
20151105,1809,1806,,,,1806,1806,0,0,0,660
20151106,1806,1806,,,,1806,1806,0,0,0,660
20151109,1806,1806,,,,1806,1806,0,0,0,660
20151110,1806,1806,,,,1806,1806,0,0,0,660
20151111,1806,1806,1810,1810,1785,1785,1805,-21,-1,360,600
20151112,1785,1805,1751,1751,1751,1751,1751,-54,-54,180,480
20151113,1751,1751,1780,1780,1780,1780,1780,29,29,60,480
20151116,1780,1780,,,,1780,1780,0,0,0,480
rb1512,20150105,2622,2619,2613,2613,2578,2598,2598,-21,-21,14,46
20150106,2598,2598,,,,2598,2598,0,0,0,46
20150107,2598,2598,2600,2604,2600,2604,2602,6,4,4,44
20150108,2604,2602,2608,2608,2598,2598,2601,-4,-1,6,46
20150109,2598,2601,2602,2608,2588,2599,2598,-2,-3,30,56
20150112,2599,2598,2596,2614,2540,2540,2575,-58,-23,50,64
20150113,2540,2575,2535,2547,2530,2530,2534,-45,-41,66,96
20150114,2530,2534,2522,2550,2488,2510,2508,-24,-26,76,106
20150115,2510,2508,2508,2529,2484,2528,2518,20,10,16,102
20150116,2528,2518,2544,2544,2534,2541,2540,23,22,10,104
20150119,2541,2540,,,,2539,2539,-1,-1,0,104
20150120,2539,2539,2550,2550,2523,2540,2534,1,-5,28,104
20150121,2540,2534,2539,2542,2513,2541,2532,7,-2,36,104
20150122,2541,2532,2529,2529,2487,2521,2513,-11,-19,196,108
20150123,2521,2513,,,,2513,2513,0,0,0,108
20150126,2513,2513,2507,2507,2493,2507,2503,-6,-10,8,108
20150127,2507,2503,2523,2523,2523,2523,2523,20,20,2,108
20150128,2523,2523,2527,2527,2527,2527,2527,4,4,2,108
20150129,2527,2527,2530,2554,2529,2554,2542,27,15,14,106
20150130,2554,2542,2544,2544,2544,2544,2544,2,2,6,106
20150202,2544,2544,2625,2625,2515,2539,2553,-5,9,22,110
20150203,2539,2553,2562,2567,2543,2560,2557,7,4,34,126
20150204,2560,2557,2550,2575,2550,2565,2566,8,9,32,118
20150205,2565,2566,2582,2582,2573,2573,2577,7,11,4,118
20150206,2573,2577,2573,2573,2573,2573,2573,-4,-4,2,120
20150209,2573,2573,2545,2545,2545,2545,2545,-28,-28,4,118
20150210,2545,2545,,,,2545,2545,0,0,0,118
20150211,2545,2545,,,,2557,2557,12,12,0,118
20150212,2557,2557,,,,2557,2557,0,0,0,118
20150213,2557,2557,2546,2566,2546,2564,2563,7,6,24,120
20150216,2564,2563,2595,2596,2595,2596,2595,33,32,10,120
20150217,2596,2595,,,,2584,2584,-11,-11,0,120
20150225,2584,2584,2574,2587,2539,2556,2561,-28,-23,492,134
20150226,2556,2561,2570,2571,2570,2571,2570,10,9,34,108
20150227,2571,2570,2571,2571,2571,2571,2571,1,1,2,108
20150302,2571,2571,2584,2584,2573,2573,2574,2,3,24,108
20150303,2573,2574,2590,2597,2578,2583,2582,9,8,26,108
20150304,2583,2582,,,,2576,2576,-6,-6,0,108
20150305,2576,2576,2538,2547,2532,2547,2539,-29,-37,8,108
20150306,2547,2539,2535,2535,2535,2535,2535,-4,-4,4,108
20150309,2535,2535,2482,2515,2482,2515,2509,-20,-26,12,120
20150310,2515,2509,2484,2484,2475,2475,2477,-34,-32,16,122
20150311,2475,2477,2465,2465,2465,2465,2465,-12,-12,2,124
20150312,2465,2465,2492,2503,2492,2503,2496,38,31,10,124
20150313,2503,2496,2499,2511,2499,2508,2507,12,11,8,124
20150316,2508,2507,2476,2520,2476,2520,2506,13,-1,24,128
20150317,2520,2506,2526,2526,2513,2520,2517,14,11,38,130
20150318,2520,2517,2502,2512,2488,2488,2498,-29,-19,54,144
20150319,2488,2498,2490,2514,2490,2505,2502,7,4,188,294
20150320,2505,2502,2502,2518,2502,2509,2511,7,9,30,296
20150323,2509,2511,2512,2544,2512,2543,2535,32,24,70,296
20150324,2543,2535,2566,2575,2555,2560,2565,25,30,14,290
20150325,2560,2565,2554,2554,2530,2530,2530,-35,-35,86,368
20150326,2530,2530,2530,2530,2504,2504,2515,-26,-15,88,406
20150327,2504,2515,2513,2513,2443,2506,2472,-9,-43,180,470
20150330,2506,2472,2517,2520,2493,2497,2504,25,32,24,458
20150331,2497,2504,2488,2503,2473,2491,2487,-13,-17,188,508
20150401,2491,2487,2445,2466,2436,2457,2447,-30,-40,320,644
20150402,2457,2447,2403,2424,2392,2398,2400,-49,-47,172,648
20150403,2398,2400,2396,2419,2362,2390,2392,-10,-8,868,648
20150407,2390,2392,2385,2385,2353,2365,2370,-27,-22,54,676
20150408,2365,2370,2361,2382,2343,2374,2357,4,-13,124,696
20150409,2374,2357,2372,2372,2342,2349,2353,-8,-4,102,708
20150410,2349,2353,2337,2339,2307,2307,2323,-46,-30,184,746
20150413,2307,2323,2308,2360,2306,2360,2317,37,-6,146,724
20150414,2360,2317,2355,2360,2332,2354,2355,37,38,134,774
20150415,2354,2355,2353,2356,2340,2340,2349,-15,-6,28,776
20150416,2340,2349,2348,2368,2345,2368,2352,19,3,48,780
20150417,2368,2352,2358,2365,2350,2357,2362,5,10,124,864
20150420,2357,2362,2353,2356,2335,2335,2344,-27,-18,92,874
20150421,2335,2344,2327,2328,2318,2321,2321,-23,-23,136,838
20150422,2321,2321,2336,2373,2336,2373,2366,52,45,34,846
20150423,2373,2366,2366,2372,2352,2361,2362,-5,-4,12,844
20150424,2361,2362,2386,2427,2377,2424,2403,62,41,220,794
20150427,2424,2403,2430,2452,2416,2452,2431,49,28,156,708
20150428,2452,2431,2462,2462,2433,2440,2452,9,21,112,734
20150429,2440,2452,2433,2450,2400,2400,2431,-52,-21,104,786
20150430,2400,2431,2417,2426,2408,2418,2416,-13,-15,50,792
20150504,2418,2416,2450,2467,2437,2458,2459,42,43,326,782
20150505,2458,2459,2468,2488,2450,2474,2467,15,8,274,756
20150506,2474,2467,2470,2488,2466,2481,2472,14,5,90,720
20150507,2481,2472,2469,2475,2459,2467,2471,-5,-1,366,784
20150508,2467,2471,2464,2474,2444,2465,2457,-6,-14,178,822
20150511,2465,2457,2426,2474,2426,2474,2461,17,4,62,830
20150512,2474,2461,2458,2458,2446,2446,2452,-15,-9,24,830
20150513,2446,2452,2450,2455,2436,2445,2449,-7,-3,54,846
20150514,2445,2449,2443,2443,2410,2426,2427,-23,-22,78,852
20150515,2426,2427,2431,2450,2401,2430,2425,3,-2,72,852
20150518,2430,2425,2430,2434,2420,2420,2425,-5,0,40,870
20150519,2420,2425,2411,2423,2402,2402,2411,-23,-14,232,900
20150520,2402,2411,2401,2401,2355,2355,2373,-56,-38,152,882
20150521,2355,2373,2365,2389,2365,2389,2380,16,7,42,868
20150522,2389,2380,2389,2395,2382,2386,2387,6,7,38,862
20150525,2386,2387,2392,2398,2386,2398,2389,11,2,56,874
20150526,2398,2389,2408,2428,2407,2407,2416,18,27,30,876
20150527,2407,2416,2408,2408,2403,2403,2404,-13,-12,6,880
20150528,2403,2404,2426,2427,2409,2417,2417,13,13,44,880
20150529,2417,2417,2419,2420,2418,2420,2419,3,2,14,890
20150601,2420,2419,2430,2453,2428,2442,2437,23,18,58,896
20150602,2442,2437,2438,2446,2434,2439,2437,2,0,54,906
20150603,2439,2437,2438,2439,2405,2405,2413,-32,-24,108,894
20150604,2405,2413,2403,2404,2392,2404,2399,-9,-14,38,880
20150605,2404,2399,2402,2402,2377,2384,2391,-15,-8,760,1220
20150608,2384,2391,2380,2386,2372,2375,2375,-16,-16,134,1198
20150609,2375,2375,2372,2457,2372,2389,2385,14,10,264,1172
20150610,2389,2385,2384,2403,2381,2388,2385,3,0,72,1192
20150611,2388,2385,2394,2397,2376,2390,2385,5,0,144,1240
20150612,2390,2385,2388,2388,2346,2346,2366,-39,-19,394,1342
20150615,2346,2366,2344,2350,2322,2322,2334,-44,-32,108,1380
20150616,2322,2334,2318,2331,2285,2300,2316,-34,-18,230,1460
20150617,2300,2316,2301,2302,2261,2274,2278,-42,-38,546,1500
20150618,2274,2278,2279,2297,2277,2290,2287,12,9,90,1516
20150619,2290,2287,2290,2304,2282,2289,2292,2,5,546,1386
20150623,2289,2292,2289,2289,2273,2273,2281,-19,-11,48,1386
20150624,2273,2281,2280,2288,2277,2285,2282,4,1,10,1386
20150625,2285,2282,2272,2275,2270,2270,2273,-12,-9,16,1390
20150626,2270,2273,2265,2298,2257,2257,2265,-16,-8,50,1386
20150629,2257,2265,2293,2295,2233,2243,2272,-22,7,310,1528
20150630,2243,2272,2228,2232,2158,2174,2181,-98,-91,546,1620
20150701,2174,2181,2166,2178,2163,2166,2170,-15,-11,484,1744
20150702,2166,2170,2156,2181,2140,2165,2152,-5,-18,486,1834
20150703,2165,2152,2167,2187,2145,2155,2163,3,11,236,1902
20150706,2155,2163,2165,2165,2054,2054,2088,-109,-75,260,1880
20150707,2054,2088,2027,2028,1929,1938,1979,-150,-109,1314,1918
20150708,1938,1979,1963,2006,1880,1883,1919,-96,-60,1504,1766
20150709,1883,1919,1896,2014,1859,2006,1977,87,58,676,1692
20150710,2006,1977,2042,2064,2030,2040,2045,63,68,510,1672
20150713,2040,2045,2044,2057,2000,2030,2029,-15,-16,420,1666
20150714,2030,2029,2043,2057,2013,2037,2046,8,17,104,1640
20150715,2037,2046,2039,2051,2010,2022,2025,-24,-21,44,1640
20150716,2022,2025,1976,2040,1924,2027,1992,2,-33,398,1622
20150717,2027,1992,2036,2036,1996,2021,2012,29,20,98,1610
20150720,2021,2012,2019,2098,2011,2081,2058,69,46,400,1598
20150721,2081,2058,2088,2088,2050,2059,2066,1,8,622,1540
20150722,2059,2066,2065,2065,1998,2009,2028,-57,-38,498,1758
20150723,2009,2028,2011,2044,1981,2009,2004,-19,-24,374,1760
20150724,2009,2004,2006,2023,2000,2005,2012,1,8,178,1718
20150727,2005,2012,2001,2064,2001,2053,2044,41,32,276,1814
20150728,2053,2044,1997,2075,1997,2032,2050,-12,6,1626,1772
20150729,2032,2050,2045,2089,2045,2067,2066,17,16,252,1704
20150730,2067,2066,2080,2081,2055,2055,2066,-11,0,214,1686
20150731,2055,2066,2056,2076,2055,2065,2066,-1,0,220,1680
20150803,2065,2066,2050,2117,2050,2074,2083,8,17,1200,1950
20150804,2074,2083,2070,2085,2050,2073,2061,-10,-22,216,1944
20150805,2073,2061,2089,2099,2055,2070,2071,9,10,280,1952
20150806,2070,2071,2075,2075,2059,2060,2063,-11,-8,152,1952
20150807,2060,2063,2057,2068,2038,2051,2054,-12,-9,338,2062
20150810,2051,2054,2050,2056,2031,2033,2042,-21,-12,324,2090
20150811,2033,2042,2041,2060,2034,2044,2048,2,6,188,2122
20150812,2044,2048,2047,2060,2041,2055,2051,7,3,104,2104
20150813,2055,2051,2068,2085,2068,2075,2077,24,26,168,2072
20150814,2075,2077,2071,2078,2071,2073,2073,-4,-4,20,2078
20150817,2073,2073,2078,2081,2055,2058,2065,-15,-8,94,2096
20150818,2058,2065,2058,2058,2046,2046,2054,-19,-11,28,2110
20150819,2046,2054,2045,2050,2024,2036,2038,-18,-16,84,2108
20150820,2036,2038,2040,2040,1997,2034,2024,-4,-14,146,2094
20150821,2034,2024,2027,2035,2015,2018,2023,-6,-1,72,2066
20150824,2018,2023,2015,2015,1921,1926,1953,-97,-70,554,2014
20150825,1926,1953,1916,1978,1916,1928,1937,-25,-16,212,1996
20150826,1928,1937,1949,1977,1931,1931,1951,-6,14,308,1956
20150827,1931,1951,1935,1974,1935,1956,1952,5,1,518,1860
20150828,1956,1952,1968,2004,1954,1979,1976,27,24,236,1886
20150831,1979,1976,1945,1971,1945,1952,1958,-24,-18,120,1864
20150901,1952,1958,1943,1963,1943,1962,1958,4,0,262,1710
20150902,1962,1958,1953,1968,1953,1958,1958,0,0,204,1650
20150907,1958,1958,1940,1957,1883,1936,1924,-22,-34,308,1666
20150908,1936,1924,1938,1955,1933,1955,1941,31,17,898,1740
20150909,1955,1941,1954,1984,1954,1965,1969,24,28,470,1886
20150910,1965,1969,1965,1979,1955,1969,1965,0,-4,50,1874
20150911,1969,1965,1970,1970,1956,1962,1968,-3,3,228,1706
20150914,1962,1968,1940,1964,1937,1945,1942,-23,-26,218,1746
20150915,1945,1942,1927,1949,1926,1926,1935,-16,-7,202,1706
20150916,1926,1935,1931,1949,1927,1934,1937,-1,2,54,1692
20150917,1934,1937,1943,1948,1930,1930,1940,-7,3,246,1604
20150918,1930,1940,1934,1934,1909,1923,1926,-17,-14,168,1552
20150921,1923,1926,1922,1922,1878,1906,1896,-20,-30,466,1698
20150922,1906,1896,1900,1911,1889,1892,1899,-4,3,300,1690
20150923,1892,1899,1878,1909,1878,1903,1901,4,2,18,1692
20150924,1903,1901,1903,1903,1882,1894,1891,-7,-10,142,1710
20150925,1894,1891,1876,1897,1869,1881,1880,-10,-11,182,1716
20150928,1881,1880,1863,1869,1851,1851,1857,-29,-23,88,1682
20150929,1851,1857,1837,1843,1826,1826,1832,-31,-25,198,1652
20150930,1826,1832,1829,1829,1793,1800,1803,-32,-29,708,1936
20151008,1800,1803,1782,1828,1782,1805,1801,2,-2,190,1942
20151009,1805,1801,1808,1860,1802,1828,1838,27,37,2372,2184
20151012,1828,1838,1845,1845,1814,1824,1825,-14,-13,240,2222
20151013,1824,1825,1809,1824,1797,1817,1807,-8,-18,78,2200
20151014,1817,1807,1811,1819,1804,1804,1807,-3,0,54,2200
20151015,1804,1807,1805,1820,1805,1820,1809,13,2,8,2198
20151016,1820,1809,1806,1808,1803,1803,1805,-6,-4,26,2202
20151019,1803,1805,1799,1807,1770,1770,1785,-35,-20,206,2280
20151020,1770,1785,1770,1783,1764,1778,1773,-7,-12,510,2374
20151021,1778,1773,1774,1785,1763,1783,1776,10,3,160,2368
20151022,1783,1776,1782,1787,1779,1787,1784,11,8,58,2372
20151023,1787,1784,1787,1787,1770,1779,1777,-5,-7,314,2220
20151026,1779,1777,1782,1784,1776,1783,1780,6,3,164,2182
20151027,1783,1780,1777,1793,1777,1787,1785,7,5,80,2192
20151028,1787,1785,1787,1787,1773,1773,1778,-12,-7,216,2004
20151029,1773,1778,1778,1782,1770,1777,1776,-1,-2,136,2002
20151030,1777,1776,1787,1787,1770,1776,1772,0,-4,328,1946
20151102,1776,1772,1773,1780,1772,1774,1773,2,1,260,1830
20151103,1774,1773,1767,1767,1757,1757,1760,-16,-13,382,1928
20151104,1757,1760,1770,1772,1764,1769,1767,9,7,110,1868
20151105,1769,1767,1772,1778,1769,1772,1771,5,4,324,1752
20151106,1772,1771,1773,1784,1773,1780,1777,9,6,126,1714
20151109,1780,1777,1775,1791,1774,1791,1786,14,9,242,1752
20151110,1791,1786,1789,1803,1789,1800,1797,14,11,570,1566
20151111,1800,1797,1795,1812,1794,1799,1800,2,3,342,1534
20151112,1799,1800,1799,1812,1797,1800,1805,0,5,610,1516
20151113,1800,1805,1791,1810,1790,1795,1794,-10,-11,116,1436
20151116,1795,1794,1793,1806,1764,1800,1792,6,-2,1426,1424
20151117,1800,1792,1800,1801,1782,1790,1790,-2,-2,556,1390
20151118,1790,1790,1772,1784,1754,1767,1767,-23,-23,458,1384
20151119,1767,1767,1760,1772,1744,1753,1750,-14,-17,478,1204
20151120,1753,1750,1748,1768,1748,1753,1760,3,10,522,1284
20151123,1753,1760,1748,1761,1736,1752,1749,-8,-11,780,1280
20151124,1752,1749,1745,1756,1745,1753,1751,4,2,202,1262
20151125,1753,1751,1755,1759,1743,1746,1752,-5,1,346,1190
20151126,1746,1752,1751,1757,1745,1745,1751,-7,-1,190,1044
20151127,1745,1751,1745,1746,1704,1704,1721,-47,-30,172,920
20151130,1704,1721,1700,1735,1640,1640,1687,-81,-34,450,602
rb1601,20150116,2518,2518,2545,2568,2533,2550,2546,32,28,96,66
20150119,2550,2546,2534,2558,2515,2541,2533,-5,-13,486,212
20150120,2541,2533,2554,2554,2521,2529,2532,-4,-1,134,286
20150121,2529,2532,2520,2540,2516,2516,2528,-16,-4,294,410
20150122,2516,2528,2519,2530,2515,2521,2522,-7,-6,310,576
20150123,2521,2522,2523,2540,2521,2524,2528,2,6,276,680
20150126,2524,2528,2519,2534,2503,2503,2513,-25,-15,352,782
20150127,2503,2513,2501,2532,2500,2520,2521,7,8,298,842
20150128,2520,2521,2520,2534,2510,2520,2523,-1,2,252,882
20150129,2520,2523,2525,2564,2525,2555,2550,32,27,608,1066
20150130,2555,2550,2555,2557,2513,2533,2531,-17,-19,2028,2042
20150202,2533,2531,2533,2550,2521,2545,2539,14,8,952,2198
20150203,2545,2539,2548,2567,2547,2560,2556,21,17,730,2418
20150204,2560,2556,2561,2590,2556,2556,2573,0,17,2152,3584
20150205,2556,2573,2565,2576,2557,2557,2565,-16,-8,920,3868
20150206,2557,2565,2550,2573,2543,2570,2561,5,-4,808,4068
20150209,2570,2561,2579,2594,2551,2559,2565,-2,4,1136,4132
20150210,2559,2565,2564,2575,2560,2569,2568,4,3,944,4618
20150211,2569,2568,2568,2574,2561,2574,2567,6,-1,732,4594
20150212,2574,2567,2575,2575,2555,2563,2562,-4,-5,1012,4562
20150213,2563,2562,2563,2580,2561,2578,2571,16,9,908,4956
20150216,2578,2571,2577,2613,2577,2588,2589,17,18,3786,6942
20150217,2588,2589,2588,2593,2568,2584,2573,-5,-16,2336,7578
20150225,2584,2573,2570,2575,2552,2555,2560,-18,-13,766,7716
20150226,2555,2560,2561,2579,2561,2576,2566,16,6,3584,9408
20150227,2576,2566,2575,2594,2560,2561,2574,-5,8,3544,10814
20150302,2561,2574,2563,2595,2540,2587,2571,13,-3,9006,15138
20150303,2587,2571,2586,2606,2572,2573,2586,2,15,12400,20338
20150304,2573,2586,2574,2585,2567,2572,2577,-14,-9,8880,20758
20150305,2572,2577,2571,2573,2528,2535,2545,-42,-32,8348,21134
20150306,2535,2545,2533,2546,2500,2505,2524,-40,-21,7226,21218
20150309,2505,2524,2501,2521,2482,2494,2502,-30,-22,13620,26148
20150310,2494,2502,2498,2503,2476,2477,2488,-25,-14,6268,26006
20150311,2477,2488,2481,2496,2471,2488,2484,0,-4,4912,25338
20150312,2488,2484,2489,2520,2480,2500,2502,16,18,18558,37054
20150313,2500,2502,2507,2520,2496,2504,2507,2,5,8560,37194
20150316,2504,2507,2498,2529,2489,2525,2513,18,6,11284,40062
20150317,2525,2513,2524,2528,2511,2517,2520,4,7,4932,40412
20150318,2517,2520,2510,2526,2481,2495,2501,-25,-19,16412,39324
20150319,2495,2501,2488,2510,2486,2494,2496,-7,-5,5386,39562
20150320,2494,2496,2495,2508,2490,2496,2498,0,2,5458,39818
20150323,2496,2498,2494,2554,2485,2553,2532,55,34,22140,44128
20150324,2553,2532,2557,2579,2548,2553,2561,21,29,15654,47030
20150325,2553,2561,2553,2556,2520,2521,2542,-40,-19,11234,48202
20150326,2521,2542,2520,2528,2500,2506,2511,-36,-31,14810,52346
20150327,2506,2511,2508,2508,2436,2493,2474,-18,-37,30906,54812
20150330,2493,2474,2488,2509,2462,2472,2482,-2,8,17412,56104
20150331,2472,2482,2495,2495,2443,2455,2459,-27,-23,37662,61474
20150401,2455,2459,2450,2450,2398,2411,2424,-48,-35,26934,65786
20150402,2411,2424,2391,2415,2362,2366,2385,-58,-39,44184,73468
20150403,2366,2385,2360,2398,2360,2365,2377,-20,-8,35634,79374
20150407,2365,2377,2350,2371,2345,2347,2355,-30,-22,35944,88650
20150408,2347,2355,2350,2366,2317,2358,2342,3,-13,53660,96660
20150409,2358,2342,2356,2359,2326,2327,2338,-15,-4,31864,101316
20150410,2327,2338,2325,2332,2300,2302,2312,-36,-26,35310,105180
20150413,2302,2312,2305,2357,2291,2353,2322,41,10,93388,119450
20150414,2353,2322,2352,2361,2325,2344,2342,22,20,73444,122374
20150415,2344,2342,2345,2353,2319,2322,2336,-20,-6,47252,128430
20150416,2322,2336,2315,2350,2315,2339,2336,3,0,55552,132086
20150417,2339,2336,2340,2362,2332,2335,2344,-1,8,59534,139772
20150420,2335,2344,2333,2342,2310,2310,2325,-34,-19,96368,147514
20150421,2310,2325,2306,2315,2298,2306,2307,-19,-18,92386,161454
20150422,2306,2307,2305,2360,2304,2352,2335,45,28,154994,167074
20150423,2352,2335,2352,2358,2333,2356,2349,21,14,122634,174772
20150424,2356,2349,2355,2415,2355,2405,2395,56,46,220176,188336
20150427,2405,2395,2415,2455,2400,2454,2426,59,31,252906,204176
20150428,2454,2426,2458,2468,2423,2434,2448,8,22,215394,220968
20150429,2434,2448,2437,2448,2370,2381,2409,-67,-39,223094,235220
20150430,2381,2409,2385,2415,2380,2399,2400,-10,-9,153990,234944
20150504,2399,2400,2409,2463,2406,2452,2440,52,40,197734,250936
20150505,2452,2440,2453,2487,2446,2479,2468,39,28,262334,262512
20150506,2479,2468,2475,2494,2461,2480,2477,12,9,242192,284176
20150507,2480,2477,2479,2485,2449,2458,2461,-19,-16,184592,292166
20150508,2458,2461,2455,2467,2432,2458,2449,-3,-12,203318,300634
20150511,2458,2449,2458,2474,2450,2463,2460,14,11,158838,299610
20150512,2463,2460,2458,2468,2440,2440,2450,-20,-10,128342,308864
20150513,2440,2450,2434,2457,2429,2439,2442,-11,-8,134438,316032
20150514,2439,2442,2440,2449,2403,2426,2422,-16,-20,246380,324874
20150515,2426,2422,2422,2437,2410,2437,2424,15,2,134010,332906
20150518,2437,2424,2437,2441,2417,2417,2428,-7,4,112064,347750
20150519,2417,2428,2416,2425,2411,2416,2416,-12,-12,109466,351826
20150520,2416,2416,2410,2411,2357,2368,2383,-48,-33,211970,343228
20150521,2368,2383,2365,2404,2365,2400,2387,17,4,210732,360494
20150522,2400,2387,2399,2410,2378,2404,2394,17,7,170430,367106
20150525,2404,2394,2403,2409,2388,2406,2398,12,4,167436,388382
20150526,2406,2398,2408,2434,2406,2414,2420,16,22,239232,372296
20150527,2414,2420,2414,2425,2405,2421,2417,1,-3,126604,379866
20150528,2421,2417,2416,2442,2415,2429,2431,12,14,203356,378538
20150529,2429,2431,2420,2441,2412,2441,2428,10,-3,187336,384062
20150601,2441,2428,2442,2462,2435,2447,2447,19,19,265036,388086
20150602,2447,2447,2447,2457,2443,2455,2450,8,3,165048,388194
20150603,2455,2450,2453,2460,2418,2419,2435,-31,-15,202634,423670
20150604,2419,2435,2412,2422,2406,2420,2414,-15,-21,231448,458470
20150605,2420,2414,2420,2428,2390,2404,2405,-10,-9,169628,469264
20150608,2404,2405,2407,2408,2386,2389,2392,-16,-13,156826,504832
20150609,2389,2392,2388,2409,2381,2385,2396,-7,4,133934,511924
20150610,2385,2396,2387,2404,2385,2394,2394,-2,-2,213704,531918
20150611,2394,2394,2400,2409,2389,2402,2399,8,5,274116,561692
20150612,2402,2399,2399,2401,2350,2352,2375,-47,-24,282470,563072
20150615,2352,2375,2346,2369,2329,2332,2347,-43,-28,252862,595616
20150616,2332,2347,2329,2343,2302,2310,2324,-37,-23,341926,624486
20150617,2310,2324,2307,2310,2276,2277,2290,-47,-34,428432,681998
20150618,2277,2290,2280,2304,2278,2297,2291,7,1,291976,690022
20150619,2297,2291,2299,2321,2297,2298,2305,7,14,259376,693448
20150623,2298,2305,2293,2296,2281,2291,2288,-14,-17,266702,723484
20150624,2291,2288,2290,2302,2283,2299,2293,11,5,319702,769186
20150625,2299,2293,2298,2304,2277,2280,2286,-13,-7,297048,799782
20150626,2280,2286,2278,2295,2273,2285,2285,-1,-1,343732,806878
20150629,2285,2285,2285,2313,2264,2267,2286,-18,1,493912,823476
20150630,2267,2286,2268,2269,2172,2217,2222,-69,-64,1058370,876800
20150701,2217,2222,2218,2232,2210,2217,2222,-5,0,552438,928446
20150702,2217,2222,2216,2236,2185,2223,2212,1,-10,1009790,1076458
20150703,2223,2212,2217,2242,2204,2212,2224,0,12,1106394,1122244
20150706,2212,2224,2209,2211,2112,2112,2154,-112,-70,1340274,1201900
20150707,2112,2154,2080,2093,1982,1995,2036,-159,-118,2666974,1228226
20150708,1995,2036,1995,2035,1934,1934,1972,-102,-64,3692064,1254176
20150709,1934,1972,1918,2103,1908,2049,2018,77,46,3976356,1187390
20150710,2049,2018,2070,2107,2060,2067,2082,49,64,3492758,1226478
20150713,2067,2082,2065,2090,2041,2061,2070,-21,-12,2244890,1234962
20150714,2061,2070,2066,2095,2059,2062,2073,-8,3,2608720,1315840
20150715,2062,2073,2064,2076,2036,2044,2057,-29,-16,2199398,1330338
20150716,2044,2057,2041,2065,2007,2047,2034,-10,-23,4108176,1441200
20150717,2047,2034,2044,2061,2024,2053,2044,19,10,2935124,1463382
20150720,2053,2044,2047,2123,2038,2112,2092,68,48,5372274,1714656
20150721,2112,2092,2104,2125,2079,2081,2101,-11,9,4278448,1822648
20150722,2081,2101,2074,2085,2010,2031,2053,-70,-48,4843262,1917802
20150723,2031,2053,2031,2062,2017,2050,2038,-3,-15,4318224,1917096
20150724,2050,2038,2050,2064,2034,2044,2048,6,10,4132504,1927220
20150727,2044,2048,2048,2099,2046,2074,2076,26,28,5905974,2009400
20150728,2074,2076,2072,2102,2052,2072,2074,-4,-2,5570278,2061730
20150729,2072,2074,2076,2118,2075,2110,2098,36,24,5789134,2203846
20150730,2110,2098,2108,2116,2081,2085,2097,-13,-1,4844012,2200790
20150731,2085,2097,2082,2107,2077,2095,2092,-2,-5,4215404,2191682
20150803,2095,2092,2095,2132,2073,2078,2099,-14,7,6307800,2241676
20150804,2078,2099,2083,2102,2068,2097,2085,-2,-14,3837588,2182916
20150805,2097,2085,2096,2107,2082,2098,2093,13,8,3994900,2219302
20150806,2098,2093,2099,2102,2066,2076,2081,-17,-12,3884330,2376042
20150807,2076,2081,2071,2079,2043,2063,2061,-18,-20,4472546,2493758
20150810,2063,2061,2057,2067,2038,2045,2050,-16,-11,3523152,2450504
20150811,2045,2050,2044,2074,2043,2053,2061,3,11,4898544,2435484
20150812,2053,2061,2049,2073,2043,2071,2061,10,0,3829656,2345210
20150813,2071,2061,2080,2103,2076,2092,2089,31,28,5340620,2316254
20150814,2092,2089,2089,2093,2081,2085,2085,-4,-4,2412166,2321784
20150817,2085,2085,2089,2095,2058,2059,2074,-26,-11,3325562,2436318
20150818,2059,2074,2055,2068,2047,2049,2058,-25,-16,2590430,2408340
20150819,2049,2058,2049,2053,2024,2044,2037,-14,-21,4059872,2284572
20150820,2044,2037,2042,2048,2020,2028,2033,-9,-4,3291744,2382612
20150821,2028,2033,2034,2040,2023,2024,2032,-9,-1,2737948,2410662
20150824,2024,2032,2021,2026,1930,1934,1969,-98,-63,6300192,2495786
20150825,1934,1969,1936,1965,1917,1933,1941,-36,-28,6832422,2219346
20150826,1933,1941,1961,1975,1936,1937,1953,-4,12,4417540,2248510
20150827,1937,1953,1935,1985,1931,1969,1958,16,5,4210674,2189386
20150828,1969,1958,1970,2004,1965,1976,1981,18,23,6597234,2393856
20150831,1976,1981,1972,1977,1945,1952,1960,-29,-21,5809012,2446838
20150901,1952,1960,1955,1970,1946,1963,1958,3,-2,4473344,2414568
20150902,1963,1958,1960,1967,1949,1955,1957,-3,-1,2561494,2272834
20150907,1955,1957,1954,1955,1839,1920,1925,-37,-32,4094518,2508030
20150908,1920,1925,1920,1949,1916,1949,1929,24,4,3649914,2441818
20150909,1949,1929,1952,1979,1946,1948,1963,19,34,7883726,2424526
20150910,1948,1963,1950,1967,1939,1956,1953,-7,-10,4779406,2446874
20150911,1956,1953,1957,1969,1946,1946,1956,-7,3,5041194,2479580
20150914,1946,1956,1944,1948,1926,1929,1935,-27,-21,4065166,2553366
20150915,1929,1935,1925,1934,1907,1909,1923,-26,-12,3253090,2649676
20150916,1909,1923,1910,1941,1910,1934,1926,11,3,3964030,2524750
20150917,1934,1926,1933,1950,1925,1926,1935,0,9,4414424,2593742
20150918,1926,1935,1928,1935,1918,1922,1926,-13,-9,3226308,2610072
20150921,1922,1926,1920,1925,1894,1904,1908,-22,-18,3814342,2763274
20150922,1904,1908,1908,1913,1884,1891,1895,-17,-13,3174160,2883358
20150923,1891,1895,1887,1905,1877,1902,1891,7,-4,3580716,2712170
20150924,1902,1891,1905,1906,1888,1893,1895,2,4,1747832,2710262
20150925,1893,1895,1892,1910,1885,1891,1898,-4,3,2794220,2649152
20150928,1891,1898,1885,1885,1855,1859,1871,-39,-27,2271328,2808478
20150929,1859,1871,1852,1858,1828,1833,1839,-38,-32,3299438,2583858
20150930,1833,1839,1837,1838,1815,1821,1826,-18,-13,2494804,2628152
20151008,1821,1826,1837,1851,1818,1826,1833,0,7,2553402,2595548
20151009,1826,1833,1826,1864,1821,1852,1844,19,11,3479500,2483282
20151012,1852,1844,1857,1868,1836,1847,1854,3,10,3981900,2466748
20151013,1847,1854,1848,1852,1820,1838,1831,-16,-23,3089416,2546572
20151014,1838,1831,1836,1843,1826,1830,1833,-1,2,2522922,2599590
20151015,1830,1833,1831,1844,1826,1834,1835,1,2,2109524,2581472
20151016,1834,1835,1834,1836,1820,1830,1828,-5,-7,2483140,2574222
20151019,1830,1828,1829,1841,1800,1807,1821,-21,-7,3243418,2804968
20151020,1807,1821,1806,1815,1795,1801,1804,-20,-17,2261400,2754348
20151021,1801,1804,1800,1811,1788,1804,1800,0,-4,4048260,2614494
20151022,1804,1800,1804,1818,1801,1805,1808,5,8,2373494,2446990
20151023,1805,1808,1805,1809,1781,1801,1796,-7,-12,2247608,2260140
20151026,1801,1796,1803,1808,1793,1801,1801,5,5,2065598,2142800
20151027,1801,1801,1800,1818,1798,1804,1806,3,5,2068660,2087966
20151028,1804,1806,1802,1804,1784,1792,1792,-14,-14,1783290,1995340
20151029,1792,1792,1790,1801,1783,1795,1793,3,1,1251140,1948786
20151030,1795,1793,1796,1797,1779,1782,1787,-11,-6,1280842,2004004
20151102,1782,1787,1782,1796,1779,1787,1788,0,1,998326,1838240
20151103,1787,1788,1785,1789,1773,1779,1779,-9,-9,1032118,1773746
20151104,1779,1779,1779,1783,1774,1779,1778,0,-1,663022,1684516
20151105,1779,1778,1780,1788,1774,1778,1780,0,2,576198,1586362
20151106,1778,1780,1776,1792,1775,1780,1781,0,1,718084,1485566
20151109,1780,1781,1780,1786,1775,1781,1781,0,0,426588,1427156
20151110,1781,1781,1781,1785,1775,1779,1780,-2,-1,320224,1364234
20151111,1779,1780,1779,1779,1757,1760,1764,-20,-16,532044,1407960
20151112,1760,1764,1760,1765,1754,1760,1758,-4,-6,443802,1344794
20151113,1760,1758,1758,1771,1756,1762,1763,4,5,500908,1181834
20151116,1762,1763,1765,1780,1758,1766,1769,3,6,577974,1033154
20151117,1766,1769,1766,1769,1757,1759,1762,-10,-7,347436,964580
20151118,1759,1762,1759,1760,1728,1735,1743,-27,-19,483836,999446
20151119,1735,1743,1736,1737,1701,1713,1715,-30,-28,604456,964542
20151120,1713,1715,1712,1720,1702,1703,1710,-12,-5,335130,922638
20151123,1703,1710,1705,1705,1640,1660,1673,-50,-37,687654,851224
20151124,1660,1673,1661,1678,1648,1674,1665,1,-8,524596,804178
20151125,1674,1665,1679,1694,1656,1666,1668,1,3,786358,832130
20151126,1666,1668,1663,1704,1652,1663,1673,-5,5,853078,819440
20151127,1663,1673,1664,1670,1652,1652,1660,-21,-13,424986,782584
20151130,1652,1660,1652,1652,1608,1616,1628,-44,-32,640220,722606
rb1602,20150216,2571,2571,2540,2646,2540,2600,2606,29,35,10,2
20150217,2600,2606,2580,2595,2580,2595,2587,-11,-19,4,2
20150225,2595,2587,2580,2580,2543,2558,2560,-29,-27,10,8
20150226,2558,2560,2550,2568,2550,2568,2553,8,-7,540,472
20150227,2568,2553,2568,2577,2559,2560,2569,7,16,492,838
20150302,2560,2569,2552,2594,2543,2594,2563,25,-6,306,882
20150303,2594,2563,2589,2600,2580,2580,2588,17,25,266,878
20150304,2580,2588,2580,2581,2559,2569,2567,-19,-21,276,878
20150305,2569,2567,2561,2561,2529,2534,2539,-33,-28,104,878
20150306,2534,2539,2532,2535,2494,2496,2523,-43,-16,730,1368
20150309,2496,2523,2500,2510,2480,2490,2486,-33,-37,330,1486
20150310,2490,2486,2494,2495,2472,2473,2480,-13,-6,556,1754
20150311,2473,2480,2475,2485,2471,2483,2474,3,-6,622,2198
20150312,2483,2474,2486,2510,2448,2497,2485,23,11,596,2430
20150313,2497,2485,2506,2512,2485,2495,2502,10,17,98,2464
20150316,2495,2502,2491,2517,2489,2517,2508,15,6,402,2608
20150317,2517,2508,2519,2521,2501,2514,2513,6,5,96,2586
20150318,2514,2513,2497,2515,2482,2486,2490,-27,-23,1720,3244
20150319,2486,2490,2483,2499,2480,2485,2484,-5,-6,104,3218
20150320,2485,2484,2485,2493,2483,2490,2489,6,5,278,3382
20150323,2490,2489,2483,2543,2483,2543,2521,54,32,404,3336
20150324,2543,2521,2547,2559,2541,2548,2551,27,30,110,3328
20150325,2548,2551,2542,2547,2511,2511,2533,-40,-18,114,3330
20150326,2511,2533,2511,2518,2496,2496,2506,-37,-27,128,3356
20150327,2496,2506,2495,2495,2423,2483,2452,-23,-54,598,3546
20150330,2483,2452,2481,2481,2447,2456,2466,4,14,184,3558
20150331,2456,2466,2462,2470,2429,2441,2451,-25,-15,282,3612
20150401,2441,2451,2428,2428,2396,2396,2410,-55,-41,184,3636
20150402,2396,2410,2372,2399,2326,2360,2373,-50,-37,328,3682
20150403,2360,2373,2353,2377,2348,2348,2361,-25,-12,316,3688
20150407,2348,2361,2351,2351,2329,2329,2337,-32,-24,112,3710
20150408,2329,2337,2332,2362,2307,2345,2322,8,-15,374,3714
20150409,2345,2322,2336,2343,2316,2316,2324,-6,2,150,3770
20150410,2316,2324,2315,2316,2297,2297,2303,-27,-21,386,3796
20150413,2297,2303,2299,2352,2292,2352,2311,49,8,270,3786
20150414,2352,2311,2344,2361,2324,2352,2342,41,31,510,3668
20150415,2352,2342,2342,2348,2313,2317,2335,-25,-7,278,3848
20150416,2317,2335,2313,2346,2313,2339,2334,4,-1,90,3812
20150417,2339,2334,2332,2354,2327,2332,2337,-2,3,448,3758
20150420,2332,2337,2325,2336,2314,2314,2323,-23,-14,192,3746
20150421,2314,2323,2313,2325,2304,2310,2311,-13,-12,190,3830
20150422,2310,2311,2220,2356,2220,2350,2331,39,20,520,4108
20150423,2350,2331,2356,2356,2341,2352,2349,21,18,270,4150
20150424,2352,2349,2358,2406,2354,2400,2396,51,47,780,4140
20150427,2400,2396,2405,2448,2399,2448,2424,52,28,782,4182
20150428,2448,2424,2451,2470,2432,2432,2442,8,18,818,4450
20150429,2432,2442,2440,2449,2380,2388,2421,-54,-21,202,4444
20150430,2388,2421,2396,2419,2396,2408,2406,-13,-15,78,4462
20150504,2408,2406,2430,2459,2430,2452,2446,46,40,242,4418
20150505,2452,2446,2457,2480,2450,2479,2465,33,19,470,4474
20150506,2479,2465,2465,2485,2456,2470,2467,5,2,330,4468
20150507,2470,2467,2478,2478,2454,2458,2460,-9,-7,278,4532
20150508,2458,2460,2451,2463,2439,2457,2445,-3,-15,230,4492
20150511,2457,2445,2457,2465,2450,2456,2460,11,15,130,4548
20150512,2456,2460,2464,2464,2439,2441,2447,-19,-13,136,4554
20150513,2441,2447,2442,2451,2427,2436,2437,-11,-10,126,4578
20150514,2436,2437,2435,2435,2408,2422,2421,-15,-16,438,4746
20150515,2422,2421,2428,2434,2413,2431,2427,10,6,186,4798
20150518,2431,2427,2428,2435,2423,2423,2430,-4,3,268,4996
20150519,2423,2430,2418,2426,2416,2426,2418,-4,-12,156,5008
20150520,2426,2418,2411,2412,2361,2367,2394,-51,-24,1202,4964
20150521,2367,2394,2375,2405,2375,2402,2391,8,-3,106,4984
20150522,2402,2391,2398,2409,2385,2400,2398,9,7,244,4924
20150525,2400,2398,2396,2410,2393,2410,2400,12,2,200,4906
20150526,2410,2400,2413,2428,2413,2414,2418,14,18,568,4890
20150527,2414,2418,2416,2421,2411,2419,2419,1,1,252,4946
20150528,2419,2419,2423,2440,2418,2428,2427,9,8,194,4914
20150529,2428,2427,2435,2438,2417,2438,2429,11,2,224,4978
20150601,2438,2429,2444,2457,2437,2449,2445,20,16,924,5268
20150602,2449,2445,2452,2453,2448,2452,2451,7,6,38,5264
20150603,2452,2451,2455,2456,2423,2423,2431,-28,-20,350,5318
20150604,2423,2431,2514,2514,2418,2423,2428,-8,-3,262,5238
20150605,2423,2428,2421,2424,2397,2410,2410,-18,-18,132,5258
20150608,2410,2410,2412,2412,2390,2395,2393,-15,-17,308,5382
20150609,2395,2393,2391,2411,2391,2391,2399,-2,6,124,5408
20150610,2391,2399,2397,2404,2393,2399,2397,0,-2,124,5388
20150611,2399,2397,2406,2410,2392,2408,2403,11,6,56,5396
20150612,2408,2403,2394,2394,2356,2356,2373,-47,-30,602,5412
20150615,2356,2373,2363,2379,2332,2333,2342,-40,-31,440,5430
20150616,2333,2342,2333,2340,2302,2310,2326,-32,-16,442,5446
20150617,2310,2326,2305,2307,2279,2284,2291,-42,-35,720,5616
20150618,2284,2291,2294,2304,2281,2304,2293,13,2,276,5650
20150619,2304,2293,2301,2316,2300,2303,2312,10,19,296,5806
20150623,2303,2312,2294,2296,2286,2296,2292,-16,-20,284,5690
20150624,2296,2292,2300,2300,2287,2298,2295,6,3,100,5716
20150625,2298,2295,2294,2297,2278,2278,2287,-17,-8,168,5702
20150626,2278,2287,2281,2297,2280,2283,2286,-4,-1,184,5702
20150629,2283,2286,2286,2304,2263,2267,2280,-19,-6,1840,5664
20150630,2267,2280,2264,2265,2167,2212,2207,-68,-73,2450,5574
20150701,2212,2207,2216,2226,2207,2214,2218,7,11,848,5582
20150702,2214,2218,2208,2226,2183,2216,2200,-2,-18,1538,6028
20150703,2216,2200,2219,2229,2198,2204,2208,4,8,478,6200
20150706,2204,2208,2190,2190,2097,2097,2124,-111,-84,988,6310
20150707,2097,2124,2102,2102,2017,2017,2030,-107,-94,1870,5954
20150708,2017,2030,2009,2020,1867,1872,1938,-158,-92,2490,6170
20150709,1872,1938,1919,2034,1917,2028,1990,90,52,2920,6546
20150710,2028,1990,2025,2085,2025,2059,2068,69,78,2356,7170
20150713,2059,2068,2050,2074,2032,2044,2058,-24,-10,880,6970
20150714,2044,2058,2060,2078,2046,2054,2061,-4,3,1330,6882
20150715,2054,2061,2057,2060,2032,2032,2042,-29,-19,618,6586
20150716,2032,2042,2025,2056,2002,2029,2024,-13,-18,554,6394
20150717,2029,2024,2031,2048,2015,2038,2035,14,11,368,6434
20150720,2038,2035,2042,2111,2041,2102,2077,67,42,766,6356
20150721,2102,2077,2094,2110,2072,2075,2090,-2,13,510,6410
20150722,2075,2090,2071,2075,2015,2035,2042,-55,-48,1780,6694
20150723,2035,2042,2026,2057,2017,2051,2029,9,-13,654,6876
20150724,2051,2029,2057,2058,2035,2043,2046,14,17,300,6876
20150727,2043,2046,2046,2086,2045,2059,2067,13,21,654,6854
20150728,2059,2067,2051,2085,2044,2057,2063,-10,-4,814,6914
20150729,2057,2063,2073,2097,2072,2093,2086,30,23,1056,6862
20150730,2093,2086,2092,2115,2054,2073,2082,-13,-4,994,7174
20150731,2073,2082,2069,2089,2069,2076,2079,-6,-3,468,7190
20150803,2076,2079,2076,2110,2058,2060,2081,-19,2,1052,7484
20150804,2060,2081,2055,2087,2053,2082,2067,1,-14,324,7458
20150805,2082,2067,2088,2095,2071,2087,2078,20,11,470,7522
20150806,2087,2078,2069,2085,2063,2068,2072,-10,-6,418,7616
20150807,2068,2072,2065,2066,2038,2054,2051,-18,-21,366,7678
20150810,2054,2051,2054,2060,2031,2039,2041,-12,-10,680,7778
20150811,2039,2041,2033,2064,2033,2045,2051,4,10,218,7768
20150812,2045,2051,2037,2063,2037,2060,2051,9,0,414,7776
20150813,2060,2051,2075,2086,2065,2080,2076,29,25,644,7764
20150814,2080,2076,2079,2080,2067,2067,2073,-9,-3,168,7762
20150817,2067,2073,2078,2085,2054,2059,2066,-14,-7,604,7886
20150818,2059,2066,2058,2064,2048,2054,2054,-12,-12,538,8082
20150819,2054,2054,2046,2046,2023,2038,2030,-16,-24,402,8014
20150820,2038,2030,2039,2040,2020,2026,2024,-4,-6,608,8056
20150821,2026,2024,2024,2031,2018,2018,2026,-6,2,152,8060
20150824,2018,2026,2019,2019,1924,1924,1948,-102,-78,1490,8310
20150825,1924,1948,1936,1968,1909,1929,1934,-19,-14,1668,8184
20150826,1929,1934,1951,1968,1930,1931,1943,-3,9,678,8384
20150827,1931,1943,1928,1963,1926,1947,1950,4,7,498,8510
20150828,1947,1950,1956,1990,1948,1964,1973,14,23,744,8500
20150831,1964,1973,1951,1962,1939,1948,1948,-25,-25,868,8488
20150901,1948,1948,1946,1953,1933,1953,1945,5,-3,162,8490
20150902,1953,1945,1945,1955,1934,1942,1943,-3,-2,310,8488
20150907,1942,1943,1910,1934,1872,1903,1909,-40,-34,724,8422
20150908,1903,1909,1890,1928,1890,1928,1912,19,3,448,8484
20150909,1928,1912,1935,1971,1932,1934,1948,22,36,2642,8584
20150910,1934,1948,1938,1950,1928,1940,1935,-8,-13,622,8432
20150911,1940,1935,1944,1955,1930,1933,1941,-2,6,918,8834
20150914,1933,1941,1923,1932,1915,1915,1922,-26,-19,2114,9618
20150915,1915,1922,1912,1920,1900,1902,1911,-20,-11,518,9724
20150916,1902,1911,1906,1925,1903,1916,1912,5,1,736,9824
20150917,1916,1912,1914,1930,1908,1912,1919,0,7,926,9978
20150918,1912,1919,1891,1919,1891,1906,1911,-13,-8,632,10152
20150921,1906,1911,1904,1908,1882,1889,1895,-22,-16,968,10154
20150922,1889,1895,1894,1899,1874,1879,1881,-16,-14,1856,9842
20150923,1879,1881,1875,1887,1867,1883,1875,2,-6,710,9792
20150924,1883,1875,1887,1887,1872,1874,1880,-1,5,1118,10238
20150925,1874,1880,1871,1890,1871,1872,1878,-8,-2,688,10554
20150928,1872,1878,1871,1871,1843,1843,1856,-35,-22,632,10360
20150929,1843,1856,1840,1840,1805,1807,1816,-49,-40,2020,10276
20150930,1807,1816,1810,1818,1797,1800,1805,-16,-11,1170,10282
20151008,1800,1805,1800,1823,1800,1804,1809,-1,4,742,10552
20151009,1804,1809,1801,1841,1801,1830,1824,21,15,1392,11042
20151012,1830,1824,1848,1848,1815,1828,1832,4,8,1598,11194
20151013,1828,1832,1831,1831,1806,1816,1816,-16,-16,1468,11528
20151014,1816,1816,1818,1829,1810,1816,1816,0,0,1054,11522
20151015,1816,1816,1814,1825,1811,1815,1817,-1,1,704,11554
20151016,1815,1817,1817,1817,1807,1811,1812,-6,-5,542,11564
20151019,1811,1812,1812,1821,1791,1791,1803,-21,-9,782,11512
20151020,1791,1803,1800,1803,1784,1785,1793,-18,-10,1098,11578
20151021,1785,1793,1787,1794,1779,1787,1786,-6,-7,1160,11620
20151022,1787,1786,1791,1800,1784,1788,1790,2,4,802,11524
20151023,1788,1790,1785,1789,1766,1781,1781,-9,-9,1600,12448
20151026,1781,1781,1782,1793,1776,1780,1782,-1,1,1028,12624
20151027,1780,1782,1777,1793,1777,1788,1785,6,3,886,12772
20151028,1788,1785,1781,1792,1772,1774,1778,-11,-7,404,12754
20151029,1774,1778,1775,1783,1769,1779,1777,1,-1,352,12748
20151030,1779,1777,1778,1779,1768,1772,1773,-5,-4,470,12736
20151102,1772,1773,1771,1779,1769,1775,1773,2,0,270,12742
20151103,1775,1773,1775,1775,1764,1765,1767,-8,-6,1220,12830
20151104,1765,1767,1767,1767,1756,1761,1760,-6,-7,1638,12602
20151105,1761,1760,1763,1768,1757,1759,1761,-1,1,1044,12376
20151106,1759,1761,1757,1771,1757,1765,1763,4,2,698,12398
20151109,1765,1763,1766,1768,1761,1766,1765,3,2,1044,12560
20151110,1766,1765,1767,1771,1761,1765,1765,0,0,996,12274
20151111,1765,1765,1763,1763,1746,1749,1754,-16,-11,778,12320
20151112,1749,1754,1750,1750,1741,1745,1745,-9,-9,854,12154
20151113,1745,1745,1742,1753,1742,1746,1746,1,1,984,12116
20151116,1746,1746,1745,1758,1742,1743,1750,-3,4,598,12208
20151117,1743,1750,1747,1747,1738,1740,1742,-10,-8,486,12138
20151118,1740,1742,1739,1740,1722,1725,1733,-17,-9,1316,11712
20151119,1725,1733,1722,1725,1689,1699,1700,-34,-33,1782,11360
20151120,1699,1700,1699,1712,1690,1694,1703,-6,3,928,11398
20151123,1694,1703,1694,1694,1632,1642,1656,-61,-47,1342,11306
20151124,1642,1656,1647,1655,1641,1653,1647,-3,-9,718,11288
20151125,1653,1647,1651,1686,1642,1654,1653,7,6,1162,11318
20151126,1654,1653,1642,1683,1642,1653,1663,0,10,1934,11372
20151127,1653,1663,1661,1661,1637,1637,1648,-26,-15,708,11554
20151130,1637,1648,1625,1631,1581,1582,1607,-66,-41,4698,13158
rb1603,20150317,2508,2508,2501,2551,2501,2511,2512,3,4,76,64
20150318,2511,2512,2510,2511,2485,2488,2501,-24,-11,320,286
20150319,2488,2501,2479,2495,2479,2493,2486,-8,-15,542,680
20150320,2493,2486,2490,2496,2480,2495,2490,9,4,258,804
20150323,2495,2490,2486,2541,2484,2541,2516,51,26,368,910
20150324,2541,2516,2543,2569,2543,2548,2553,32,37,238,930
20150325,2548,2553,2548,2552,2521,2522,2532,-31,-21,212,948
20150326,2522,2532,2514,2524,2497,2497,2508,-35,-24,166,1042
20150327,2497,2508,2503,2503,2424,2489,2473,-19,-35,430,1184
20150330,2489,2473,2490,2502,2458,2469,2474,-4,1,290,1318
20150331,2469,2474,2468,2477,2428,2445,2438,-29,-36,928,1982
20150401,2445,2438,2426,2426,2396,2403,2412,-35,-26,478,2088
20150402,2403,2412,2365,2491,2360,2364,2374,-48,-38,1278,2178
20150403,2364,2374,2365,2389,2340,2353,2362,-21,-12,574,2366
20150407,2353,2362,2360,2364,2343,2344,2354,-18,-8,690,2496
20150408,2344,2354,2350,2369,2318,2356,2330,2,-24,678,2900
20150409,2356,2330,2416,2445,2301,2330,2332,0,2,566,3044
20150410,2330,2332,2314,2323,2296,2300,2307,-32,-25,296,3106
20150413,2300,2307,2297,2354,2295,2354,2310,47,3,486,3214
20150414,2354,2310,2341,2365,2330,2352,2342,42,32,1064,3324
20150415,2352,2342,2356,2356,2319,2319,2337,-23,-5,790,3782
20150416,2319,2337,2320,2353,2318,2345,2342,8,5,264,3698
20150417,2345,2342,2340,2357,2335,2337,2343,-5,1,406,3690
20150420,2337,2343,2331,2343,2321,2326,2328,-17,-15,394,3826
20150421,2326,2328,2324,2336,2316,2336,2322,8,-6,174,3906
20150422,2336,2322,2330,2373,2330,2363,2357,41,35,554,3972
20150423,2363,2357,2310,2373,2310,2362,2358,5,1,606,4110
20150424,2362,2358,2362,2423,2362,2409,2393,51,35,2020,4916
20150427,2409,2393,2420,2450,2408,2450,2423,57,30,506,5032
20150428,2450,2423,2457,2467,2437,2447,2454,24,31,510,5218
20150429,2447,2454,2441,2459,2384,2398,2420,-56,-34,352,5252
20150430,2398,2420,2398,2433,2398,2416,2417,-4,-3,242,5272
20150504,2416,2417,2435,2472,2409,2462,2456,45,39,248,5222
20150505,2462,2456,2468,2493,2461,2480,2477,24,21,904,5580
20150506,2480,2477,2482,2491,2465,2485,2478,8,1,744,5650
20150507,2485,2478,2467,2475,2458,2468,2464,-10,-14,232,5650
20150508,2468,2464,2462,2470,2439,2461,2449,-3,-15,442,5644
20150511,2461,2449,2470,2475,2455,2469,2468,20,19,230,5744
20150512,2469,2468,2469,2474,2449,2450,2456,-18,-12,126,5754
20150513,2450,2456,2455,2461,2438,2448,2445,-8,-11,372,5818
20150514,2448,2445,2445,2457,2411,2423,2433,-22,-12,858,6132
20150515,2423,2433,2425,2440,2419,2439,2428,6,-5,192,6132
20150518,2439,2428,2432,2444,2426,2430,2433,2,5,210,6240
20150519,2430,2433,2420,2429,2416,2416,2422,-17,-11,378,6372
20150520,2416,2422,2417,2417,2366,2373,2394,-49,-28,316,6514
20150521,2373,2394,2376,2407,2376,2403,2395,9,1,222,6528
20150522,2403,2395,2406,2415,2391,2401,2398,6,3,304,6498
20150525,2401,2398,2400,2429,2397,2411,2403,13,5,320,6514
20150526,2411,2403,2413,2435,2412,2418,2421,15,18,438,6494
20150527,2418,2421,2405,2427,2405,2422,2420,1,-1,200,6538
20150528,2422,2420,2426,2445,2426,2430,2438,10,18,376,6574
20150529,2430,2438,2433,2444,2421,2444,2435,6,-3,146,6584
20150601,2444,2435,2455,2471,2440,2453,2452,18,17,1386,7314
20150602,2453,2452,2453,2462,2453,2462,2458,10,6,164,7338
20150603,2462,2458,2458,2458,2436,2436,2442,-22,-16,142,7406
20150604,2436,2442,2426,2435,2420,2424,2426,-18,-16,84,7382
20150605,2424,2426,2425,2427,2404,2414,2416,-12,-10,146,7404
20150608,2414,2416,2412,2421,2397,2402,2407,-14,-9,264,7434
20150609,2402,2407,2397,2416,2397,2402,2403,-5,-4,262,7582
20150610,2402,2403,2401,2417,2401,2410,2410,7,7,110,7582
20150611,2410,2410,2422,2422,2407,2419,2413,9,3,58,7596
20150612,2419,2413,2414,2414,2367,2372,2390,-41,-23,612,7924
20150615,2372,2390,2373,2407,2351,2356,2376,-34,-14,418,7974
20150616,2356,2376,2346,2360,2333,2337,2338,-39,-38,732,8184
20150617,2337,2338,2340,2340,2287,2295,2308,-43,-30,342,8200
20150618,2295,2308,2302,2315,2289,2307,2297,-1,-11,1482,8210
20150619,2307,2297,2313,2328,2308,2318,2317,21,20,126,8216
20150623,2318,2317,2306,2306,2295,2306,2300,-11,-17,106,8210
20150624,2306,2300,2310,2312,2295,2311,2303,11,3,460,8226
20150625,2311,2303,2303,2310,2293,2293,2301,-10,-2,192,8228
20150626,2293,2301,2291,2307,2289,2293,2297,-8,-4,146,8216
20150629,2293,2297,2289,2313,2275,2275,2294,-22,-3,506,8198
20150630,2275,2294,2275,2275,2179,2231,2223,-63,-71,1148,8244
20150701,2231,2223,2225,2238,2220,2225,2229,2,6,248,8276
20150702,2225,2229,2205,2238,2196,2226,2217,-3,-12,602,8408
20150703,2226,2217,2232,2238,2207,2214,2222,-3,5,300,8420
20150706,2214,2222,2205,2205,2110,2110,2133,-112,-89,770,8426
20150707,2110,2133,2083,2102,1983,1996,2022,-137,-111,3138,7736
20150708,1996,2022,1998,2032,1920,1920,1951,-102,-71,2646,7218
20150709,1920,1951,1853,2048,1853,2037,1998,86,47,1356,6948
20150710,2037,1998,2060,2097,2060,2069,2078,71,80,766,6920
20150713,2069,2078,2053,2082,2050,2069,2062,-9,-16,734,6916
20150714,2069,2062,2074,2099,2065,2066,2075,4,13,394,6874
20150715,2066,2075,2068,2073,2043,2047,2052,-28,-23,512,6862
20150716,2047,2052,2044,2064,2005,2064,2033,12,-19,192,6856
20150717,2064,2033,2059,2064,2039,2046,2051,13,18,194,6892
20150720,2046,2051,2062,2113,2057,2102,2088,51,37,626,6898
20150721,2102,2088,2102,2118,2081,2085,2099,-3,11,782,6898
20150722,2085,2099,2066,2089,2032,2043,2060,-56,-39,692,7030
20150723,2043,2060,2044,2064,2030,2058,2041,-2,-19,266,6984
20150724,2058,2041,2062,2062,2037,2050,2050,9,9,210,7006
20150727,2050,2050,2063,2092,2060,2067,2071,17,21,442,7162
20150728,2067,2071,2047,2090,2044,2065,2063,-6,-8,504,7050
20150729,2065,2063,2079,2109,2072,2100,2089,37,26,940,7178
20150730,2100,2089,2100,2115,2077,2077,2091,-12,2,1354,7134
20150731,2077,2091,2077,2092,2072,2077,2082,-14,-9,414,7138
20150803,2077,2082,2086,2105,2060,2060,2083,-22,1,1406,7400
20150804,2060,2083,2058,2089,2043,2080,2070,-3,-13,226,7414
20150805,2080,2070,2087,2091,2073,2082,2082,12,12,372,7430
20150806,2082,2082,2085,2085,2060,2069,2070,-13,-12,444,7496
20150807,2069,2070,2060,2069,2036,2052,2051,-18,-19,320,7494
20150810,2052,2051,2054,2059,2033,2040,2041,-11,-10,190,7510
20150811,2040,2041,2041,2062,2041,2047,2055,6,14,422,7550
20150812,2047,2055,2047,2067,2046,2065,2056,10,1,114,7552
20150813,2065,2056,2078,2096,2071,2081,2085,25,29,702,7524
20150814,2081,2085,2082,2088,2077,2080,2079,-5,-6,88,7524
20150817,2080,2079,2082,2089,2058,2065,2072,-14,-7,174,7508
20150818,2065,2072,2055,2064,2046,2049,2053,-23,-19,270,7506
20150819,2049,2053,2037,2047,2025,2040,2033,-13,-20,278,7490
20150820,2040,2033,2040,2040,2017,2032,2030,-1,-3,192,7506
20150821,2032,2030,2024,2035,2020,2021,2028,-9,-2,256,7570
20150824,2021,2028,2021,2021,1926,1926,1961,-102,-67,1458,7882
20150825,1926,1961,1930,1951,1915,1926,1931,-35,-30,834,7818
20150826,1926,1931,1952,1952,1932,1932,1944,1,13,322,7856
20150827,1932,1944,1924,1965,1924,1950,1949,6,5,490,8086
20150828,1950,1949,1963,1990,1956,1965,1972,16,23,420,8090
20150831,1965,1972,1958,1960,1938,1945,1950,-27,-22,362,8024
20150901,1945,1950,1970,1970,1938,1944,1947,-6,-3,134,8026
20150902,1944,1947,1952,1952,1937,1940,1941,-7,-6,202,8026
20150907,1940,1941,1898,1931,1824,1912,1906,-29,-35,556,8026
20150908,1912,1906,1916,1936,1910,1936,1915,30,9,220,8120
20150909,1936,1915,1938,1959,1930,1936,1941,21,26,1066,8326
20150910,1936,1941,1935,1947,1927,1935,1937,-6,-4,256,8332
20150911,1935,1937,1943,1956,1930,1932,1942,-5,5,992,8544
20150914,1932,1942,1923,1933,1917,1917,1924,-25,-18,884,8786
20150915,1917,1924,1913,1925,1904,1904,1917,-20,-7,232,8832
20150916,1904,1917,1908,1928,1905,1918,1916,1,-1,192,8834
20150917,1918,1916,1919,1930,1911,1911,1919,-5,3,562,9138
20150918,1911,1919,1914,1917,1907,1909,1913,-10,-6,280,9140
20150921,1909,1913,1905,1910,1889,1894,1895,-19,-18,774,9412
20150922,1894,1895,1912,1913,1879,1887,1889,-8,-6,360,9444
20150923,1887,1889,1886,1889,1872,1884,1880,-5,-9,268,9422
20150924,1884,1880,1889,1889,1873,1876,1880,-4,0,228,9486
20150925,1876,1880,1870,1887,1870,1875,1878,-5,-2,398,9490
20150928,1875,1878,1865,1867,1845,1845,1857,-33,-21,544,9566
20150929,1845,1857,1845,1845,1810,1810,1823,-47,-34,1430,9500
20150930,1810,1823,1810,1818,1798,1803,1806,-20,-17,634,9550
20151008,1803,1806,1861,1861,1808,1810,1815,4,9,492,9552
20151009,1810,1815,1810,1847,1809,1841,1830,26,15,430,9552
20151012,1841,1830,1834,1849,1827,1832,1838,2,8,852,10058
20151013,1832,1838,1835,1835,1818,1827,1827,-11,-11,404,10124
20151014,1827,1827,1826,1832,1821,1821,1826,-6,-1,228,10168
20151015,1821,1826,1825,1830,1824,1828,1828,2,2,112,10192
20151016,1828,1828,1824,1829,1819,1819,1823,-9,-5,102,10196
20151019,1819,1823,1826,1830,1800,1802,1815,-21,-8,202,10204
20151020,1802,1815,1800,1807,1796,1799,1801,-16,-14,356,10290
20151021,1799,1801,1803,1803,1786,1796,1793,-5,-8,718,10280
20151022,1796,1793,1793,1804,1785,1790,1795,-3,2,304,10326
20151023,1790,1795,1796,1796,1770,1785,1780,-10,-15,318,10326
20151026,1785,1780,1790,1790,1761,1780,1779,0,-1,490,10472
20151027,1780,1779,1782,1787,1776,1780,1781,1,2,774,10450
20151028,1780,1781,1778,1782,1772,1773,1775,-8,-6,468,10468
20151029,1773,1775,1770,1781,1770,1776,1774,1,-1,228,10464
20151030,1776,1774,1777,1778,1770,1774,1773,0,-1,276,10466
20151102,1774,1773,1773,1780,1771,1773,1776,0,3,100,10464
20151103,1773,1776,1776,1776,1762,1762,1769,-14,-7,512,10558
20151104,1762,1769,1766,1767,1760,1760,1761,-9,-8,432,10558
20151105,1760,1761,1764,1769,1758,1763,1761,2,0,360,10510
20151106,1763,1761,1761,1777,1761,1767,1767,6,6,314,10476
20151109,1767,1767,1769,1773,1769,1770,1770,3,3,102,10470
20151110,1770,1770,1775,1779,1768,1774,1774,4,4,358,10352
20151111,1774,1774,1770,1770,1754,1756,1759,-18,-15,418,10306
20151112,1756,1759,1761,1761,1749,1749,1752,-10,-7,282,10150
20151113,1749,1752,1750,1754,1749,1749,1752,-3,0,192,10162
20151116,1749,1752,1747,1758,1745,1747,1750,-5,-2,146,10104
20151117,1747,1750,1745,1747,1741,1743,1743,-7,-7,214,9932
20151118,1743,1743,1740,1743,1729,1730,1735,-13,-8,1250,9206
20151119,1730,1735,1736,1736,1696,1703,1705,-32,-30,1830,8498
20151120,1703,1705,1698,1719,1696,1699,1705,-6,0,470,8508
20151123,1699,1705,1693,1693,1636,1650,1652,-55,-53,758,8102
20151124,1650,1652,1643,1657,1637,1653,1652,1,0,464,8076
20151125,1653,1652,1653,1682,1644,1655,1654,3,2,1106,8138
20151126,1655,1654,1642,1682,1642,1657,1665,3,11,1078,8348
20151127,1657,1665,1656,1658,1635,1637,1648,-28,-17,754,8478
20151130,1637,1648,1631,1637,1586,1589,1606,-59,-42,3864,9938
rb1604,20150416,2337,2337,,,,2342,2342,5,5,0,0
20150417,2342,2342,2337,2382,2337,2346,2360,4,18,54,22
20150420,2346,2360,2351,2376,2331,2353,2358,-7,-2,46,46
20150421,2353,2358,2336,2342,2328,2335,2336,-23,-22,28,54
20150422,2335,2336,2343,2395,2343,2383,2371,47,35,168,196
20150423,2383,2371,2383,2399,2382,2399,2391,28,20,56,220
20150424,2399,2391,2408,2463,2400,2438,2439,47,48,166,316
20150427,2438,2439,2456,2482,2424,2469,2453,30,14,196,348
20150428,2469,2453,2483,2487,2444,2464,2477,11,24,168,482
20150429,2464,2477,2469,2476,2426,2433,2455,-44,-22,214,630
20150430,2433,2455,2421,2454,2421,2451,2442,-4,-13,88,632
20150504,2451,2442,2462,2499,2460,2495,2486,53,44,118,666
20150505,2495,2486,2492,2517,2488,2494,2499,8,13,484,736
20150506,2494,2499,2494,2510,2483,2506,2500,7,1,410,942
20150507,2506,2500,2496,2505,2468,2491,2489,-9,-11,194,960
20150508,2491,2489,2489,2495,2470,2492,2482,3,-7,70,950
20150511,2492,2482,2486,2505,2482,2492,2493,10,11,40,948
20150512,2492,2493,2496,2496,2477,2477,2484,-16,-9,18,954
20150513,2477,2484,2485,2487,2461,2465,2475,-19,-9,84,996
20150514,2465,2475,2472,2478,2422,2443,2450,-32,-25,458,1102
20150515,2443,2450,2455,2462,2440,2462,2453,12,3,38,1098
20150518,2462,2453,2455,2457,2449,2449,2453,-4,0,62,1082
20150519,2449,2453,2430,2453,2424,2424,2429,-29,-24,500,948
20150520,2424,2429,2420,2420,2392,2400,2407,-29,-22,202,908
20150521,2400,2407,2404,2444,2401,2420,2411,13,4,68,898
20150522,2420,2411,2421,2430,2421,2421,2424,10,13,14,900
20150525,2421,2424,2417,2442,2415,2422,2425,-2,1,56,890
20150526,2422,2425,2436,2455,2432,2446,2440,21,15,30,888
20150527,2446,2440,2455,2455,2430,2439,2439,-1,-1,64,902
20150528,2439,2439,2440,2465,2440,2455,2454,16,15,60,894
20150529,2455,2454,2460,2460,2445,2460,2455,6,1,42,912
20150601,2460,2455,2477,2487,2471,2479,2476,24,21,92,946
20150602,2479,2476,2477,2486,2472,2480,2477,4,1,58,936
20150603,2480,2477,2478,2478,2450,2452,2457,-25,-20,172,930
20150604,2452,2457,2445,2446,2432,2443,2437,-14,-20,142,938
20150605,2443,2437,2443,2444,2425,2435,2433,-2,-4,114,910
20150608,2435,2433,2439,2439,2408,2412,2422,-21,-11,88,928
20150609,2412,2422,2406,2432,2406,2414,2420,-8,-2,30,932
20150610,2414,2420,2415,2429,2415,2421,2426,1,6,50,956
20150611,2421,2426,2433,2441,2426,2441,2433,15,7,20,954
20150612,2441,2433,2423,2428,2398,2398,2413,-35,-20,20,958
20150615,2398,2413,2397,2407,2392,2407,2400,-6,-13,18,958
20150616,2407,2400,2384,2397,2364,2373,2381,-27,-19,30,958
20150617,2373,2381,2359,2361,2325,2348,2340,-33,-41,58,960
20150618,2348,2340,2331,2344,2311,2344,2331,4,-9,240,992
20150619,2344,2331,2347,2347,2341,2341,2345,10,14,8,992
20150623,2341,2345,2326,2326,2326,2326,2326,-19,-19,2,994
20150624,2326,2326,,,,2329,2329,3,3,0,994
20150625,2329,2329,2338,2349,2330,2330,2343,1,14,74,1036
20150626,2330,2343,2341,2341,2235,2327,2334,-16,-9,840,1114
20150629,2327,2334,2327,2339,2312,2312,2328,-22,-6,68,1076
20150630,2312,2328,2300,2300,2229,2259,2264,-69,-64,602,1042
20150701,2259,2264,2267,2273,2254,2273,2269,9,5,108,1102
20150702,2273,2269,2247,2294,2247,2286,2265,17,-4,98,1104
20150703,2286,2265,2284,2288,2242,2242,2277,-23,12,76,1068
20150706,2242,2277,2245,2247,2163,2163,2182,-114,-95,88,1058
20150707,2163,2182,2135,2135,2072,2072,2100,-110,-82,316,1026
20150708,2072,2100,2020,2061,1933,1934,1974,-166,-126,576,954
20150709,1934,1974,1999,2072,1972,2066,2022,92,48,394,948
20150710,2066,2022,2098,2120,2082,2106,2105,84,83,122,942
20150713,2106,2105,2093,2108,2066,2066,2091,-39,-14,78,932
20150714,2066,2091,2091,2106,2077,2085,2099,-6,8,58,966
20150715,2085,2099,2063,2070,2063,2068,2066,-31,-33,18,976
20150716,2068,2066,2055,2087,2034,2067,2054,1,-12,174,940
20150717,2067,2054,2068,2075,2055,2074,2066,20,12,32,922
20150720,2074,2066,2061,2121,2061,2112,2104,46,38,154,902
20150721,2112,2104,2128,2129,2105,2105,2116,1,12,46,908
20150722,2105,2116,2088,2109,2050,2076,2089,-40,-27,64,902
20150723,2076,2089,2060,2086,2051,2076,2064,-13,-25,112,900
20150724,2076,2064,2090,2090,2070,2082,2076,18,12,30,920
20150727,2082,2076,2111,2119,2081,2103,2100,27,24,22,916
20150728,2103,2100,2089,2098,2061,2090,2076,-10,-24,138,968
20150729,2090,2076,2094,2132,2089,2118,2106,42,30,148,970
20150730,2118,2106,2128,2128,2084,2089,2100,-17,-6,112,962
20150731,2089,2100,2085,2100,2077,2081,2085,-19,-15,146,954
20150803,2081,2085,2090,2113,2077,2085,2090,0,5,102,956
20150804,2085,2090,2063,2092,2063,2092,2082,2,-8,40,956
20150805,2092,2082,2096,2097,2080,2088,2089,6,7,20,966
20150806,2088,2089,2085,2085,2074,2074,2079,-15,-10,36,962
20150807,2074,2079,2037,2081,2037,2061,2061,-18,-18,162,962
20150810,2061,2061,2056,2061,2032,2040,2046,-21,-15,42,958
20150811,2040,2046,2042,2067,2042,2051,2055,5,9,52,982
20150812,2051,2055,2054,2068,2054,2063,2062,8,7,30,966
20150813,2063,2062,2088,2095,2084,2089,2088,27,26,32,964
20150814,2089,2088,2090,2090,2082,2085,2084,-3,-4,70,1002
20150817,2085,2084,2086,2086,2072,2075,2078,-9,-6,32,1016
20150818,2075,2078,2073,2073,2055,2055,2063,-23,-15,14,1016
20150819,2055,2063,2041,2044,2031,2044,2036,-19,-27,16,1014
20150820,2044,2036,2044,2044,2032,2034,2036,-2,0,6,1010
20150821,2034,2036,2030,2035,2026,2026,2030,-10,-6,34,1024
20150824,2026,2030,2006,2014,1928,1928,1959,-102,-71,718,1164
20150825,1928,1959,1935,1976,1922,1937,1936,-22,-23,104,1136
20150826,1937,1936,1957,1959,1936,1936,1951,0,15,12,1136
20150827,1936,1951,1932,1971,1932,1954,1957,3,6,22,1142
20150828,1954,1957,1964,1996,1964,1985,1987,28,30,42,1140
20150831,1985,1987,1958,1966,1958,1962,1961,-25,-26,14,1142
20150901,1962,1961,1947,1963,1939,1954,1956,-7,-5,70,1106
20150902,1954,1956,1950,1953,1925,1943,1949,-13,-7,128,1134
20150907,1943,1949,1901,1935,1896,1920,1913,-29,-36,284,1178
20150908,1920,1913,1910,1932,1907,1932,1915,19,2,576,1510
20150909,1932,1915,1943,1968,1943,1944,1953,29,38,308,1504
20150910,1944,1953,1941,1946,1930,1946,1940,-7,-13,58,1534
20150911,1946,1940,1958,1958,1934,1938,1945,-2,5,122,1552
20150914,1938,1945,1932,1932,1923,1923,1930,-22,-15,152,1626
20150915,1923,1930,1920,1929,1908,1908,1921,-22,-9,86,1684
20150916,1908,1921,1911,1932,1911,1927,1927,6,6,152,1684
20150917,1927,1927,1932,1941,1930,1930,1934,3,7,110,1762
20150918,1930,1934,1931,1932,1919,1923,1926,-11,-8,350,2070
20150921,1923,1926,1924,1924,1891,1896,1906,-30,-20,86,2090
20150922,1896,1906,1904,1907,1888,1897,1896,-9,-10,140,2140
20150923,1897,1896,1885,1989,1885,1894,1905,-2,9,106,2162
20150924,1894,1905,1891,1902,1884,1884,1892,-21,-13,16,2164
20150925,1884,1892,1877,1902,1877,1889,1887,-3,-5,88,2186
20150928,1889,1887,1870,1872,1854,1854,1866,-33,-21,16,2186
20150929,1854,1866,1845,1845,1830,1839,1838,-27,-28,68,2184
20150930,1839,1838,1829,1829,1822,1824,1825,-14,-13,28,2184
20151008,1824,1825,1843,1843,1834,1834,1841,9,16,18,2184
20151009,1834,1841,1841,1869,1841,1867,1859,26,18,26,2184
20151012,1867,1859,1851,1863,1841,1841,1851,-18,-8,940,2752
20151013,1841,1851,1843,1843,1821,1830,1829,-21,-22,100,2748
20151014,1830,1829,1829,1835,1824,1828,1827,-1,-2,154,2752
20151015,1828,1827,1828,1837,1824,1829,1830,2,3,236,2906
20151016,1829,1830,1826,1829,1822,1824,1825,-6,-5,70,2906
20151019,1824,1825,1826,1832,1815,1815,1822,-10,-3,180,2906
20151020,1815,1822,1815,1818,1798,1801,1807,-21,-15,224,2906
20151021,1801,1807,1803,1803,1789,1795,1797,-12,-10,162,2898
20151022,1795,1797,1799,1805,1792,1797,1798,0,1,82,2904
20151023,1797,1798,1782,1799,1771,1784,1786,-14,-12,104,2922
20151026,1784,1786,1795,1795,1773,1781,1784,-5,-2,136,2924
20151027,1781,1784,1766,1796,1766,1785,1787,1,3,78,2912
20151028,1785,1787,1780,1790,1780,1781,1785,-6,-2,54,2916
20151029,1781,1785,1748,1785,1748,1785,1774,0,-11,16,2920
20151030,1785,1774,1786,1787,1780,1780,1784,6,10,64,2938
20151102,1780,1784,1786,1787,1786,1787,1786,3,2,6,2938
20151103,1787,1786,1786,1786,1775,1775,1779,-11,-7,634,3090
20151104,1775,1779,1778,1780,1774,1777,1777,-2,-2,350,3066
20151105,1777,1777,1780,1782,1773,1774,1776,-3,-1,216,3056
20151106,1774,1776,1779,1786,1777,1779,1780,3,4,1908,3348
20151109,1779,1780,1775,1787,1775,1780,1782,0,2,214,3446
20151110,1780,1782,1786,1787,1773,1778,1780,-4,-2,138,3450
20151111,1778,1780,1778,1778,1761,1761,1766,-19,-14,56,3448
20151112,1761,1766,1753,1758,1745,1750,1750,-16,-16,154,3476
20151113,1750,1750,1744,1757,1737,1747,1747,-3,-3,550,3574
20151116,1747,1747,1746,1769,1745,1747,1751,0,4,288,3622
20151117,1747,1751,1746,1765,1741,1741,1747,-10,-4,106,3624
20151118,1741,1747,1743,1745,1728,1733,1736,-14,-11,162,3636
20151119,1733,1736,1728,1728,1671,1700,1705,-36,-31,294,3600
20151120,1700,1705,1698,1711,1695,1697,1704,-8,-1,212,3630
20151123,1697,1704,1684,1684,1622,1646,1651,-58,-53,332,3490
20151124,1646,1651,1648,1668,1644,1652,1647,1,-4,276,3480
20151125,1652,1647,1655,1670,1645,1662,1658,15,11,156,3520
20151126,1662,1658,1662,1690,1662,1664,1668,6,10,228,3542
20151127,1664,1668,1669,1669,1639,1641,1651,-27,-17,572,3870
20151130,1641,1651,1632,1639,1608,1608,1625,-43,-26,538,3678
rb1605,20150518,2453,2453,2485,2485,2461,2464,2468,11,15,936,598
20150519,2464,2468,2461,2466,2444,2448,2458,-20,-10,3266,2838
20150520,2448,2458,2444,2449,2410,2417,2425,-41,-33,2934,3942
20150521,2417,2425,2418,2440,2418,2436,2433,11,8,3164,4512
20150522,2436,2433,2435,2447,2424,2445,2432,12,-1,4562,7590
20150525,2445,2432,2439,2450,2433,2449,2442,17,10,2576,8190
20150526,2449,2442,2446,2479,2446,2464,2466,22,24,7156,11652
20150527,2464,2466,2458,2473,2458,2469,2464,3,-2,3980,13324
20150528,2469,2464,2460,2485,2459,2469,2473,5,9,3952,14060
20150529,2469,2473,2466,2485,2455,2483,2469,10,-4,4132,15918
20150601,2483,2469,2488,2514,2483,2508,2501,39,32,11712,22096
20150602,2508,2501,2510,2510,2497,2508,2502,7,1,3994,21802
20150603,2508,2502,2508,2512,2481,2481,2496,-21,-6,4418,23168
20150604,2481,2496,2488,2489,2464,2476,2473,-20,-23,6106,23638
20150605,2476,2473,2470,2493,2451,2462,2466,-11,-7,4022,23530
20150608,2462,2466,2463,2468,2437,2441,2443,-25,-23,6986,24732
20150609,2441,2443,2441,2461,2439,2444,2450,1,7,4542,26038
20150610,2444,2450,2445,2466,2443,2459,2457,9,7,12742,32738
20150611,2459,2457,2463,2479,2457,2471,2465,14,8,10060,34040
20150612,2471,2465,2470,2470,2442,2443,2454,-22,-11,16768,40600
20150615,2443,2454,2443,2455,2421,2425,2440,-29,-14,12032,42282
20150616,2425,2440,2425,2433,2396,2405,2419,-35,-21,9286,44120
20150617,2405,2419,2405,2405,2365,2366,2379,-53,-40,11606,45596
20150618,2366,2379,2371,2383,2355,2361,2367,-18,-12,24938,50644
20150619,2361,2367,2355,2389,2355,2371,2374,4,7,7274,50554
20150623,2371,2374,2365,2377,2357,2369,2364,-5,-10,3380,50290
20150624,2369,2364,2369,2382,2364,2379,2374,15,10,8602,50642
20150625,2379,2374,2383,2384,2361,2362,2370,-12,-4,9756,54376
20150626,2362,2370,2364,2380,2357,2362,2365,-8,-5,7500,55166
20150629,2362,2365,2360,2380,2339,2340,2356,-25,-9,13168,55578
20150630,2340,2356,2340,2342,2258,2290,2299,-66,-57,33130,54184
20150701,2290,2299,2285,2313,2285,2299,2302,0,3,12222,58568
20150702,2299,2302,2293,2313,2270,2307,2292,5,-10,14140,60598
20150703,2307,2292,2303,2318,2288,2294,2305,2,13,14722,61572
20150706,2294,2305,2291,2291,2189,2189,2235,-116,-70,30318,68826
20150707,2189,2235,2178,2178,2058,2071,2116,-164,-119,55034,63156
20150708,2071,2116,2062,2101,2010,2010,2038,-106,-78,62744,68494
20150709,2010,2038,2000,2180,1990,2127,2093,89,55,61358,70772
20150710,2127,2093,2125,2174,2125,2141,2154,48,61,48376,76388
20150713,2141,2154,2130,2153,2046,2132,2135,-22,-19,35152,72178
20150714,2132,2135,2140,2159,2132,2135,2144,0,9,20158,73818
20150715,2135,2144,2139,2146,2111,2117,2129,-27,-15,15988,74430
20150716,2117,2129,2115,2132,2081,2118,2106,-11,-23,28180,74164
20150717,2118,2106,2114,2131,2099,2124,2118,18,12,21780,75024
20150720,2124,2118,2120,2220,2111,2169,2156,51,38,61804,84508
20150721,2169,2156,2170,2187,2142,2150,2165,-6,9,32812,91358
20150722,2150,2165,2150,2154,2082,2103,2120,-62,-45,31460,95178
20150723,2103,2120,2101,2130,2091,2120,2110,0,-10,25412,93366
20150724,2120,2110,2115,2130,2106,2113,2117,3,7,21648,96310
20150727,2113,2117,2114,2158,2112,2131,2135,14,18,37344,99400
20150728,2131,2135,2134,2149,2111,2130,2131,-5,-4,37798,101458
20150729,2130,2131,2130,2162,2130,2154,2147,23,16,59496,111974
20150730,2154,2147,2156,2160,2128,2130,2146,-17,-1,42202,117478
20150731,2130,2146,2120,2143,2103,2112,2119,-34,-27,96982,146536
20150803,2112,2119,2112,2126,2083,2094,2106,-25,-13,159374,206952
20150804,2094,2106,2089,2114,2088,2112,2102,6,-4,52990,201888
20150805,2112,2102,2114,2118,2100,2110,2109,8,7,60156,215114
20150806,2110,2109,2111,2115,2086,2091,2095,-18,-14,68506,237692
20150807,2091,2095,2090,2095,2056,2062,2070,-33,-25,102250,267546
20150810,2062,2070,2059,2071,2044,2050,2054,-20,-16,95000,294188
20150811,2050,2054,2052,2073,2048,2055,2061,1,7,113522,314728
20150812,2055,2061,2053,2078,2044,2078,2066,17,5,76614,322766
20150813,2078,2066,2083,2109,2083,2103,2099,37,33,99028,323822
20150814,2103,2099,2098,2105,2091,2098,2096,-1,-3,43490,326510
20150817,2098,2096,2099,2106,2077,2078,2090,-18,-6,62142,335234
20150818,2078,2090,2075,2083,2060,2060,2071,-30,-19,52194,339020
20150819,2060,2071,2059,2063,2034,2054,2045,-17,-26,99542,354848
20150820,2054,2045,2052,2057,2032,2039,2045,-6,0,86278,367872
20150821,2039,2045,2041,2049,2031,2032,2041,-13,-4,62870,374654
20150824,2032,2041,2036,2036,1938,1949,1976,-92,-65,202360,369680
20150825,1949,1976,1941,1979,1931,1955,1957,-21,-19,141228,360442
20150826,1955,1957,1988,1996,1957,1958,1975,1,18,105342,375264
20150827,1958,1975,1953,1993,1953,1982,1974,7,-1,81188,381694
20150828,1982,1974,1993,2012,1978,1989,1992,15,18,213784,430130
20150831,1989,1992,1981,1991,1958,1964,1971,-28,-21,219806,445150
20150901,1964,1971,1965,1975,1952,1964,1963,-7,-8,264696,482218
20150902,1964,1963,1965,1969,1952,1956,1959,-7,-4,128278,501026
20150907,1956,1959,1959,1959,1901,1929,1933,-30,-26,206232,513974
20150908,1929,1933,1929,1952,1924,1952,1934,19,1,143606,521728
20150909,1952,1934,1955,1992,1953,1963,1973,29,39,403102,544542
20150910,1963,1973,1961,1980,1955,1970,1966,-3,-7,233326,566238
20150911,1970,1966,1972,1979,1952,1953,1967,-13,1,296792,613874
20150914,1953,1967,1950,1958,1941,1950,1949,-17,-18,271314,610102
20150915,1950,1949,1950,1959,1932,1934,1949,-15,0,208498,615558
20150916,1934,1949,1936,1960,1932,1951,1947,2,-2,240278,627528
20150917,1951,1947,1952,1962,1945,1947,1951,0,4,202032,637616
20150918,1947,1951,1946,1953,1941,1942,1946,-9,-5,130262,640120
20150921,1942,1946,1939,1946,1916,1922,1929,-24,-17,174144,655424
20150922,1922,1929,1927,1932,1907,1912,1916,-17,-13,112414,670134
20150923,1912,1916,1909,1917,1903,1915,1910,-1,-6,179172,684676
20150924,1915,1910,1913,1919,1898,1903,1906,-7,-4,156364,707300
20150925,1903,1906,1901,1915,1891,1899,1906,-7,0,184402,711724
20150928,1899,1906,1895,1900,1870,1872,1884,-34,-22,165796,721018
20150929,1872,1884,1866,1871,1848,1850,1857,-34,-27,228840,699968
20150930,1850,1857,1851,1857,1841,1848,1847,-9,-10,134340,693992
20151008,1848,1847,1859,1880,1847,1858,1861,11,14,181100,717514
20151009,1858,1861,1858,1892,1854,1888,1878,27,17,354578,781678
20151012,1888,1878,1890,1899,1875,1880,1886,2,8,439802,826544
20151013,1880,1886,1878,1884,1856,1871,1867,-15,-19,287982,861244
20151014,1871,1867,1869,1872,1853,1856,1862,-11,-5,325880,949710
20151015,1856,1862,1855,1866,1852,1860,1859,-2,-3,271820,972764
20151016,1860,1859,1855,1859,1850,1851,1854,-8,-5,312446,1010262
20151019,1851,1854,1850,1859,1833,1836,1847,-18,-7,395276,1033706
20151020,1836,1847,1834,1845,1825,1828,1833,-19,-14,356702,1083274
20151021,1828,1833,1828,1834,1807,1815,1818,-18,-15,779904,1320754
20151022,1815,1818,1815,1830,1806,1809,1816,-9,-2,801672,1428528
20151023,1809,1816,1810,1812,1785,1803,1799,-13,-17,1091922,1537164
20151026,1803,1799,1805,1809,1787,1793,1795,-6,-4,1201124,1686458
20151027,1793,1795,1791,1814,1789,1803,1801,8,6,1384070,1779106
20151028,1803,1801,1801,1806,1792,1797,1798,-4,-3,972760,1740590
20151029,1797,1798,1795,1803,1793,1799,1799,1,1,602350,1727372
20151030,1799,1799,1800,1805,1792,1795,1797,-4,-2,575392,1753318
20151102,1795,1797,1795,1804,1791,1796,1797,-1,0,530768,1775586
20151103,1796,1797,1793,1796,1774,1776,1782,-21,-15,1411662,1873864
20151104,1776,1782,1777,1785,1773,1780,1777,-2,-5,1321266,2032100
20151105,1780,1777,1781,1788,1768,1776,1779,-1,2,1524966,2041548
20151106,1776,1779,1777,1808,1775,1794,1787,15,8,2568118,2158254
20151109,1794,1787,1791,1808,1788,1805,1799,18,12,1957650,2228016
20151110,1805,1799,1806,1811,1790,1797,1798,-2,-1,1808924,2223182
20151111,1797,1798,1795,1796,1775,1777,1785,-21,-13,1753724,2289778
20151112,1777,1785,1780,1780,1760,1765,1767,-20,-18,2324048,2514674
20151113,1765,1767,1764,1768,1758,1759,1761,-8,-6,1946790,2612404
20151116,1759,1761,1759,1768,1752,1753,1758,-8,-3,1964378,2662192
20151117,1753,1758,1753,1758,1748,1752,1752,-6,-6,1586652,2639974
20151118,1752,1752,1752,1753,1731,1736,1740,-16,-12,2100464,2737376
20151119,1736,1740,1736,1737,1692,1705,1709,-35,-31,4542824,2799492
20151120,1705,1709,1704,1712,1693,1695,1702,-14,-7,2733446,2863134
20151123,1695,1702,1695,1695,1649,1659,1670,-43,-32,4414044,2820906
20151124,1659,1670,1660,1673,1652,1667,1663,-3,-7,3414958,2824648
20151125,1667,1663,1666,1729,1659,1676,1676,13,13,6173106,2935306
20151126,1676,1676,1673,1722,1666,1680,1691,4,15,8211592,2905020
20151127,1680,1691,1680,1685,1654,1656,1668,-35,-23,4213766,2996760
20151130,1656,1668,1652,1660,1621,1626,1637,-42,-31,4700388,3042022
rb1606,20150616,2440,2440,2435,2443,2416,2416,2432,-24,-8,46,36
20150617,2416,2432,2412,2416,2375,2377,2396,-55,-36,254,122
20150618,2377,2396,2385,2390,2380,2384,2385,-12,-11,30,136
20150619,2384,2385,2389,2394,2382,2386,2389,1,4,20,140
20150623,2386,2389,2380,2380,2371,2378,2377,-11,-12,36,156
20150624,2378,2377,2390,2396,2384,2394,2391,17,14,34,170
20150625,2394,2391,2476,2476,2370,2370,2395,-21,4,52,178
20150626,2370,2395,2373,2393,2353,2369,2378,-26,-17,68,180
20150629,2369,2378,2373,2373,2349,2349,2366,-29,-12,16,172
20150630,2349,2366,2354,2354,2281,2307,2311,-59,-55,142,192
20150701,2307,2311,2312,2332,2289,2306,2315,-5,4,372,324
20150702,2306,2315,2297,2323,2283,2311,2297,-4,-18,146,346
20150703,2311,2297,2318,2332,2312,2313,2322,16,25,100,340
20150706,2313,2322,2302,2302,2205,2205,2249,-117,-73,264,392
20150707,2205,2249,2128,2210,2072,2081,2110,-168,-139,306,508
20150708,2081,2110,2080,2108,2004,2016,2039,-94,-71,586,658
20150709,2016,2039,2038,2140,2038,2135,2075,96,36,436,636
20150710,2135,2075,2160,2178,2138,2153,2157,78,82,232,656
20150713,2153,2157,2133,2149,2124,2129,2138,-28,-19,174,632
20150714,2129,2138,2137,2175,2137,2147,2155,9,17,174,696
20150715,2147,2155,2159,2159,2122,2124,2133,-31,-22,76,696
20150716,2124,2133,2121,2147,2097,2136,2129,3,-4,266,724
20150717,2136,2129,2141,2141,2122,2126,2127,-3,-2,68,748
20150720,2126,2127,2135,2183,2131,2179,2164,52,37,90,740
20150721,2179,2164,2184,2185,2163,2163,2175,-1,11,74,718
20150722,2163,2175,2146,2148,2100,2109,2114,-66,-61,188,834
20150723,2109,2114,2112,2128,2094,2118,2104,4,-10,480,1122
20150724,2118,2104,2115,2119,2101,2115,2110,11,6,114,1158
20150727,2115,2110,2111,2176,2106,2130,2127,20,17,184,1160
20150728,2130,2127,2112,2145,2106,2121,2115,-6,-12,154,1266
20150729,2121,2115,2141,2167,2129,2158,2150,43,35,192,1280
20150730,2158,2150,2150,2156,2140,2143,2148,-7,-2,56,1282
20150731,2143,2148,2130,2135,2107,2112,2125,-36,-23,218,1352
20150803,2112,2125,2110,2125,2089,2096,2102,-29,-23,462,1526
20150804,2096,2102,2087,2106,2087,2106,2100,4,-2,14,1528
20150805,2106,2100,2119,2142,2098,2101,2101,1,1,392,1822
20150806,2101,2101,2096,2097,2081,2091,2090,-10,-11,106,1858
20150807,2091,2090,2079,2082,2049,2056,2066,-34,-24,256,1964
20150810,2056,2066,2055,2063,2042,2053,2050,-13,-16,286,2054
20150811,2053,2050,2048,2063,2046,2055,2050,5,0,640,2130
20150812,2055,2050,2048,2071,2048,2067,2059,17,9,104,2126
20150813,2067,2059,2079,2099,2079,2084,2093,25,34,228,2124
20150814,2084,2093,2089,2090,2085,2086,2087,-7,-6,132,2176
20150817,2086,2087,2095,2096,2070,2070,2081,-17,-6,178,2200
20150818,2070,2081,2067,2072,2059,2060,2064,-21,-17,190,2316
20150819,2060,2064,2043,2051,2025,2045,2034,-19,-30,254,2416
20150820,2045,2034,2045,2048,2028,2032,2038,-2,4,92,2422
20150821,2032,2038,2029,2041,2029,2032,2039,-6,1,520,2498
20150824,2032,2039,2028,2036,1937,1947,1965,-92,-74,496,2650
20150825,1947,1965,1942,1967,1929,1946,1947,-19,-18,418,2780
20150826,1946,1947,1973,1973,1938,1938,1962,-9,15,210,2856
20150827,1938,1962,1940,1970,1940,1960,1956,-2,-6,42,2858
20150828,1960,1956,1970,1999,1969,1977,1981,21,25,152,2864
20150831,1977,1981,1965,1968,1952,1955,1959,-26,-22,196,2868
20150901,1955,1959,1959,1966,1923,1951,1954,-8,-5,542,3144
20150902,1951,1954,1954,1957,1942,1947,1949,-7,-5,182,3196
20150907,1947,1949,1941,1941,1906,1918,1918,-31,-31,132,3204
20150908,1918,1918,1924,1935,1911,1935,1923,17,5,394,3386
20150909,1935,1923,1944,1996,1940,1953,1964,30,41,552,3472
20150910,1953,1964,1953,1965,1946,1956,1954,-8,-10,162,3542
20150911,1956,1954,1960,1965,1950,1950,1958,-4,4,152,3574
20150914,1950,1958,1943,1949,1934,1938,1940,-20,-18,356,3762
20150915,1938,1940,1937,1941,1922,1924,1935,-16,-5,202,3874
20150916,1924,1935,1909,1945,1909,1937,1932,2,-3,272,3992
20150917,1937,1932,1937,1950,1936,1939,1940,7,8,280,4000
20150918,1939,1940,1941,1941,1930,1931,1935,-9,-5,136,4066
20150921,1931,1935,1934,1936,1909,1914,1917,-21,-18,512,4394
20150922,1914,1917,1923,1923,1900,1902,1908,-15,-9,388,4466
20150923,1902,1908,1901,1908,1893,1904,1902,-4,-6,236,4534
20150924,1904,1902,1908,1910,1896,1901,1904,-1,2,232,4606
20150925,1901,1904,1892,1912,1892,1898,1902,-6,-2,122,4616
20150928,1898,1902,1896,1896,1861,1861,1875,-41,-27,286,4776
20150929,1861,1875,1852,1863,1838,1840,1843,-35,-32,526,5054
20150930,1840,1843,1846,1846,1830,1837,1838,-6,-5,286,5150
20151008,1837,1838,1851,1863,1836,1842,1846,4,8,256,5280
20151009,1842,1846,1845,1875,1843,1872,1863,26,17,706,5714
20151012,1872,1863,1869,1878,1857,1864,1864,1,1,772,6074
20151013,1864,1864,1861,1863,1839,1851,1842,-13,-22,596,6554
20151014,1851,1842,1846,1851,1839,1839,1846,-3,4,200,6570
20151015,1839,1846,1842,1848,1838,1844,1842,-2,-4,244,6642
20151016,1844,1842,1838,1842,1834,1834,1838,-8,-4,312,6724
20151019,1834,1838,1836,1844,1812,1816,1830,-22,-8,566,6940
20151020,1816,1830,1822,1827,1808,1810,1814,-20,-16,794,7214
20151021,1810,1814,1814,1816,1789,1795,1801,-19,-13,1574,8136
20151022,1795,1801,1800,1809,1794,1794,1799,-7,-2,612,8244
20151023,1794,1799,1795,1798,1773,1789,1784,-10,-15,1422,8838
20151026,1789,1784,1790,1791,1777,1780,1782,-4,-2,1194,9214
20151027,1780,1782,1782,1796,1779,1787,1784,5,2,1160,9696
20151028,1787,1784,1783,1789,1778,1782,1783,-2,-1,1020,10024
20151029,1782,1783,1778,1785,1776,1783,1778,0,-5,1116,10648
20151030,1783,1778,1781,1786,1773,1777,1778,-1,0,1398,11570
20151102,1777,1778,1777,1784,1776,1779,1781,1,3,554,11550
20151103,1779,1781,1778,1782,1766,1768,1772,-13,-9,2300,12194
20151104,1768,1772,1769,1769,1761,1766,1765,-6,-7,1340,12804
20151105,1766,1765,1768,1772,1758,1762,1765,-3,0,1248,13354
20151106,1762,1765,1763,1786,1762,1775,1770,10,5,2000,14110
20151109,1775,1770,1774,1787,1770,1787,1778,17,8,1022,14408
20151110,1787,1778,1788,1789,1775,1782,1780,4,2,3660,15076
20151111,1782,1780,1777,1778,1761,1761,1767,-19,-13,1758,15494
20151112,1761,1767,1760,1763,1750,1754,1755,-13,-12,3596,16840
20151113,1754,1755,1752,1760,1750,1753,1754,-2,-1,1012,17162
20151116,1753,1754,1749,1763,1747,1749,1753,-5,-1,1582,17686
20151117,1749,1753,1749,1752,1744,1746,1747,-7,-6,554,17668
20151118,1746,1747,1748,1748,1730,1732,1737,-15,-10,1010,17588
20151119,1732,1737,1733,1734,1694,1705,1708,-32,-29,2278,17310
20151120,1705,1708,1702,1710,1694,1700,1700,-8,-8,1274,17346
20151123,1700,1700,1695,1698,1649,1654,1667,-46,-33,2878,16744
20151124,1654,1667,1659,1667,1649,1666,1657,-1,-10,1414,16706
20151125,1666,1657,1662,1712,1654,1676,1674,19,17,2274,16598
20151126,1676,1674,1676,1709,1664,1682,1687,8,13,2420,16568
20151127,1682,1687,1680,1682,1654,1656,1666,-31,-21,2104,17328
20151130,1656,1666,1650,1655,1620,1623,1633,-43,-33,3244,18242
rb1607,20150716,2133,2133,2076,2144,2076,2139,2119,6,-14,78,48
20150717,2139,2119,2139,2139,2113,2126,2127,7,8,38,44
20150720,2126,2127,2133,2187,2133,2179,2170,52,43,58,76
20150721,2179,2170,2178,2187,2164,2166,2174,-4,4,86,112
20150722,2166,2174,2152,2168,2112,2126,2136,-48,-38,66,126
20150723,2126,2136,2124,2136,2103,2122,2114,-14,-22,142,130
20150724,2122,2114,2129,2130,2109,2114,2119,0,5,100,184
20150727,2114,2119,2130,2150,2126,2132,2137,13,18,58,188
20150728,2132,2137,2113,2135,2113,2127,2123,-10,-14,20,188
20150729,2127,2123,2154,2159,2143,2159,2152,36,29,16,184
20150730,2159,2152,2147,2156,2140,2140,2145,-12,-7,22,182
20150731,2140,2145,2136,2136,2112,2113,2116,-32,-29,50,208
20150803,2113,2116,2114,2127,2097,2097,2105,-19,-11,290,310
20150804,2097,2105,2090,2116,2090,2116,2101,11,-4,108,334
20150805,2116,2101,2125,2125,2095,2105,2102,4,1,156,470
20150806,2105,2102,2099,2107,2081,2087,2094,-15,-8,236,596
20150807,2087,2094,2083,2098,2050,2056,2066,-38,-28,98,634
20150810,2056,2066,2061,2065,2043,2058,2053,-8,-13,142,660
20150811,2058,2053,2058,2069,2053,2062,2062,9,9,58,664
20150812,2062,2062,2056,2099,2048,2070,2074,8,12,54,658
20150813,2070,2074,2105,2107,2080,2107,2100,33,26,164,652
20150814,2107,2100,2093,2104,2093,2099,2096,-1,-4,126,712
20150817,2099,2096,2099,2107,2075,2075,2089,-21,-7,132,776
20150818,2075,2089,2080,2091,2057,2057,2067,-32,-22,258,940
20150819,2057,2067,2043,2049,2036,2048,2039,-19,-28,160,980
20150820,2048,2039,2044,2050,2035,2040,2043,1,4,70,996
20150821,2040,2043,2036,2044,2036,2036,2038,-7,-5,68,1026
20150824,2036,2038,2028,2028,1936,1939,1956,-99,-82,160,1046
20150825,1939,1956,1950,1966,1933,1953,1947,-3,-9,244,1130
20150826,1953,1947,2003,2003,1944,1949,1967,2,20,158,1200
20150827,1949,1967,1955,2015,1955,2010,1975,43,8,58,1204
20150828,2010,1975,1984,2009,1976,1985,1987,10,12,198,1208
20150831,1985,1987,2019,2019,1958,1960,1967,-27,-20,84,1206
20150901,1960,1967,1960,1961,1949,1952,1952,-15,-15,262,1354
20150902,1952,1952,1955,1959,1948,1951,1954,-1,2,138,1394
20150907,1951,1954,1919,1960,1912,1922,1930,-32,-24,254,1428
20150908,1922,1930,1924,1935,1919,1933,1925,3,-5,312,1602
20150909,1933,1925,1946,1982,1943,1957,1967,32,42,388,1650
20150910,1957,1967,1954,1965,1948,1963,1957,-4,-10,308,1910
20150911,1963,1957,1967,1972,1954,1954,1962,-3,5,446,2188
20150914,1954,1962,1945,1953,1937,1953,1944,-9,-18,58,2220
20150915,1953,1944,1951,1953,1938,1938,1939,-6,-5,248,2294
20150916,1938,1939,1948,1965,1940,1950,1949,11,10,228,2368
20150917,1950,1949,1955,1964,1948,1948,1957,-1,8,124,2384
20150918,1948,1957,1951,1951,1944,1944,1947,-13,-10,64,2434
20150921,1944,1947,1939,1939,1912,1916,1924,-31,-23,260,2644
20150922,1916,1924,1923,1923,1904,1909,1918,-15,-6,74,2678
20150923,1909,1918,1904,1916,1904,1907,1904,-11,-14,226,2842
20150924,1907,1904,1940,1940,1900,1903,1907,-1,3,58,2834
20150925,1903,1907,1910,1910,1903,1903,1908,-4,1,412,3236
20150928,1903,1908,1888,1897,1887,1889,1894,-19,-14,668,3796
20150929,1889,1894,1877,1877,1841,1842,1848,-52,-46,748,3680
20150930,1842,1848,1842,1846,1838,1846,1839,-2,-9,310,3688
20151008,1846,1839,1848,1861,1848,1858,1853,19,14,26,3686
20151009,1858,1853,1862,1887,1856,1887,1871,34,18,78,3686
20151012,1887,1871,1880,1888,1873,1873,1878,2,7,130,3694
20151013,1873,1878,1867,1871,1856,1863,1867,-15,-11,94,3694
20151014,1863,1867,1868,1868,1858,1858,1860,-9,-7,50,3692
20151015,1858,1860,1856,1869,1856,1862,1862,2,2,34,3690
20151016,1862,1862,1856,1858,1852,1852,1852,-10,-10,456,4108
20151019,1852,1852,1853,1859,1838,1838,1849,-14,-3,218,4100
20151020,1838,1849,1848,1848,1832,1835,1841,-14,-8,34,4108
20151021,1835,1841,1839,1839,1810,1818,1816,-23,-25,640,4468
20151022,1818,1816,1817,1831,1812,1812,1819,-4,3,34,4474
20151023,1812,1819,1817,1818,1787,1801,1798,-18,-21,216,4592
20151026,1801,1798,1799,1809,1785,1800,1795,2,-3,392,4830
20151027,1800,1795,1791,1808,1791,1801,1802,6,7,56,4858
20151028,1801,1802,1801,1808,1789,1792,1800,-10,-2,36,4862
20151029,1792,1800,1797,1802,1796,1802,1801,2,1,38,4864
20151030,1802,1801,1797,1797,1797,1797,1797,-4,-4,2,4864
20151102,1797,1797,1801,1801,1801,1801,1801,4,4,2,4864
20151103,1801,1801,1788,1788,1780,1783,1782,-18,-19,730,5430
20151104,1783,1782,1778,1778,1770,1773,1772,-9,-10,430,5672
20151105,1773,1772,1781,1781,1770,1770,1775,-2,3,130,5760
20151106,1770,1775,1773,1789,1773,1787,1779,12,4,52,5748
20151109,1787,1779,1781,1800,1781,1800,1796,21,17,244,5948
20151110,1800,1796,1798,1798,1784,1792,1788,-4,-8,220,5940
20151111,1792,1788,1781,1789,1778,1778,1783,-10,-5,32,5946
20151112,1778,1783,1773,1773,1763,1768,1767,-15,-16,56,5934
20151113,1768,1767,1759,1759,1750,1755,1754,-12,-13,120,5972
20151116,1755,1754,1756,1763,1750,1750,1755,-4,1,34,5978
20151117,1750,1755,1749,1751,1743,1743,1747,-12,-8,52,5960
20151118,1743,1747,1743,1745,1731,1731,1737,-16,-10,744,5808
20151119,1731,1737,1727,1729,1699,1709,1707,-28,-30,288,5738
20151120,1709,1707,1701,1701,1701,1701,1701,-6,-6,4,5738
20151123,1701,1701,1692,1692,1645,1654,1665,-47,-36,134,5712
20151124,1654,1665,1663,1672,1646,1659,1658,-6,-7,76,5706
20151125,1659,1658,1665,1700,1662,1677,1679,19,21,90,5678
20151126,1677,1679,1683,1725,1682,1683,1700,4,21,2710,6028
20151127,1683,1700,1690,1690,1654,1654,1670,-46,-30,826,6334
20151130,1654,1670,1650,1657,1603,1621,1627,-49,-43,134,6392
rb1608,20150818,2089,2089,2106,2106,2085,2099,2096,10,7,6,4
20150819,2099,2096,2061,2077,2048,2071,2065,-25,-31,52,40
20150820,2071,2065,2076,2076,2056,2060,2061,-5,-4,34,54
20150821,2060,2061,2055,2071,2042,2042,2051,-19,-10,142,82
20150824,2042,2051,2035,2041,1959,1963,2013,-88,-38,216,154
20150825,1963,2013,1971,2002,1958,1972,1977,-41,-36,98,174
20150826,1972,1977,2023,2023,1980,1993,1993,16,16,64,184
20150827,1993,1993,1973,2000,1973,2000,1988,7,-5,12,182
20150828,2000,1988,1994,2028,1994,2006,2010,18,22,44,180
20150831,2006,2010,1985,1999,1976,1986,1986,-24,-24,72,196
20150901,1986,1986,1978,1990,1973,1984,1982,-2,-4,40,208
20150902,1984,1982,1984,1984,1971,1980,1977,-2,-5,50,204
20150907,1980,1977,1963,1964,1943,1952,1953,-25,-24,24,210
20150908,1952,1953,1945,1972,1945,1963,1957,10,4,68,212
20150909,1963,1957,1970,2000,1970,1980,1992,23,35,88,238
20150910,1980,1992,1980,1996,1969,1979,1978,-13,-14,70,214
20150911,1979,1978,1982,1994,1973,1975,1979,-3,1,40,210
20150914,1975,1979,1968,1972,1960,1970,1964,-9,-15,54,228
20150915,1970,1964,1964,1991,1955,1957,1965,-7,1,86,244
20150916,1957,1965,1951,1973,1951,1972,1963,7,-2,56,242
20150917,1972,1963,1971,1988,1968,1968,1974,5,11,100,260
20150918,1968,1974,1973,1974,1961,1964,1968,-10,-6,52,266
20150921,1964,1968,1960,1965,1934,1941,1945,-27,-23,170,286
20150922,1941,1945,1941,1941,1920,1920,1929,-25,-16,106,320
20150923,1920,1929,1918,1927,1918,1927,1925,-2,-4,24,320
20150924,1927,1925,1926,1926,1916,1916,1921,-9,-4,4,320
20150925,1916,1921,1920,1931,1920,1921,1924,0,3,20,330
20150928,1921,1924,1921,1921,1907,1907,1911,-17,-13,6,336
20150929,1907,1911,1884,1884,1867,1867,1870,-44,-41,20,324
20150930,1867,1870,1860,1869,1860,1866,1865,-4,-5,14,326
20151008,1866,1865,1870,1890,1869,1880,1879,15,14,10,328
20151009,1880,1879,1876,1916,1876,1905,1899,26,20,66,358
20151012,1905,1899,1898,1917,1898,1901,1905,2,6,76,382
20151013,1901,1905,1898,1898,1878,1885,1889,-20,-16,18,384
20151014,1885,1889,1880,1889,1880,1882,1884,-7,-5,94,422
20151015,1882,1884,1885,1885,1885,1885,1885,1,1,6,422
20151016,1885,1885,1873,1876,1868,1868,1872,-17,-13,76,426
20151019,1868,1872,1869,1869,1851,1853,1861,-19,-11,50,420
20151020,1853,1861,1855,1855,1841,1841,1852,-20,-9,22,424
20151021,1841,1852,1830,1830,1827,1829,1829,-23,-23,30,440
20151022,1829,1829,1843,1843,1822,1822,1833,-7,4,8,444
20151023,1822,1833,1827,1828,1802,1811,1808,-22,-25,32,458
20151026,1811,1808,1808,1816,1807,1807,1810,-1,2,68,488
20151027,1807,1810,1812,1823,1812,1822,1821,12,11,676,1030
20151028,1822,1821,1820,1821,1816,1818,1819,-3,-2,126,1100
20151029,1818,1819,1817,1820,1817,1820,1818,1,-1,240,1326
20151030,1820,1818,1818,1821,1818,1819,1819,1,1,962,2242
20151102,1819,1819,1818,1821,1818,1818,1818,-1,-1,186,2382
20151103,1818,1818,1828,1828,1801,1806,1811,-12,-7,532,2822
20151104,1806,1811,1802,1803,1792,1798,1798,-13,-13,206,2850
20151105,1798,1798,1799,1801,1789,1790,1795,-8,-3,64,2850
20151106,1790,1795,1788,1798,1788,1798,1792,3,-3,152,2848
20151109,1798,1792,1801,1815,1801,1814,1808,22,16,128,2844
20151110,1814,1808,1808,1813,1805,1806,1808,-2,0,12,2840
20151111,1806,1808,1800,1804,1792,1792,1799,-16,-9,20,2846
20151112,1792,1799,1789,1789,1774,1774,1785,-25,-14,22,2852
20151113,1774,1785,1779,1784,1769,1769,1776,-16,-9,72,2842
20151116,1769,1776,1770,1770,1763,1763,1767,-13,-9,12,2844
20151117,1763,1767,1757,1765,1756,1756,1759,-11,-8,26,2844
20151118,1756,1759,1756,1756,1740,1740,1742,-19,-17,120,2842
20151119,1740,1742,1739,1739,1705,1717,1718,-25,-24,24,2842
20151120,1717,1718,1711,1712,1707,1711,1709,-7,-9,16,2842
20151123,1711,1709,1684,1691,1658,1665,1675,-44,-34,104,2818
20151124,1665,1675,1670,1681,1667,1675,1668,0,-7,54,2820
20151125,1675,1668,1679,1696,1675,1689,1690,21,22,260,3020
20151126,1689,1690,1685,1736,1683,1703,1698,13,8,522,2888
20151127,1703,1698,1692,1692,1666,1666,1687,-32,-11,30,2864
20151130,1666,1687,1662,1665,1633,1633,1657,-54,-30,100,2902
rb1609,20150916,1965,1965,1969,1989,1969,1983,1982,18,17,16,12
20150917,1983,1982,1998,2013,1979,1981,1989,-1,7,364,244
20150918,1981,1989,1984,1984,1973,1973,1981,-16,-8,86,258
20150921,1973,1981,1978,1978,1945,1947,1955,-34,-26,278,454
20150922,1947,1955,1960,1960,1912,1927,1937,-28,-18,1532,1698
20150923,1927,1937,1919,1932,1918,1932,1924,-5,-13,250,1838
20150924,1932,1924,1939,1939,1915,1925,1927,1,3,106,1886
20150925,1925,1927,1912,1936,1912,1918,1927,-9,0,80,1906
20150928,1918,1927,1927,1927,1900,1900,1910,-27,-17,564,2278
20150929,1900,1910,1909,1909,1882,1889,1889,-21,-21,240,2402
20150930,1889,1889,1888,1888,1869,1871,1876,-18,-13,248,2508
20151008,1871,1876,1888,1907,1884,1888,1891,12,15,448,2690
20151009,1888,1891,1890,1917,1887,1911,1901,20,10,896,3200
20151012,1911,1901,1906,1918,1900,1906,1911,5,10,2070,4530
20151013,1906,1911,1904,1909,1888,1899,1899,-12,-12,1556,5242
20151014,1899,1899,1895,1900,1890,1891,1895,-8,-4,586,5398
20151015,1891,1895,1899,1899,1889,1891,1893,-4,-2,794,5426
20151016,1891,1893,1886,1891,1868,1871,1881,-22,-12,1806,6328
20151019,1871,1881,1871,1876,1853,1854,1868,-27,-13,900,6660
20151020,1854,1868,1858,1866,1847,1848,1855,-20,-13,754,6802
20151021,1848,1855,1847,1852,1830,1831,1838,-24,-17,1164,6904
20151022,1831,1838,1829,1847,1829,1830,1834,-8,-4,478,7094
20151023,1830,1834,1830,1833,1812,1822,1822,-12,-12,822,7438
20151026,1822,1822,1822,1827,1809,1815,1819,-7,-3,1062,7628
20151027,1815,1819,1817,1835,1811,1821,1820,2,1,1312,7820
20151028,1821,1820,1817,1823,1816,1818,1819,-2,-1,1280,7552
20151029,1818,1819,1816,1823,1815,1819,1817,0,-2,972,7140
20151030,1819,1817,1820,1822,1816,1819,1818,2,1,608,7084
20151102,1819,1818,1816,1825,1816,1818,1820,0,2,392,7130
20151103,1818,1820,1819,1819,1802,1802,1807,-18,-13,978,7364
20151104,1802,1807,1801,1805,1791,1793,1796,-14,-11,1068,7602
20151105,1793,1796,1799,1805,1772,1786,1790,-10,-6,1076,7764
20151106,1786,1790,1785,1812,1782,1800,1794,10,4,1222,7792
20151109,1800,1794,1800,1818,1796,1817,1810,23,16,866,7770
20151110,1817,1810,1815,1822,1802,1810,1813,0,3,1032,7794
20151111,1810,1813,1810,1810,1792,1794,1798,-19,-15,466,7818
20151112,1794,1798,1791,1792,1774,1777,1783,-21,-15,1018,8168
20151113,1777,1783,1774,1778,1766,1766,1773,-17,-10,826,8386
20151116,1766,1773,1763,1770,1757,1757,1761,-16,-12,1796,8680
20151117,1757,1761,1754,1760,1752,1753,1755,-8,-6,478,8626
20151118,1753,1755,1753,1754,1738,1740,1745,-15,-10,1722,9114
20151119,1740,1745,1742,1742,1702,1710,1718,-35,-27,2998,9320
20151120,1710,1718,1712,1716,1704,1704,1709,-14,-9,686,9162
20151123,1704,1709,1701,1703,1658,1665,1679,-44,-30,2926,9650
20151124,1665,1679,1666,1683,1661,1678,1673,-1,-6,1410,9764
20151125,1678,1673,1679,1727,1672,1690,1690,17,17,2148,9276
20151126,1690,1690,1682,1735,1679,1695,1707,5,17,2512,9416
20151127,1695,1707,1691,1699,1670,1670,1681,-37,-26,1242,9438
20151130,1670,1681,1663,1669,1635,1636,1650,-45,-31,3276,10108
rb1610,20151016,1893,1893,1893,1893,1869,1869,1874,-24,-19,3824,3052
20151019,1869,1874,1870,1883,1858,1860,1870,-14,-4,4214,5482
20151020,1860,1870,1860,1868,1850,1852,1859,-18,-11,2100,6402
20151021,1852,1859,1853,1857,1834,1841,1844,-18,-15,5244,9076
20151022,1841,1844,1842,1854,1834,1834,1842,-10,-2,2570,9736
20151023,1834,1842,1832,1839,1816,1830,1826,-12,-16,5902,13132
20151026,1830,1826,1836,1838,1816,1819,1822,-7,-4,3618,14522
20151027,1819,1822,1821,1833,1817,1822,1824,0,2,7544,16662
20151028,1822,1824,1821,1826,1817,1819,1820,-5,-4,3464,17632
20151029,1819,1820,1820,1824,1815,1821,1820,1,0,3366,19162
20151030,1821,1820,1822,1825,1818,1822,1821,2,1,5238,21856
20151102,1822,1821,1823,1826,1818,1822,1822,1,1,3556,22426
20151103,1822,1822,1823,1823,1801,1804,1810,-18,-12,6594,24508
20151104,1804,1810,1802,1804,1791,1792,1796,-18,-14,10128,28622
20151105,1792,1796,1792,1806,1781,1784,1793,-12,-3,10948,34676
20151106,1784,1793,1783,1817,1783,1804,1796,11,3,15436,40310
20151109,1804,1796,1801,1820,1798,1818,1810,22,14,14358,45364
20151110,1818,1810,1818,1824,1805,1813,1812,3,2,12062,43932
20151111,1813,1812,1812,1812,1794,1795,1802,-17,-10,10856,45550
20151112,1795,1802,1795,1796,1776,1779,1784,-23,-18,23592,55094
20151113,1779,1784,1778,1784,1770,1770,1777,-14,-7,24194,67574
20151116,1770,1777,1772,1777,1758,1761,1766,-16,-11,24784,76418
20151117,1761,1766,1763,1770,1755,1760,1760,-6,-6,31064,93000
20151118,1760,1760,1761,1761,1740,1741,1748,-19,-12,31602,106496
20151119,1741,1748,1741,1742,1700,1710,1718,-38,-30,79868,133604
20151120,1710,1718,1710,1716,1701,1706,1709,-12,-9,49648,141472
20151123,1706,1709,1707,1707,1655,1666,1681,-43,-28,92838,162312
20151124,1666,1681,1666,1679,1658,1672,1668,-9,-13,59332,177894
20151125,1672,1668,1673,1723,1665,1683,1683,15,15,103454,175058
20151126,1683,1683,1682,1730,1672,1695,1700,12,17,117308,177206
20151127,1695,1700,1695,1697,1666,1668,1682,-32,-18,56630,187200
20151130,1668,1682,1666,1669,1631,1634,1647,-48,-35,76842,205262
rb1611,20151117,1766,1766,1747,1752,1742,1745,1746,-21,-20,1160,990
20151118,1745,1746,1745,1745,1735,1735,1740,-11,-6,894,1644
20151119,1735,1740,1740,1741,1694,1711,1707,-29,-33,920,2198
20151120,1711,1707,1711,1715,1698,1702,1704,-5,-3,336,2362
20151123,1702,1704,1697,1700,1653,1656,1671,-48,-33,1002,2770
20151124,1656,1671,1661,1664,1649,1664,1657,-7,-14,646,3154
20151125,1664,1657,1664,1699,1660,1678,1671,21,14,714,3474
20151126,1678,1671,1672,1715,1672,1699,1700,28,29,1162,3700
20151127,1699,1700,1691,1693,1659,1665,1680,-35,-20,402,3714
20151130,1665,1680,1655,1665,1625,1632,1645,-48,-35,1176,4196
ru1501,20150105,13640,13870,13650,13850,13580,13805,13760,-65,-110,4376,22104
20150106,13805,13760,13800,14430,13760,14335,14155,575,395,3876,21674
20150107,14335,14155,14300,14555,14300,14305,14470,150,315,4294,20700
20150108,14305,14470,14220,14220,13600,13605,13815,-865,-655,3270,19354
20150109,13605,13815,13560,14140,13325,14065,13800,250,-15,1850,19278
20150112,14065,13800,13920,14540,13920,14425,14255,625,455,2008,18346
20150113,14425,14255,14600,14605,14155,14155,14375,-100,120,406,18046
20150114,14155,14375,14190,14200,13800,13975,13975,-400,-400,276,18066
20150115,13975,13975,14150,14200,13150,13800,13780,-175,-195,206,18074
ru1503,20150105,13660,13715,13595,13665,13440,13530,13530,-185,-185,116,300
20150106,13530,13530,13525,13960,13410,13885,13745,355,215,154,326
20150107,13885,13745,13700,13945,13625,13700,13705,-45,-40,182,356
20150108,13700,13705,13520,13700,13350,13450,13515,-255,-190,162,360
20150109,13450,13515,13405,13865,13400,13700,13555,185,40,180,440
20150112,13700,13555,13720,13755,13605,13675,13710,120,155,108,466
20150113,13675,13710,13595,13595,13335,13480,13455,-230,-255,144,510
20150114,13480,13455,13350,13450,12970,12970,13155,-485,-300,296,452
20150115,12970,13155,13095,13500,13095,13420,13365,265,210,246,574
20150116,13420,13365,13445,13865,13325,13515,13555,150,190,632,788
20150119,13515,13555,13500,13570,13325,13400,13455,-155,-100,122,784
20150120,13400,13455,13255,13525,13100,13360,13425,-95,-30,142,816
20150121,13360,13425,13355,13685,13290,13685,13515,260,90,110,842
20150122,13685,13515,13570,13810,13570,13700,13705,185,190,462,1052
20150123,13700,13705,13605,13695,13435,13640,13610,-65,-95,120,1022
20150126,13640,13610,13600,13695,13005,13225,13215,-385,-395,340,954
20150127,13225,13215,13375,13595,13350,13525,13445,310,230,172,986
20150128,13525,13445,13430,13635,13360,13360,13450,-85,5,470,946
20150129,13360,13450,13335,13415,13200,13300,13270,-150,-180,104,944
20150130,13300,13270,13000,13135,12990,13010,13065,-260,-205,388,880
20150202,13010,13065,12995,13380,12965,13315,13155,250,90,192,870
20150203,13315,13155,13370,13480,13260,13310,13345,155,190,140,824
20150204,13310,13345,13335,13780,13300,13500,13605,155,260,208,892
20150205,13500,13605,13545,13600,13325,13325,13495,-280,-110,222,878
20150206,13325,13495,13390,13670,13340,13670,13460,175,-35,212,868
20150209,13670,13460,13565,13800,13430,13610,13600,150,140,108,872
20150210,13610,13600,13600,13620,13430,13525,13545,-75,-55,50,856
20150211,13525,13545,13450,13650,13450,13630,13595,85,50,138,828
20150212,13630,13595,13530,13530,13530,13530,13530,-65,-65,2,828
20150213,13530,13530,13600,13800,13600,13800,13730,270,200,92,826
20150216,13800,13730,13775,14000,13775,13945,13930,215,200,84,804
20150217,13945,13930,13970,13985,13705,13705,13800,-225,-130,130,808
20150225,13705,13800,13830,13855,13830,13850,13845,50,45,40,802
20150226,13850,13845,13830,14030,13830,13990,13935,145,90,272,898
20150227,13990,13935,14100,14100,13820,13970,13985,35,50,178,906
20150302,13970,13985,14020,14020,13680,13680,13805,-305,-180,148,808
20150303,13680,13805,13720,13775,13385,13440,13515,-365,-290,116,838
20150304,13440,13515,13435,13450,13300,13300,13390,-215,-125,154,924
20150305,13300,13390,13145,13215,13025,13100,13065,-290,-325,96,980
20150306,13100,13065,13175,13250,13050,13050,13105,-15,40,148,952
20150309,13050,13105,12990,13320,12990,13205,13175,100,70,88,924
20150310,13205,13175,13250,13250,12600,12600,13050,-575,-125,194,916
20150311,12600,13050,12820,13130,12550,12925,12945,-125,-105,148,916
20150312,12925,12945,13030,13245,13000,13115,13085,170,140,46,928
20150313,13115,13085,13050,13050,13050,13050,13050,-35,-35,60,908
20150316,13050,13050,13050,13050,12710,12890,12885,-160,-165,12,910
ru1504,20150105,13600,13610,13505,13505,13365,13365,13435,-245,-175,40,144
20150106,13365,13435,13800,13815,13710,13815,13760,380,325,20,142
20150107,13815,13760,13635,13635,13425,13530,13535,-230,-225,32,150
20150108,13530,13535,13520,13520,13245,13245,13390,-290,-145,18,144
20150109,13245,13390,13110,13460,13110,13300,13345,-90,-45,10,140
20150112,13300,13345,,,,13500,13500,155,155,0,140
20150113,13500,13500,,,,13250,13250,-250,-250,0,140
20150114,13250,13250,12995,12995,12625,12625,12675,-625,-575,14,150
20150115,12625,12675,12845,12870,12770,12860,12820,185,145,10,146
20150116,12860,12820,12865,12865,12865,12865,12865,45,45,2,146
20150119,12865,12865,13060,13070,13000,13000,13035,135,170,26,126
20150120,13000,13035,13165,13210,13040,13100,13135,65,100,26,126
20150121,13100,13135,13055,13325,12960,13325,13035,190,-100,44,114
20150122,13325,13035,13265,13560,13250,13455,13460,420,425,196,104
20150123,13455,13460,13450,13495,13245,13380,13375,-80,-85,26,100
20150126,13380,13375,13460,13545,12950,13265,13095,-110,-280,108,88
20150127,13265,13095,13420,13490,13340,13490,13420,395,325,36,92
20150128,13490,13420,13310,13485,13295,13405,13390,-15,-30,36,80
20150129,13405,13390,13235,13255,13110,13255,13220,-135,-170,20,72
20150130,13255,13220,13175,13345,12885,12885,13165,-335,-55,48,70
20150202,12885,13165,12910,13315,12910,13300,13055,135,-110,38,64
20150203,13300,13055,13635,13635,13270,13305,13320,250,265,36,60
20150204,13305,13320,13320,13780,13320,13600,13600,280,280,82,62
20150205,13600,13600,13540,13540,13430,13430,13475,-170,-125,34,50
20150206,13430,13475,13440,13550,13440,13550,13495,75,20,8,46
20150209,13550,13495,,,,13550,13550,55,55,0,46
20150210,13550,13550,13570,13635,13570,13635,13600,85,50,4,46
20150211,13635,13600,13555,13555,13555,13555,13555,-45,-45,4,46
20150212,13555,13555,13535,13535,13535,13535,13535,-20,-20,2,46
20150213,13535,13535,13660,13760,13570,13760,13665,225,130,14,48
20150216,13760,13665,13960,14100,13785,14080,14010,415,345,26,48
20150217,14080,14010,14025,14025,14000,14000,14015,-10,5,6,44
20150225,14000,14015,13885,13885,13715,13715,13800,-300,-215,4,44
20150226,13715,13800,13895,14120,13890,14065,14055,265,255,18,48
20150227,14065,14055,14060,14060,14060,14060,14060,5,5,2,46
20150302,14060,14060,,,,14060,14060,0,0,0,46
20150303,14060,14060,13620,13785,13400,13400,13600,-660,-460,8,46
20150304,13400,13600,13425,13425,13300,13300,13355,-300,-245,10,44
20150305,13300,13355,13130,13130,13125,13125,13125,-230,-230,4,44
20150306,13125,13125,13420,13420,13050,13050,13140,-75,15,76,76
20150309,13050,13140,,,,13140,13140,0,0,0,76
20150310,13140,13140,13135,13155,12905,12985,12990,-155,-150,20,76
20150311,12985,12990,13010,13010,13010,13010,13010,20,20,2,76
20150312,13010,13010,,,,13150,13150,140,140,0,76
20150313,13150,13150,,,,13110,13110,-40,-40,0,76
20150316,13110,13110,12930,12930,12930,12930,12930,-180,-180,10,66
20150317,12930,12930,13050,13050,12950,13050,12995,120,65,30,78
20150318,13050,12995,12920,12950,12920,12920,12930,-75,-65,6,80
20150319,12920,12930,12990,12990,12970,12970,12975,40,45,6,84
20150320,12970,12975,12995,12995,12840,12855,12910,-120,-65,20,84
20150323,12855,12910,13130,13350,13130,13350,13245,440,335,10,90
20150324,13350,13245,13485,13600,13405,13405,13510,160,265,54,84
20150325,13405,13510,13435,13435,13300,13300,13335,-210,-175,16,76
20150326,13300,13335,13550,13550,13550,13550,13550,215,215,4,76
20150327,13550,13550,13300,13300,13260,13260,13270,-290,-280,14,90
20150330,13260,13270,13280,13280,13275,13275,13275,5,5,4,90
20150331,13275,13275,13300,13300,13215,13215,13255,-60,-20,4,88
20150401,13215,13255,,,,13050,13050,-205,-205,0,88
20150402,13050,13050,,,,13050,13050,0,0,0,88
20150403,13050,13050,12920,12920,12920,12920,12920,-130,-130,4,88
20150407,12920,12920,12895,12895,12895,12895,12895,-25,-25,2,86
20150408,12895,12895,12800,12800,12635,12635,12715,-260,-180,8,90
20150409,12635,12715,,,,12635,12635,-80,-80,0,90
20150410,12635,12635,12400,12400,12325,12400,12390,-235,-245,26,66
20150413,12400,12390,,,,12390,12390,0,0,0,66
20150414,12390,12390,12600,12710,12600,12680,12690,290,300,16,80
20150415,12680,12690,12830,12830,12700,12800,12755,110,65,8,78
ru1505,20150105,13590,13525,13520,13535,13230,13365,13365,-160,-160,459516,183484
20150106,13365,13365,13245,13770,13245,13625,13600,260,235,658940,188338
20150107,13625,13600,13545,13695,13270,13350,13440,-250,-160,647204,181178
20150108,13350,13440,13375,13400,13065,13200,13225,-240,-215,592762,185218
20150109,13200,13225,13245,13475,12960,13250,13195,25,-30,695478,181638
20150112,13250,13195,13255,13485,13235,13285,13340,90,145,563020,182754
20150113,13285,13340,13220,13225,12900,12920,13045,-420,-295,559164,183636
20150114,12920,13045,12820,12965,12350,12425,12625,-620,-420,793010,191250
20150115,12425,12625,12485,12730,12415,12625,12580,0,-45,523152,193388
20150116,12625,12580,12655,12915,12510,12650,12680,70,100,587562,187658
20150119,12650,12680,12600,12820,12535,12750,12705,70,25,543434,183454
20150120,12750,12705,12630,12870,12620,12675,12755,-30,50,440242,187296
20150121,12675,12755,12715,13085,12465,12985,12795,230,40,679548,194262
20150122,12985,12795,12980,13425,12945,13215,13215,420,420,683898,190046
20150123,13215,13215,13215,13290,13020,13190,13145,-25,-70,529154,188226
20150126,13190,13145,13220,13325,12815,13070,13025,-75,-120,667780,180394
20150127,13070,13025,13115,13445,13115,13320,13305,295,280,618306,191416
20150128,13320,13305,13265,13455,13100,13280,13305,-25,0,584432,189116
20150129,13280,13305,13255,13320,13050,13145,13165,-160,-140,426992,176252
20150130,13145,13165,13105,13245,12855,12875,13035,-290,-130,482776,174456
20150202,12875,13035,12935,13320,12815,13255,13055,220,20,514914,189078
20150203,13255,13055,13265,13415,13215,13280,13300,225,245,452360,193652
20150204,13280,13300,13365,13825,13270,13500,13585,200,285,669098,186778
20150205,13500,13585,13565,13575,13300,13325,13430,-260,-155,479518,174930
20150206,13325,13430,13370,13750,13345,13745,13595,315,165,518732,185254
20150209,13745,13595,13700,13960,13540,13680,13680,85,85,468302,181632
20150210,13680,13680,13650,13710,13480,13560,13580,-120,-100,350566,171986
20150211,13560,13580,13500,13720,13445,13650,13620,70,40,331666,178424
20150212,13650,13620,13625,13715,13475,13620,13585,0,-35,344582,167544
20150213,13620,13585,13655,13995,13605,13925,13805,340,220,486006,170324
20150216,13925,13805,13930,14150,13855,14090,14025,285,220,384198,155830
20150217,14090,14025,14095,14155,13720,13875,13890,-150,-135,331690,132162
20150225,13875,13890,13775,14035,13755,13880,13895,-10,5,196478,139156
20150226,13880,13895,13895,14240,13870,14195,14050,300,155,313800,157422
20150227,14195,14050,14200,14300,13970,14095,14140,45,90,289830,150416
20150302,14095,14140,14110,14250,13760,13925,13965,-215,-175,398354,144794
20150303,13925,13965,13895,13980,13500,13595,13710,-370,-255,308024,133434
20150304,13595,13710,13600,13665,13400,13400,13550,-310,-160,204896,128626
20150305,13400,13550,13400,13430,13105,13260,13280,-290,-270,197888,121650
20150306,13260,13280,13280,13490,13155,13320,13345,40,65,190962,112874
20150309,13320,13345,13305,13470,13130,13385,13300,40,-45,162778,108650
20150310,13385,13300,13365,13420,13085,13110,13270,-190,-30,132476,103174
20150311,13110,13270,13105,13365,13055,13250,13205,-20,-65,124132,97816
20150312,13250,13205,13265,13415,13175,13365,13300,160,95,73328,96862
20150313,13365,13300,13365,13400,13240,13315,13300,15,0,62818,95470
20150316,13315,13300,13275,13280,12990,13140,13135,-160,-165,73584,92136
20150317,13140,13135,13135,13215,13055,13065,13125,-70,-10,61612,90758
20150318,13065,13125,13005,13095,12935,13020,13015,-105,-110,56972,87220
20150319,13020,13015,13005,13175,12970,13095,13080,80,65,49748,82042
20150320,13095,13080,13075,13120,12840,13050,13005,-30,-75,86288,79348
20150323,13050,13005,13095,13530,13090,13435,13340,430,335,85398,71288
20150324,13435,13340,13430,13690,13415,13500,13525,160,185,67658,65530
20150325,13500,13525,13450,13510,13330,13380,13400,-145,-125,44278,66420
20150326,13380,13400,13400,13625,13380,13550,13495,150,95,63144,60142
20150327,13550,13495,13495,13555,13175,13410,13360,-85,-135,67092,54684
20150330,13410,13360,13400,13450,13210,13225,13290,-135,-70,44460,51212
20150331,13225,13290,13235,13305,13150,13180,13235,-110,-55,41258,47134
20150401,13180,13235,13175,13240,12930,12935,13085,-300,-150,48988,37216
20150402,12935,13085,12925,13135,12900,13050,13050,-35,-35,30284,34166
20150403,13050,13050,13045,13100,12950,13050,13035,0,-15,19240,31462
20150407,13050,13035,13100,13250,12995,13020,13080,-15,45,14300,29420
20150408,13020,13080,13000,13030,12715,12780,12840,-300,-240,19888,26896
20150409,12780,12840,12660,12735,12300,12405,12475,-435,-365,23026,24418
20150410,12405,12475,12450,12485,12365,12425,12415,-50,-60,10660,22640
20150413,12425,12415,12490,12990,12490,12925,12840,510,425,20238,20500
20150414,12925,12840,13000,13015,12755,12875,12875,35,35,10202,18182
20150415,12875,12875,12850,12990,12830,12875,12905,0,30,7334,17438
20150416,12875,12905,12850,13050,12805,12990,12970,85,65,6118,16006
20150417,12990,12970,13000,13050,12850,12930,12955,-40,-15,5616,14566
20150420,12930,12955,12905,12965,12855,12880,12910,-75,-45,4144,13312
20150421,12880,12910,12850,13065,12760,13040,12970,130,60,7714,10530
20150422,13040,12970,13090,13120,12955,13015,13040,45,70,3602,8934
20150423,13015,13040,13040,13180,12990,13055,13065,15,25,3126,7950
20150424,13055,13065,13095,13115,13000,13080,13040,15,-25,1598,7266
20150427,13080,13040,13115,13820,13050,13820,13500,780,460,5436,5858
20150428,13820,13500,13900,14145,13710,13835,13970,335,470,2596,5074
20150429,13835,13970,13820,13905,13590,13670,13740,-300,-230,1602,4392
20150430,13670,13740,13675,14085,13675,14010,13945,270,205,1646,3950
20150504,14010,13945,14235,14780,14115,14520,14440,575,495,1224,3738
20150505,14520,14440,14545,14650,14405,14555,14500,115,60,826,3578
20150506,14555,14500,14650,14650,14420,14515,14530,15,30,610,3350
20150507,14515,14530,14650,14750,14180,14260,14475,-270,-55,956,2936
20150508,14260,14475,14350,14450,14180,14240,14285,-235,-190,400,2838
20150511,14240,14285,14260,14460,14095,14220,14220,-65,-65,546,2774
20150512,14220,14220,14190,14360,13950,14250,14170,30,-50,292,2692
20150513,14250,14170,14250,14350,14190,14190,14230,20,60,104,2628
20150514,14190,14230,14100,14100,13390,13720,13710,-510,-520,70,2656
20150515,13720,13710,13800,13800,13800,13800,13800,90,90,12,2656
ru1506,20150105,13255,13285,12920,13175,12920,13050,13025,-235,-260,74,1370
20150106,13050,13025,12970,13320,12930,13195,13170,170,145,290,1508
20150107,13195,13170,13030,13165,12800,12800,12990,-370,-180,244,1574
20150108,12800,12990,12865,12890,12630,12790,12775,-200,-215,68,1574
20150109,12790,12775,12665,13065,12650,12900,12840,125,65,76,1574
20150112,12900,12840,13200,13200,12130,12875,12925,35,85,106,1576
20150113,12875,12925,12695,12780,12435,12500,12635,-425,-290,56,1572
20150114,12500,12635,12500,12500,11950,12055,12240,-580,-395,182,1576
20150115,12055,12240,12105,12340,12035,12240,12195,0,-45,86,1578
20150116,12240,12195,12300,12585,12245,12370,12415,175,220,558,1584
20150119,12370,12415,12335,12470,12300,12350,12375,-65,-40,86,1574
20150120,12350,12375,12430,12445,12305,12305,12385,-70,10,44,1574
20150121,12305,12385,12350,12610,12210,12550,12450,165,65,202,1576
20150122,12550,12450,12615,12880,12165,12685,12705,235,255,358,1668
20150123,12685,12705,12685,12685,12500,12590,12575,-115,-130,110,1666
20150126,12590,12575,12645,12720,12265,12500,12470,-75,-105,152,1664
20150127,12500,12470,12690,12885,12645,12810,12770,340,300,540,1680
20150128,12810,12770,12780,12920,12625,12770,12795,0,25,162,1674
20150129,12770,12795,12800,12800,12540,12670,12645,-125,-150,64,1668
20150130,12670,12645,12655,12700,12375,12415,12555,-230,-90,216,1668
20150202,12415,12555,12320,12800,12315,12790,12600,235,45,316,1676
20150203,12790,12600,12730,12915,12715,12830,12830,230,230,236,1676
20150204,12830,12830,12835,13310,12820,13085,13125,255,295,174,1680
20150205,13085,13125,12975,13110,12940,12940,13020,-185,-105,200,1676
20150206,12940,13020,13005,13310,12980,13310,13185,290,165,60,1678
20150209,13310,13185,13310,13435,13170,13220,13235,35,50,130,1674
20150210,13220,13235,13150,13210,13060,13090,13100,-145,-135,110,1668
20150211,13090,13100,13040,13200,12970,13170,13045,70,-55,170,1666
20150212,13170,13045,13200,13235,13000,13115,13110,70,65,38,1666
20150213,13115,13110,13160,13450,13145,13360,13250,250,140,182,1670
20150216,13360,13250,13780,13780,13290,13290,13365,40,115,122,1676
20150217,13290,13365,13320,13345,13065,13145,13155,-220,-210,72,1674
20150225,13145,13155,13165,13195,13125,13125,13155,-30,0,16,1680
20150226,13125,13155,13180,13550,13180,13550,13305,395,150,80,1682
20150227,13550,13305,13545,13610,13400,13445,13505,140,200,254,1706
20150302,13445,13505,13450,13510,13110,13170,13210,-335,-295,178,1690
20150303,13170,13210,13200,13215,12745,12850,12990,-360,-220,178,1712
20150304,12850,12990,12845,13025,12845,12850,12945,-140,-45,198,1670
20150305,12850,12945,12880,13220,12650,12755,12800,-190,-145,554,1680
20150306,12755,12800,12755,12830,12550,12685,12705,-115,-95,252,1726
20150309,12685,12705,12580,12780,12535,12765,12675,60,-30,254,1684
20150310,12765,12675,12680,12700,12425,12425,12610,-250,-65,122,1674
20150311,12425,12610,12425,12750,12325,12630,12555,20,-55,112,1676
20150312,12630,12555,12665,12890,12525,12815,12715,260,160,154,1684
20150313,12815,12715,12725,12745,12645,12655,12695,-60,-20,92,1678
20150316,12655,12695,12565,12615,12350,12470,12435,-225,-260,534,1732
20150317,12470,12435,12540,12585,12435,12445,12495,10,60,118,1690
20150318,12445,12495,12445,12465,12335,12400,12400,-95,-95,36,1686
20150319,12400,12400,12255,12540,12255,12485,12435,85,35,64,1676
20150320,12485,12435,12465,12485,12310,12425,12390,-10,-45,188,1686
20150323,12425,12390,12500,12880,12500,12850,12685,460,295,286,1674
20150324,12850,12685,12870,13075,12855,12925,12940,240,255,86,1674
20150325,12925,12940,12820,12880,12765,12800,12800,-140,-140,50,1674
20150326,12800,12800,12840,13030,12840,12920,12935,120,135,88,1674
20150327,12920,12935,12855,12935,12485,12720,12785,-215,-150,340,1678
20150330,12720,12785,12605,12680,12540,12545,12615,-240,-170,152,1686
20150331,12545,12615,12565,12610,12405,12430,12510,-185,-105,62,1674
20150401,12430,12510,12400,12955,12400,12425,12515,-85,5,262,1684
20150402,12425,12515,12475,12675,12465,12580,12600,65,85,228,1682
20150403,12580,12600,12550,12635,12485,12590,12550,-10,-50,52,1676
20150407,12590,12550,12595,12740,12595,12660,12695,110,145,242,1684
20150408,12660,12695,12635,12695,12365,12365,12495,-330,-200,124,1674
20150409,12365,12495,12400,12430,12040,12050,12195,-445,-300,108,1672
20150410,12050,12195,12080,12170,12070,12135,12110,-60,-85,98,1640
20150413,12135,12110,12250,12505,12210,12410,12365,300,255,272,1620
20150414,12410,12365,12410,12500,12325,12400,12380,35,15,120,1556
20150415,12400,12380,12490,12550,12455,12485,12500,105,120,132,1532
20150416,12485,12500,12410,12650,12395,12580,12505,80,5,188,1502
20150417,12580,12505,12650,12675,12505,12640,12595,135,90,56,1466
20150420,12640,12595,12605,12650,12530,12560,12565,-35,-30,494,1436
20150421,12560,12565,12505,13020,12500,12975,12755,410,190,600,1212
20150422,12975,12755,13005,13155,12905,13000,13035,245,280,328,1120
20150423,13000,13035,13060,13265,13005,13095,13110,60,75,70,1130
20150424,13095,13110,13105,13190,13015,13140,13140,30,30,82,1132
20150427,13140,13140,13160,13925,13140,13900,13710,760,570,102,1144
20150428,13900,13710,14055,14225,13830,13900,13980,190,270,188,1110
20150429,13900,13980,14000,14020,13575,13720,13810,-260,-170,252,1086
20150430,13720,13810,13935,14165,13935,14080,14055,270,245,546,1108
20150504,14080,14055,14280,14895,14270,14670,14375,615,320,828,1182
20150505,14670,14375,14555,14760,14520,14635,14630,260,255,88,1196
20150506,14635,14630,14755,14825,14500,14715,14620,85,-10,40,1194
20150507,14715,14620,14715,14900,14260,14340,14470,-280,-150,116,1162
20150508,14340,14470,14305,14400,14255,14360,14285,-110,-185,72,1120
20150511,14360,14285,14455,14550,14195,14405,14300,120,15,90,1082
20150512,14405,14300,14415,14450,14260,14280,14360,-20,60,360,1082
20150513,14280,14360,14350,14495,14285,14285,14330,-75,-30,30,1068
20150514,14285,14330,14305,14305,13905,13925,14065,-405,-265,192,974
20150515,13925,14065,14010,14035,13950,14035,14000,-30,-65,64,980
20150518,14035,14000,14240,14375,13915,14160,14120,160,120,88,980
20150519,14160,14120,14230,14230,13955,13995,14040,-125,-80,38,960
20150520,13995,14040,13905,14040,13300,13475,13600,-565,-440,288,918
20150521,13475,13600,13585,13595,13510,13520,13555,-80,-45,12,912
20150522,13520,13555,13705,13750,13555,13635,13630,80,75,32,908
20150525,13635,13630,13600,13645,13455,13645,13550,15,-80,48,902
20150526,13645,13550,14050,14360,14050,14090,14140,540,590,46,914
20150527,14090,14140,14295,14295,14015,14065,14070,-75,-70,158,962
20150528,14065,14070,14445,14815,14270,14270,14490,200,420,198,870
20150529,14270,14490,14510,14595,14180,14500,14410,10,-80,162,834
20150601,14500,14410,14775,15210,14400,14535,14785,125,375,298,836
20150602,14535,14785,14715,14805,13895,14285,14370,-500,-415,108,828
20150603,14285,14370,14395,14400,14165,14165,14310,-205,-60,128,840
20150604,14165,14310,14155,15165,13855,14250,14000,-60,-310,190,718
20150605,14250,14000,14110,14625,14080,14100,14120,100,120,88,668
20150608,14100,14120,14010,14200,14010,14105,14160,-15,40,180,658
20150609,14105,14160,14135,14290,14100,14100,14155,-60,-5,230,634
20150610,14100,14155,14385,14385,14080,14105,14135,-50,-20,38,636
20150611,14105,14135,14105,14105,14060,14060,14070,-75,-65,8,630
20150612,14060,14070,,,,14070,14070,0,0,0,630
20150615,14070,14070,13525,13525,13525,13525,13525,-545,-545,8,630
ru1507,20150105,13245,13240,12935,13025,12935,13025,12980,-215,-260,8,184
20150106,13025,12980,13130,13395,13130,13315,13270,335,290,32,190
20150107,13315,13270,13170,13210,12920,12920,13175,-350,-95,22,192
20150108,12920,13175,12920,12920,12920,12920,12920,-255,-255,2,190
20150109,12920,12920,12785,12945,12690,12945,12840,25,-80,14,192
20150112,12945,12840,13050,13050,13050,13050,13050,210,210,2,192
20150113,13050,13050,12800,12800,12625,12625,12680,-425,-370,10,188
20150114,12625,12680,12495,12495,12495,12495,12495,-185,-185,2,190
20150115,12495,12495,12230,12230,12230,12230,12230,-265,-265,2,192
20150116,12230,12230,12545,12545,12305,12305,12445,75,215,42,206
20150119,12305,12445,12410,12460,12240,12300,12335,-145,-110,44,204
20150120,12300,12335,12390,12500,12390,12500,12415,165,80,10,198
20150121,12500,12415,12345,12570,12345,12570,12455,155,40,4,194
20150122,12570,12455,12715,12715,12715,12715,12715,260,260,2,194
20150123,12715,12715,12580,12580,12580,12580,12580,-135,-135,2,192
20150126,12580,12580,12675,12675,12675,12675,12675,95,95,4,192
20150127,12675,12675,12675,12940,12675,12940,12805,265,130,4,190
20150128,12940,12805,12805,12850,12690,12740,12775,-65,-30,10,192
20150129,12740,12775,,,,12775,12775,0,0,0,192
20150130,12775,12775,,,,12680,12680,-95,-95,0,192
20150202,12680,12680,,,,12750,12750,70,70,0,192
20150203,12750,12750,12760,12915,12715,12795,12810,45,60,88,202
20150204,12795,12810,12850,13180,12850,13010,13100,200,290,40,190
20150205,13010,13100,12975,13020,12955,12960,12990,-140,-110,26,184
20150206,12960,12990,12890,13210,12890,13210,13060,220,70,8,182
20150209,13210,13060,13155,13290,13155,13175,13220,115,160,18,178
20150210,13175,13220,,,,13220,13220,0,0,0,178
20150211,13220,13220,,,,13220,13220,0,0,0,178
20150212,13220,13220,13005,13085,13005,13050,13025,-170,-195,14,182
20150213,13050,13025,13230,13370,13230,13370,13285,345,260,10,184
20150216,13370,13285,13165,13385,13165,13385,13285,100,0,12,182
20150217,13385,13285,13315,13315,13185,13185,13270,-100,-15,6,180
20150225,13185,13270,,,,13270,13270,0,0,0,180
20150226,13270,13270,,,,13420,13420,150,150,0,180
20150227,13420,13420,,,,13620,13620,200,200,0,180
20150302,13620,13620,13275,13385,13125,13170,13250,-450,-370,12,178
20150303,13170,13250,13165,13165,12830,12910,12930,-340,-320,138,238
20150304,12910,12930,12885,13030,12885,13030,12965,100,35,32,238
20150305,13030,12965,12870,12870,12600,12700,12685,-265,-280,154,198
20150306,12700,12685,12770,12825,12580,12580,12740,-105,55,40,176
20150309,12580,12740,12520,12780,12480,12780,12670,40,-70,32,172
20150310,12780,12670,12675,12690,12425,12425,12645,-245,-25,26,172
20150311,12425,12645,12515,12715,12515,12650,12605,5,-40,20,178
20150312,12650,12605,12630,12740,12530,12740,12630,135,25,16,176
20150313,12740,12630,,,,12630,12630,0,0,0,176
20150316,12630,12630,12500,12515,12395,12485,12495,-145,-135,18,182
20150317,12485,12495,,,,12495,12495,0,0,0,182
20150318,12495,12495,12395,12395,12370,12370,12375,-125,-120,10,182
20150319,12370,12375,12350,12540,12350,12530,12495,155,120,20,180
20150320,12530,12495,12380,12380,12380,12380,12380,-115,-115,2,178
20150323,12380,12380,12455,12870,12455,12845,12720,465,340,6,180
20150324,12845,12720,13020,13020,12925,12925,12965,205,245,6,176
20150325,12925,12965,12845,12885,12845,12885,12850,-80,-115,42,174
20150326,12885,12850,12795,13050,12795,13045,12985,195,135,8,168
20150327,13045,12985,12615,12690,12610,12610,12630,-375,-355,10,166
20150330,12610,12630,12550,12550,12550,12550,12550,-80,-80,2,166
20150331,12550,12550,12565,12625,12505,12505,12565,-45,15,6,166
20150401,12505,12565,12500,12500,12500,12500,12500,-65,-65,4,166
20150402,12500,12500,12620,12705,12550,12680,12640,180,140,10,166
20150403,12680,12640,,,,12640,12640,0,0,0,166
20150407,12640,12640,12695,12695,12695,12695,12695,55,55,2,166
20150408,12695,12695,12460,12460,12460,12460,12460,-235,-235,2,166
20150409,12460,12460,12150,12150,12150,12150,12150,-310,-310,2,168
20150410,12150,12150,,,,12065,12065,-85,-85,0,168
20150413,12065,12065,12300,12510,12300,12495,12440,430,375,10,168
20150414,12495,12440,12320,12320,12320,12320,12320,-120,-120,2,168
20150415,12320,12320,12400,12400,12400,12400,12400,80,80,2,170
20150416,12400,12400,12675,12675,12675,12675,12675,275,275,4,170
20150417,12675,12675,12500,12500,12500,12500,12500,-175,-175,10,170
20150420,12500,12500,12615,12615,12615,12615,12615,115,115,4,170
20150421,12615,12615,12520,12980,12520,12980,12880,365,265,14,166
20150422,12980,12880,12985,13085,12985,13050,13030,170,150,12,164
20150423,13050,13030,13145,13325,13095,13115,13145,85,115,30,146
20150424,13115,13145,13185,13310,13185,13195,13235,50,90,16,146
20150427,13195,13235,13250,14020,13250,14000,13595,765,360,26,144
20150428,14000,13595,14410,14410,13960,14000,14025,405,430,82,114
20150429,14000,14025,14040,14040,13770,13785,13925,-240,-100,70,120
20150430,13785,13925,14265,14335,14190,14230,14245,305,320,48,116
20150504,14230,14245,14460,14955,14460,14815,14755,570,510,28,134
20150505,14815,14755,14810,14980,14745,14760,14835,5,80,26,142
20150506,14760,14835,14840,14865,14730,14730,14820,-105,-15,10,150
20150507,14730,14820,14870,14870,14340,14475,14600,-345,-220,20,154
20150508,14475,14600,14520,14600,14320,14495,14470,-105,-130,42,164
20150511,14495,14470,14595,14705,14320,14440,14445,-30,-25,28,162
20150512,14440,14445,14705,14705,14340,14340,14520,-105,75,18,164
20150513,14340,14520,14320,14465,14295,14295,14400,-225,-120,44,164
20150514,14295,14400,14025,14025,13930,13950,13955,-450,-445,24,156
20150515,13950,13955,14210,14210,14210,14210,14210,255,255,6,152
20150518,14210,14210,,,,14330,14330,120,120,0,152
20150519,14330,14330,14220,14220,14220,14220,14220,-110,-110,2,152
20150520,14220,14220,13425,13425,13405,13405,13405,-815,-815,10,148
20150521,13405,13405,13700,13700,13590,13590,13650,185,245,8,148
20150522,13590,13650,13600,13715,13600,13715,13655,65,5,8,146
20150525,13715,13655,13695,13795,13555,13795,13705,140,50,12,156
20150526,13795,13705,13860,14515,13860,14200,14175,495,470,86,154
20150527,14200,14175,14360,14390,14165,14325,14295,150,120,48,148
20150528,14325,14295,14335,14900,14335,14655,14755,360,460,52,134
20150529,14655,14755,14215,14720,14215,14720,14385,-35,-370,24,136
20150601,14720,14385,14650,14650,14650,14650,14650,265,265,2,134
20150602,14650,14650,,,,14240,14240,-410,-410,0,134
20150603,14240,14240,14500,14500,14210,14210,14415,-30,175,74,164
20150604,14210,14415,14035,14220,14030,14195,14175,-220,-240,52,130
20150605,14195,14175,14325,14325,14035,14035,14125,-140,-50,16,130
20150608,14035,14125,14115,14120,14055,14120,14095,-5,-30,6,132
20150609,14120,14095,14170,14175,14170,14175,14170,80,75,8,134
20150610,14175,14170,,,,14150,14150,-20,-20,0,134
20150611,14150,14150,14350,14350,14300,14300,14325,150,175,12,132
20150612,14300,14325,14250,14250,13860,13860,14130,-465,-195,30,138
20150615,13860,14130,13780,13815,13730,13730,13775,-400,-355,14,136
20150616,13730,13775,13800,14600,13575,14600,14145,825,370,44,162
20150617,14600,14145,13680,13895,13680,13845,13815,-300,-330,40,152
20150618,13845,13815,13755,13755,13485,13520,13580,-295,-235,10,162
20150619,13520,13580,13550,13550,13550,13550,13550,-30,-30,2,162
20150623,13550,13550,13880,13880,13520,13720,13690,170,140,10,164
20150624,13720,13690,13780,13790,13680,13700,13735,10,45,40,178
20150625,13700,13735,13600,13600,13295,13295,13380,-440,-355,70,220
20150626,13295,13380,13235,13235,13235,13235,13235,-145,-145,2,218
20150629,13235,13235,13415,13415,12950,13035,13340,-200,105,76,216
20150630,13035,13340,12535,12535,12535,12535,12535,-805,-805,2,214
20150701,12535,12535,12465,13200,12465,13000,12890,465,355,22,212
20150702,13000,12890,13080,13195,12880,13195,13035,305,145,42,216
20150703,13195,13035,13530,13530,13530,13530,13530,495,495,2,218
20150706,13530,13530,13200,13440,12715,12715,12765,-815,-765,72,172
20150707,12715,12765,12835,12835,12450,12450,12600,-315,-165,14,174
20150708,12450,12600,12000,12000,11840,11840,11920,-760,-680,4,178
20150709,11840,11920,11345,12575,11345,12000,12135,80,215,72,180
20150710,12000,12135,11980,12200,11775,12130,11960,-5,-175,26,176
20150713,12130,11960,,,,11960,11960,0,0,0,176
20150714,11960,11960,11960,11960,11960,11960,11960,0,0,4,172
20150715,11960,11960,12030,12030,12030,12030,12030,70,70,4,174
ru1508,20150105,13240,13315,13105,13195,13000,13080,13070,-235,-245,34,34
20150106,13080,13070,13235,13375,13235,13375,13305,305,235,4,34
20150107,13375,13305,12955,12980,12955,12980,12965,-325,-340,4,36
20150108,12980,12965,12955,12955,12815,12910,12880,-55,-85,8,36
20150109,12910,12880,,,,12800,12800,-80,-80,0,36
20150112,12800,12800,12950,13065,12950,13065,13010,265,210,6,32
20150113,13065,13010,12785,12845,12785,12845,12815,-165,-195,4,32
20150114,12845,12815,12515,12515,12125,12180,12235,-635,-580,8,36
20150115,12180,12235,,,,12235,12235,0,0,0,36
20150116,12235,12235,,,,12450,12450,215,215,0,36
20150119,12450,12450,,,,12340,12340,-110,-110,0,36
20150120,12340,12340,,,,12420,12420,80,80,0,36
20150121,12420,12420,12380,12650,12380,12650,12470,230,50,6,38
20150122,12650,12470,12700,12870,12700,12870,12800,400,330,12,34
20150123,12870,12800,12785,12785,12685,12710,12725,-90,-75,6,36
20150126,12710,12725,12765,12765,12575,12575,12670,-150,-55,4,38
20150127,12575,12670,12900,12900,12900,12900,12900,230,230,16,40
20150128,12900,12900,12905,12905,12905,12905,12905,5,5,2,40
20150129,12905,12905,,,,12830,12830,-75,-75,0,40
20150130,12830,12830,,,,12460,12460,-370,-370,0,40
20150202,12460,12460,12560,12600,12560,12600,12580,140,120,4,40
20150203,12600,12580,12770,12770,12770,12770,12770,190,190,2,40
20150204,12770,12770,12960,13220,12960,13140,13100,370,330,42,44
20150205,13140,13100,13075,13125,12960,13110,13080,10,-20,22,38
20150206,13110,13080,13150,13180,13150,13180,13165,100,85,4,34
20150209,13180,13165,13235,13235,13235,13235,13235,70,70,2,34
20150210,13235,13235,,,,13235,13235,0,0,0,34
20150211,13235,13235,13155,13155,13155,13155,13155,-80,-80,2,34
20150212,13155,13155,13100,13140,13100,13140,13125,-15,-30,6,36
20150213,13140,13125,13190,13460,13190,13330,13345,205,220,12,34
20150216,13330,13345,13425,13425,13215,13375,13345,30,0,32,42
20150217,13375,13345,13360,13360,13185,13185,13260,-160,-85,6,40
20150225,13185,13260,,,,13260,13260,0,0,0,40
20150226,13260,13260,13155,13520,13155,13520,13295,260,35,18,38
20150227,13520,13295,13340,13340,13340,13340,13340,45,45,4,38
20150302,13340,13340,13405,13405,13180,13185,13260,-155,-80,10,38
20150303,13185,13260,13165,13165,12880,12880,12985,-380,-275,6,42
20150304,12880,12985,12920,13015,12845,13000,12940,15,-45,20,38
20150305,13000,12940,12750,12750,12750,12750,12750,-190,-190,2,38
20150306,12750,12750,12855,12855,12630,12630,12700,-120,-50,24,40
20150309,12630,12700,,,,12700,12700,0,0,0,40
20150310,12700,12700,12675,12675,12675,12675,12675,-25,-25,2,38
20150311,12675,12675,12760,12760,12645,12645,12710,-30,35,40,38
20150312,12645,12710,12750,12750,12740,12745,12745,35,35,42,56
20150313,12745,12745,12835,12835,12775,12780,12795,35,50,6,56
20150316,12780,12795,12490,12490,12490,12490,12490,-305,-305,2,56
20150317,12490,12490,12560,12560,12480,12480,12520,-10,30,4,60
20150318,12480,12520,12455,12455,12455,12455,12455,-65,-65,4,56
20150319,12455,12455,12465,12590,12375,12500,12450,45,-5,16,58
20150320,12500,12450,12530,12530,12430,12430,12445,-20,-5,26,76
20150323,12430,12445,12675,12845,12675,12845,12795,400,350,76,84
20150324,12845,12795,13050,13170,12995,13005,13085,210,290,30,78
20150325,13005,13085,13015,13015,12870,12870,12945,-215,-140,8,76
20150326,12870,12945,13100,13100,13045,13065,13060,120,115,14,76
20150327,13065,13060,,,,12700,12700,-360,-360,0,76
20150330,12700,12700,12560,12760,12560,12670,12655,-30,-45,8,76
20150331,12670,12655,12645,12715,12385,12385,12425,-270,-230,580,588
20150401,12385,12425,12450,12640,12450,12540,12510,115,85,86,510
20150402,12540,12510,12725,12725,12705,12705,12715,195,205,4,510
20150403,12705,12715,,,,12715,12715,0,0,0,510
20150407,12715,12715,12815,12825,12780,12780,12805,65,90,6,510
20150408,12780,12805,12775,12870,12505,12505,12750,-300,-55,60,512
20150409,12505,12750,12490,12490,12120,12195,12220,-555,-530,16,512
20150410,12195,12220,12170,12225,12100,12225,12155,5,-65,12,512
20150413,12225,12155,12335,12555,12335,12535,12510,380,355,52,512
20150414,12535,12510,12525,12590,12425,12510,12485,0,-25,118,532
20150415,12510,12485,12615,12660,12600,12600,12630,115,145,68,522
20150416,12600,12630,12720,12720,12620,12620,12670,-10,40,4,522
20150417,12620,12670,12550,12550,12550,12550,12550,-120,-120,2,520
20150420,12550,12550,,,,12550,12550,0,0,0,520
20150421,12550,12550,12550,13060,12515,12960,12725,410,175,30,524
20150422,12960,12725,13175,13180,13050,13180,13105,455,380,58,524
20150423,13180,13105,13155,13430,13155,13250,13280,145,175,50,526
20150424,13250,13280,13300,13375,13220,13225,13300,-55,20,44,524
20150427,13225,13300,13325,14095,13325,14095,13980,795,680,186,370
20150428,14095,13980,14275,14315,14155,14155,14270,175,290,16,372
20150429,14155,14270,14220,14220,14065,14125,14125,-145,-145,8,372
20150430,14125,14125,14295,14295,14265,14265,14280,140,155,4,372
20150504,14265,14280,14450,14965,14450,14950,14930,670,650,112,464
20150505,14950,14930,14825,15000,14765,14860,14880,-70,-50,38,468
20150506,14860,14880,14980,14980,14760,14805,14830,-75,-50,30,466
20150507,14805,14830,14775,14775,14625,14625,14705,-205,-125,24,446
20150508,14625,14705,14430,14565,14430,14515,14500,-190,-205,28,446
20150511,14515,14500,14440,14560,14440,14560,14480,60,-20,6,448
20150512,14560,14480,14810,14810,14500,14525,14655,45,175,36,450
20150513,14525,14655,14525,14705,14525,14560,14560,-95,-95,424,396
20150514,14560,14560,14540,14605,14110,14150,14435,-410,-125,40,390
20150515,14150,14435,14140,14290,14130,14235,14205,-200,-230,22,382
20150518,14235,14205,14165,14165,14155,14155,14155,-50,-50,8,374
20150519,14155,14155,14375,14375,14225,14260,14290,105,135,40,356
20150520,14260,14290,14055,14055,13590,13645,13765,-645,-525,40,324
20150521,13645,13765,13535,13780,13535,13740,13705,-25,-60,58,330
20150522,13740,13705,13910,13980,13760,13760,13865,55,160,38,322
20150525,13760,13865,13775,13890,13715,13890,13780,25,-85,160,312
20150526,13890,13780,14070,14550,14030,14270,14235,490,455,44,304
20150527,14270,14235,14485,14500,14435,14500,14455,265,220,10,302
20150528,14500,14455,14785,15055,14600,14605,14910,150,455,118,308
20150529,14605,14910,14540,14880,14520,14880,14615,-30,-295,66,292
20150601,14880,14615,14900,14900,14700,14805,14800,190,185,6,288
20150602,14805,14800,14765,14830,14500,14575,14625,-225,-175,84,280
20150603,14575,14625,14620,14620,14570,14570,14600,-55,-25,32,274
20150604,14570,14600,14255,14300,14050,14050,14170,-550,-430,50,276
20150605,14050,14170,14340,14340,14185,14340,14310,170,140,18,266
20150608,14340,14310,14295,14315,14220,14220,14285,-90,-25,12,268
20150609,14220,14285,14335,14335,14245,14305,14290,20,5,40,254
20150610,14305,14290,14270,14340,14270,14315,14320,25,30,24,252
20150611,14315,14320,14470,14505,14435,14465,14480,145,160,70,246
20150612,14465,14480,14350,14350,13935,13965,14130,-515,-350,52,244
20150615,13965,14130,13965,14100,13785,13875,13875,-255,-255,68,240
20150616,13875,13875,13990,14070,13930,13945,14005,70,130,40,238
20150617,13945,14005,13925,13940,13925,13940,13930,-65,-75,4,238
20150618,13940,13930,13785,13785,13655,13655,13695,-275,-235,6,236
20150619,13655,13695,13605,13740,13605,13740,13640,45,-55,16,228
20150623,13740,13640,13820,13820,13820,13820,13820,180,180,10,220
20150624,13820,13820,13840,13910,13775,13820,13820,0,0,136,208
20150625,13820,13820,13455,13515,13455,13500,13490,-320,-330,6,208
20150626,13500,13490,13345,13345,13120,13220,13220,-270,-270,10,202
20150629,13220,13220,13350,13405,13235,13275,13290,55,70,36,214
20150630,13275,13290,12775,12775,12600,12630,12700,-660,-590,18,214
20150701,12630,12700,12845,12920,12845,12900,12890,200,190,76,170
20150702,12900,12890,,,,13035,13035,145,145,0,170
20150703,13035,13035,13390,13390,13130,13130,13220,95,185,60,166
20150706,13130,13220,12935,12975,12935,12975,12955,-245,-265,4,166
20150707,12975,12955,,,,12490,12490,-465,-465,0,166
20150708,12490,12490,11740,11740,11740,11740,11740,-750,-750,10,174
20150709,11740,11740,11090,12795,11090,12305,11590,565,-150,680,184
20150710,12305,11590,12225,12285,12225,12285,12265,695,675,30,178
20150713,12285,12265,12115,12170,12115,12170,12140,-95,-125,42,182
20150714,12170,12140,11810,12325,11810,12150,12120,10,-20,20,180
20150715,12150,12120,12130,12130,12050,12050,12090,-70,-30,4,180
20150716,12050,12090,12115,12180,11795,12180,12115,90,25,26,174
20150717,12180,12115,12280,12325,11710,12095,12145,-20,30,18,174
20150720,12095,12145,,,,12145,12145,0,0,0,174
20150721,12145,12145,12275,12520,12220,12255,12325,110,180,16,172
20150722,12255,12325,12420,12420,12150,12150,12365,-175,40,48,170
20150723,12150,12365,12255,12315,12185,12240,12235,-125,-130,64,170
20150724,12240,12235,12020,12020,11900,11900,11940,-335,-295,14,164
20150727,11900,11940,11885,11920,11885,11920,11895,-20,-45,8,162
20150728,11920,11895,11665,11765,11630,11745,11680,-150,-215,54,206
20150729,11745,11680,11905,12010,11590,11760,11905,80,225,68,196
20150730,11760,11905,11780,12230,11780,11930,11895,25,-10,48,198
20150731,11930,11895,11790,11910,11770,11910,11815,15,-80,14,196
20150803,11910,11815,12000,12050,11780,11780,11900,-35,85,42,206
20150804,11780,11900,11445,11695,11185,11420,11530,-480,-370,106,186
20150805,11420,11530,11480,11480,11055,11100,11270,-430,-260,50,176
20150806,11100,11270,11285,11290,11000,11125,11140,-145,-130,20,166
20150807,11125,11140,11210,11210,11000,11000,11105,-140,-35,4,168
20150810,11000,11105,11050,11050,10995,11000,11025,-105,-80,20,174
20150811,11000,11025,10980,10980,10970,10970,10975,-55,-50,8,168
20150812,10970,10975,,,,10975,10975,0,0,0,168
20150813,10975,10975,10870,10900,10870,10900,10885,-75,-90,4,168
20150814,10900,10885,,,,10885,10885,0,0,0,168
20150817,10885,10885,,,,10850,10850,-35,-35,0,168
ru1509,20150105,13245,13210,13145,13170,12895,12985,13000,-225,-210,97468,94904
20150106,12985,13000,12935,13350,12870,13240,13180,240,180,112964,98282
20150107,13240,13180,13120,13275,12885,12915,13035,-265,-145,136746,96412
20150108,12915,13035,12905,12970,12690,12845,12835,-190,-200,124588,95730
20150109,12845,12835,12900,13170,12700,12960,12915,125,80,135928,91276
20150112,12960,12915,12980,13155,12910,12945,13035,30,120,118690,95794
20150113,12945,13035,12850,12900,12565,12590,12725,-445,-310,114524,91498
20150114,12590,12725,12480,12600,12050,12170,12310,-555,-415,180928,94064
20150115,12170,12310,12215,12470,12155,12370,12320,60,10,121674,95990
20150116,12370,12320,12390,12640,12255,12370,12410,50,90,146978,94748
20150119,12370,12410,12360,12550,12305,12460,12450,50,40,139246,96714
20150120,12460,12450,12340,12565,12340,12410,12465,-40,15,109980,99796
20150121,12410,12465,12470,12730,12230,12695,12520,230,55,179664,98748
20150122,12695,12520,12620,12975,12620,12830,12855,310,335,186256,101820
20150123,12830,12855,12840,12880,12650,12810,12750,-45,-105,157244,107528
20150126,12810,12750,12860,12925,12480,12725,12675,-25,-75,170578,110612
20150127,12725,12675,12800,13050,12775,12905,12920,230,245,159222,114178
20150128,12905,12920,12860,13015,12735,12845,12890,-75,-30,142328,113602
20150129,12845,12890,12845,12890,12645,12740,12755,-150,-135,118672,113374
20150130,12740,12755,12700,12825,12440,12450,12610,-305,-145,148260,114480
20150202,12450,12610,12510,12850,12400,12810,12615,200,5,167528,121460
20150203,12810,12615,12850,12980,12770,12880,12865,265,250,153084,124312
20150204,12880,12865,12930,13395,12870,13060,13150,195,285,214938,131426
20150205,13060,13150,13150,13230,12980,12990,13105,-160,-45,209248,131470
20150206,12990,13105,13060,13375,13010,13365,13225,260,120,186648,135416
20150209,13365,13225,13340,13535,13190,13275,13315,50,90,170974,133028
20150210,13275,13315,13255,13340,13150,13200,13230,-115,-85,114880,135476
20150211,13200,13230,13160,13310,13060,13290,13225,60,-5,124884,135996
20150212,13290,13225,13285,13350,13105,13240,13225,15,0,132466,137678
20150213,13240,13225,13310,13515,13230,13400,13380,175,155,202412,143108
20150216,13400,13380,13400,13470,13205,13335,13335,-45,-45,150770,136918
20150217,13335,13335,13350,13350,13110,13155,13200,-180,-135,105752,136252
20150225,13155,13200,13010,13235,13010,13135,13140,-65,-60,84522,140484
20150226,13135,13140,13150,13605,13115,13575,13380,435,240,197874,161980
20150227,13575,13380,13600,13635,13385,13440,13510,60,130,198616,164456
20150302,13440,13510,13450,13595,13170,13250,13325,-260,-185,357876,171696
20150303,13250,13325,13250,13300,12800,12895,12985,-430,-340,329946,182574
20150304,12895,12985,12900,13135,12855,12935,13030,-50,45,353704,194532
20150305,12935,13030,12920,12970,12680,12810,12835,-220,-195,366192,189844
20150306,12810,12835,12830,12925,12600,12700,12780,-135,-55,367544,197236
20150309,12700,12780,12695,12885,12530,12815,12725,35,-55,428198,195742
20150310,12815,12725,12765,12815,12485,12490,12680,-235,-45,414842,208668
20150311,12490,12680,12480,12860,12450,12705,12660,25,-20,446474,196484
20150312,12705,12660,12735,12915,12660,12865,12795,205,135,358682,197518
20150313,12865,12795,12865,12895,12720,12735,12785,-60,-10,363380,205068
20150316,12735,12785,12700,12705,12345,12580,12560,-205,-225,370350,212408
20150317,12580,12560,12595,12720,12495,12555,12595,-5,35,403490,223090
20150318,12555,12595,12515,12590,12380,12495,12490,-100,-105,381424,222378
20150319,12495,12490,12465,12670,12430,12540,12555,50,65,329890,228938
20150320,12540,12555,12555,12635,12405,12560,12530,5,-25,389678,224660
20150323,12560,12530,12610,13080,12580,12990,12855,460,325,587922,218798
20150324,12990,12855,13050,13275,12950,13050,13100,195,245,554488,225788
20150325,13050,13100,13050,13100,12880,12930,12980,-170,-120,438542,225884
20150326,12930,12980,12980,13215,12915,13065,13050,85,70,498130,237340
20150327,13065,13050,13030,13095,12590,12815,12810,-235,-240,557798,227124
20150330,12815,12810,12840,12845,12620,12640,12720,-170,-90,410000,233920
20150331,12640,12720,12650,12750,12510,12540,12635,-180,-85,383832,234768
20150401,12540,12635,12500,12720,12500,12595,12620,-40,-15,327708,228208
20150402,12595,12620,12605,12880,12590,12770,12765,150,145,410134,225222
20150403,12770,12765,12760,12840,12630,12775,12745,10,-20,361444,220616
20150407,12775,12745,12775,12990,12730,12880,12885,135,140,270574,225542
20150408,12880,12885,12860,12920,12545,12630,12695,-255,-190,471072,243950
20150409,12630,12695,12610,12620,12205,12300,12375,-395,-320,446250,264350
20150410,12300,12375,12320,12375,12230,12350,12315,-25,-60,290056,252222
20150413,12350,12315,12355,12790,12355,12655,12595,340,280,436216,230882
20150414,12655,12595,12705,12730,12485,12670,12590,75,-5,346978,230160
20150415,12670,12590,12670,12815,12620,12645,12710,55,120,393332,228768
20150416,12645,12710,12645,12885,12560,12760,12780,50,70,403752,231006
20150417,12760,12780,12780,12880,12650,12725,12775,-55,-5,455754,223514
20150420,12725,12775,12700,12840,12685,12715,12755,-60,-20,315406,223424
20150421,12715,12755,12675,13240,12620,13230,13015,475,260,645466,249908
20150422,13230,13015,13230,13320,13130,13225,13225,210,210,407624,255596
20150423,13225,13225,13230,13580,13200,13335,13380,110,155,590976,259878
20150424,13335,13380,13380,13475,13320,13460,13395,80,15,350252,260612
20150427,13460,13395,13520,14195,13400,14195,13835,800,440,565400,282960
20150428,14195,13835,14250,14580,14120,14280,14370,445,535,753416,278014
20150429,14280,14370,14320,14350,13855,14060,14165,-310,-205,631070,276042
20150430,14060,14165,14135,14525,14060,14470,14360,305,195,666368,286622
20150504,14470,14360,14660,15220,14570,15005,14950,645,590,646306,286288
20150505,15005,14950,15010,15125,14820,15005,14980,55,30,578286,282024
20150506,15005,14980,15170,15170,14835,14995,14980,15,0,657094,281686
20150507,14995,14980,15035,15270,14590,14705,14825,-275,-155,708452,273282
20150508,14705,14825,14715,14825,14540,14650,14675,-175,-150,600280,266520
20150511,14650,14675,14710,14890,14505,14760,14685,85,10,537384,268844
20150512,14760,14685,14710,14865,14580,14630,14705,-55,20,535584,265060
20150513,14630,14705,14715,14865,14550,14710,14700,5,-5,516736,253226
20150514,14710,14700,14740,14775,14110,14240,14345,-460,-355,544334,249864
20150515,14240,14345,14240,14410,14220,14320,14310,-25,-35,399050,247720
20150518,14320,14310,14255,14630,14210,14485,14465,175,155,514992,252364
20150519,14485,14465,14480,14530,14240,14340,14405,-125,-60,428404,243788
20150520,14340,14405,14245,14260,13545,13615,13780,-790,-625,652262,220124
20150521,13615,13780,13660,13910,13655,13810,13805,30,25,435520,217600
20150522,13810,13805,13800,14050,13730,13895,13895,90,90,436450,216892
20150525,13895,13895,13745,13970,13645,13955,13790,60,-105,426998,227568
20150526,13955,13790,14050,14600,14015,14370,14340,580,550,707562,229892
20150527,14370,14340,14295,14570,14275,14550,14460,210,120,540988,238708
20150528,14550,14460,14560,15150,14500,14700,14830,240,370,862422,225498
20150529,14700,14830,14600,15015,14400,15010,14720,180,-110,704524,241846
20150601,15010,14720,15015,15245,14740,14750,14955,30,235,782428,226568
20150602,14750,14955,14750,14995,14560,14730,14775,-225,-180,673710,228390
20150603,14730,14775,14790,14870,14375,14385,14665,-390,-110,545740,231970
20150604,14385,14665,14355,14490,14075,14490,14310,-175,-355,623328,219240
20150605,14490,14310,14500,14560,14205,14350,14385,40,75,526958,212840
20150608,14350,14385,14370,14535,14215,14275,14340,-110,-45,426620,215778
20150609,14275,14340,14210,14440,14150,14275,14345,-65,5,397508,216946
20150610,14275,14345,14310,14470,14290,14425,14375,80,30,367346,222044
20150611,14425,14375,14495,14625,14430,14485,14530,110,155,386818,215978
20150612,14485,14530,14450,14515,13860,13885,14120,-645,-410,442210,210638
20150615,13885,14120,13885,14005,13785,13895,13905,-225,-215,335452,206030
20150616,13895,13905,13880,14130,13730,14015,13970,110,65,394844,202436
20150617,14015,13970,14010,14055,13845,13900,13935,-70,-35,381998,203948
20150618,13900,13935,14000,14035,13660,13685,13850,-250,-85,391238,211716
20150619,13685,13850,13680,13890,13635,13725,13740,-125,-110,332300,201704
20150623,13725,13740,13730,13955,13715,13880,13845,140,105,235716,196518
20150624,13880,13845,13875,13945,13815,13835,13875,-10,30,205904,195126
20150625,13835,13875,13845,13850,13345,13370,13595,-505,-280,399442,207352
20150626,13370,13595,13380,13495,13175,13380,13370,-215,-225,340990,183610
20150629,13380,13370,13400,13475,13250,13330,13355,-40,-15,303432,172964
20150630,13330,13355,13325,13345,12615,12800,12890,-555,-465,443982,156248
20150701,12800,12890,12855,13415,12790,13225,13070,335,180,348026,149690
20150702,13225,13070,13200,13365,13135,13305,13260,235,190,262836,145576
20150703,13305,13260,13335,13550,13050,13215,13335,-45,75,316318,141606
20150706,13215,13335,13220,13245,12610,12735,12945,-600,-390,374902,140552
20150707,12735,12945,12650,12890,12450,12515,12675,-430,-270,362292,137096
20150708,12515,12675,12415,12475,11910,11910,12060,-765,-615,141414,125748
20150709,11910,12060,11500,12590,10975,12235,12025,175,-35,798866,105136
20150710,12235,12025,12315,12575,12055,12165,12280,140,255,560506,112482
20150713,12165,12280,12125,12275,11990,12150,12130,-130,-150,334134,109364
20150714,12150,12130,12255,12430,12080,12120,12300,-10,170,282522,106944
20150715,12120,12300,12210,12295,12130,12205,12215,-95,-85,184110,100574
20150716,12205,12215,12220,12290,11850,12260,12105,45,-110,259024,98734
20150717,12260,12105,12250,12350,12130,12200,12255,95,150,147304,95528
20150720,12200,12255,12120,12360,12030,12310,12215,55,-40,159190,98670
20150721,12310,12215,12310,12500,12270,12490,12365,275,150,140048,95740
20150722,12490,12365,12530,12640,12235,12335,12485,-30,120,151888,87456
20150723,12335,12485,12330,12430,12215,12350,12310,-135,-175,104750,85992
20150724,12350,12310,12310,12380,11890,11895,12105,-415,-205,110566,83948
20150727,11895,12105,11945,12075,11715,11755,11955,-350,-150,109760,79024
20150728,11755,11955,11725,11980,11600,11925,11800,-30,-155,105568,70670
20150729,11925,11800,11985,12130,11800,11920,11980,120,180,85846,69602
20150730,11920,11980,11875,12070,11840,11945,11965,-35,-15,69252,66836
20150731,11945,11965,11905,12040,11840,11995,11970,30,5,79852,59674
20150803,11995,11970,12030,12350,11940,11975,12125,5,155,110270,54656
20150804,11975,12125,11630,11790,11395,11395,11570,-730,-555,81554,48986
20150805,11395,11570,11475,11500,11120,11260,11290,-310,-280,88998,48744
20150806,11260,11290,11250,11325,11085,11125,11220,-165,-70,42762,46268
20150807,11125,11220,11075,11225,10955,11090,11075,-130,-145,52830,43742
20150810,11090,11075,11070,11230,10975,11090,11070,15,-5,31096,42540
20150811,11090,11070,11075,11200,10960,10960,11095,-110,25,41078,41964
20150812,10960,11095,10925,10955,10610,10935,10795,-160,-300,56390,39292
20150813,10935,10795,10990,11150,10750,11000,10980,205,185,46952,38680
20150814,11000,10980,10980,11095,10925,11000,11010,20,30,25488,37822
20150817,11000,11010,11000,11060,10735,10835,10875,-175,-135,22634,36724
20150818,10835,10875,10825,10895,10775,10805,10835,-70,-40,18478,34064
20150819,10805,10835,10750,10830,10655,10820,10760,-15,-75,17880,33052
20150820,10820,10760,10830,10905,10760,10815,10825,55,65,15246,32218
20150821,10815,10825,10865,10890,10660,10810,10815,-15,-10,14132,31036
20150824,10810,10815,10785,10860,10165,10165,10425,-650,-390,15522,26936
20150825,10165,10425,10105,10245,9950,10010,10115,-415,-310,13022,23700
20150826,10010,10115,10130,10330,9960,9975,10125,-140,10,7330,22346
20150827,9975,10125,9920,10200,9890,10155,10075,30,-50,8220,20692
20150828,10155,10075,10240,10570,10155,10275,10340,200,265,6924,19102
20150831,10275,10340,10260,10310,10065,10085,10185,-255,-155,5710,17896
20150901,10085,10185,10050,10175,10025,10100,10080,-85,-105,2528,17220
20150902,10100,10080,10020,10100,9985,9995,10020,-85,-60,2388,16222
20150907,9995,10020,9990,10260,9980,10180,10140,160,120,3136,15984
20150908,10180,10140,10170,10280,10120,10255,10205,115,65,2416,15324
20150909,10255,10205,10425,10580,10240,10355,10420,150,215,2374,15022
20150910,10355,10420,10350,10440,10180,10400,10275,-20,-145,3474,14432
20150911,10400,10275,10300,10650,10300,10530,10560,255,285,470,14180
20150914,10530,10560,10605,10650,10450,10450,10535,-110,-25,764,13756
20150915,10450,10535,10455,10485,10270,10335,10355,-200,-180,200,13676
ru1510,20150105,13215,13315,13040,13110,12800,12800,12870,-515,-445,576,684
20150106,12800,12870,12865,13050,12780,12780,12935,-90,65,658,636
20150107,12780,12935,12700,12940,12700,12790,12800,-145,-135,134,644
20150108,12790,12800,12800,12835,12610,12740,12715,-60,-85,232,646
20150109,12740,12715,12740,12945,12740,12850,12870,135,155,14,642
20150112,12850,12870,12990,12995,12900,12970,12950,100,80,60,646
20150113,12970,12950,12800,12890,12590,12625,12700,-325,-250,64,636
20150114,12625,12700,12410,12500,12115,12170,12375,-530,-325,42,644
20150115,12170,12375,12110,12350,12110,12350,12210,-25,-165,20,648
20150116,12350,12210,12400,12425,12240,12290,12325,80,115,20,642
20150119,12290,12325,12460,12490,12275,12390,12385,65,60,34,638
20150120,12390,12385,12395,12490,12395,12490,12455,105,70,16,638
20150121,12490,12455,12280,12625,12280,12600,12405,145,-50,46,638
20150122,12600,12405,12560,12800,12560,12620,12730,215,325,94,678
20150123,12620,12730,12560,12625,12560,12565,12580,-165,-150,14,678
20150126,12565,12580,12725,12725,12335,12485,12490,-95,-90,30,678
20150127,12485,12490,12685,12800,12645,12750,12765,260,275,102,696
20150128,12750,12765,12700,12800,12545,12705,12695,-60,-70,118,756
20150129,12705,12695,12660,12680,12530,12605,12640,-90,-55,42,718
20150130,12605,12640,12640,12640,12335,12335,12410,-305,-230,38,712
20150202,12335,12410,12380,12730,12265,12730,12495,320,85,24,710
20150203,12730,12495,12700,12780,12700,12780,12730,285,235,20,710
20150204,12780,12730,12880,13180,12780,13005,13010,275,280,78,716
20150205,13005,13010,12990,13075,12900,12900,12990,-110,-20,84,714
20150206,12900,12990,13020,13210,12960,13210,13125,220,135,200,742
20150209,13210,13125,13220,13320,13075,13095,13150,-30,25,108,724
20150210,13095,13150,13050,13120,12930,12970,13005,-180,-145,76,708
20150211,12970,13005,12975,13025,12900,13005,12975,0,-30,50,708
20150212,13005,12975,13030,13040,12900,12970,12955,-5,-20,48,702
20150213,12970,12955,13025,13205,13025,13160,13100,205,145,68,700
20150216,13160,13100,13090,13275,13030,13250,13145,150,45,524,920
20150217,13250,13145,13195,13210,13045,13045,13125,-100,-20,72,924
20150225,13045,13125,13020,13100,12980,13040,13040,-85,-85,54,902
20150226,13040,13040,13045,13470,13045,13470,13230,430,190,94,862
20150227,13470,13230,13505,13525,13400,13520,13505,290,275,588,1374
20150302,13520,13505,13490,13580,13250,13270,13415,-235,-90,92,1338
20150303,13270,13415,13265,13265,12970,12995,13025,-420,-390,60,1340
20150304,12995,13025,12960,13180,12900,13165,13050,140,25,38,1328
20150305,13165,13050,12565,13010,12540,12860,12835,-190,-215,124,1322
20150306,12860,12835,12895,12960,12640,12680,12865,-155,30,80,1310
20150309,12680,12865,12640,12915,12640,12810,12745,-55,-120,50,1306
20150310,12810,12745,12795,12800,12660,12660,12765,-85,20,20,1304
20150311,12660,12765,12520,12790,12520,12680,12715,-85,-50,422,1064
20150312,12680,12715,12670,12735,12665,12735,12695,20,-20,694,756
20150313,12735,12695,12715,12715,12600,12620,12650,-75,-45,18,760
20150316,12620,12650,12510,12540,12320,12475,12480,-175,-170,48,790
20150317,12475,12480,12850,12850,12415,12460,12505,-20,25,18,788
20150318,12460,12505,12450,12450,12290,12350,12395,-155,-110,46,790
20150319,12350,12395,12315,12545,12315,12420,12440,25,45,46,788
20150320,12420,12440,12445,12530,12360,12450,12435,10,-5,28,788
20150323,12450,12435,12500,12935,12480,12870,12660,435,225,64,788
20150324,12870,12660,12925,13145,12910,12920,12990,260,330,82,786
20150325,12920,12990,12900,12945,12855,12860,12900,-130,-90,66,790
20150326,12860,12900,12980,13135,12860,13020,13000,120,100,118,832
20150327,13020,13000,12900,12900,12610,12635,12665,-365,-335,14,824
20150330,12635,12665,12715,12730,12600,12700,12690,35,25,50,814
20150331,12700,12690,12665,12665,12485,12485,12585,-205,-105,20,804
20150401,12485,12585,12555,12665,12490,12590,12565,5,-20,26,792
20150402,12590,12565,12770,12800,12710,12800,12760,235,195,58,800
20150403,12800,12760,12740,12800,12680,12800,12745,40,-15,42,794
20150407,12800,12745,12870,12870,12570,12760,12805,15,60,98,800
20150408,12760,12805,12715,12765,12475,12540,12555,-265,-250,80,790
20150409,12540,12555,12515,12515,12170,12240,12305,-315,-250,58,784
20150410,12240,12305,12210,12260,12180,12200,12210,-105,-95,82,810
20150413,12200,12210,12400,12565,12330,12535,12465,325,255,64,782
20150414,12535,12465,12465,12505,12380,12505,12450,40,-15,184,820
20150415,12505,12450,12510,12615,12505,12510,12560,60,110,96,782
20150416,12510,12560,12655,12720,12650,12685,12670,125,110,20,776
20150417,12685,12670,12715,12715,12575,12685,12660,15,-10,72,786
20150420,12685,12660,12460,12705,12460,12660,12610,0,-50,22,780
20150421,12660,12610,12600,13040,12505,13040,12970,430,360,108,766
20150422,13040,12970,13055,13160,13015,13095,13075,125,105,48,770
20150423,13095,13075,13160,13370,13160,13250,13290,175,215,1052,1466
20150424,13250,13290,13310,13410,13285,13285,13355,-5,65,228,1574
20150427,13285,13355,13370,14155,13370,14145,13975,790,620,154,1520
20150428,14145,13975,14270,14485,14085,14180,14280,205,305,180,1456
20150429,14180,14280,14165,14270,13840,13980,14085,-300,-195,100,1434
20150430,13980,14085,14035,14380,14020,14320,14200,235,115,38,1422
20150504,14320,14200,14675,15050,14675,14970,14950,770,750,248,1460
20150505,14970,14950,14930,15035,14800,14955,14910,5,-40,152,1464
20150506,14955,14910,15055,15125,14850,14955,14925,45,15,298,1550
20150507,14955,14925,15225,15225,14425,14500,14865,-425,-60,1282,1218
20150508,14500,14865,14590,14620,14415,14490,14510,-375,-355,142,1156
20150511,14490,14510,14455,14650,14350,14475,14515,-35,5,60,1158
20150512,14475,14515,14610,14640,14425,14480,14560,-35,45,96,1146
20150513,14480,14560,14550,14650,14405,14500,14505,-60,-55,146,1056
20150514,14500,14505,14535,14540,14000,14075,14130,-430,-375,208,1040
20150515,14075,14130,14140,14220,14065,14220,14145,90,15,22,1038
20150518,14220,14145,14220,14360,14120,14340,14265,195,120,70,1030
20150519,14340,14265,14315,14375,14100,14180,14205,-85,-60,48,1030
20150520,14180,14205,14010,14010,13445,13450,13630,-755,-575,106,1040
20150521,13450,13630,13585,13700,13585,13700,13650,70,20,12,1036
20150522,13700,13650,13795,13880,13685,13685,13810,35,160,270,1022
20150525,13685,13810,13685,13805,13555,13805,13650,-5,-160,44,1024
20150526,13805,13650,13885,14465,13885,14405,14435,755,785,1270,1668
20150527,14405,14435,14330,14505,14270,14490,14410,55,-25,116,1648
20150528,14490,14410,14450,15055,14450,14685,14825,275,415,158,1574
20150529,14685,14825,14555,14945,14450,14945,14685,120,-140,68,1572
20150601,14945,14685,15060,15100,14755,14950,14970,265,285,108,1554
20150602,14950,14970,14845,14845,14600,14600,14730,-370,-240,28,1536
20150603,14600,14730,14780,14780,14350,14350,14490,-380,-240,108,1510
20150604,14350,14490,14320,14320,13990,14290,14195,-200,-295,1168,1148
20150605,14290,14195,14305,14325,14080,14250,14145,55,-50,198,1050
20150608,14250,14145,14215,14300,14080,14080,14175,-65,30,28,1052
20150609,14080,14175,14225,14225,14135,14135,14180,-40,5,92,1054
20150610,14135,14180,14170,14260,14170,14255,14235,75,55,94,976
20150611,14255,14235,14410,14470,14330,14335,14375,100,140,26,978
20150612,14335,14375,14275,14275,13775,13880,14010,-495,-365,122,968
20150615,13880,14010,13670,13790,13620,13790,13680,-220,-330,58,988
20150616,13790,13680,13880,13940,13590,13805,13770,125,90,76,976
20150617,13805,13770,13735,13815,13700,13780,13705,10,-65,250,952
20150618,13780,13705,13790,13790,13500,13500,13600,-205,-105,222,956
20150619,13500,13600,13550,13615,13485,13580,13545,-20,-55,260,934
20150623,13580,13545,13645,13710,13560,13710,13600,165,55,16,932
20150624,13710,13600,13715,13715,13640,13695,13680,95,80,18,938
20150625,13695,13680,13610,13650,13180,13180,13410,-500,-270,166,962
20150626,13180,13410,13135,13290,13100,13210,13145,-200,-265,176,958
20150629,13210,13145,13330,13330,13130,13130,13220,-15,75,18,956
20150630,13130,13220,12860,13110,12445,12620,12850,-600,-370,494,914
20150701,12620,12850,12670,13000,12580,12965,12790,115,-60,26,914
20150702,12965,12790,12970,13115,12945,13060,13035,270,245,42,922
20150703,13060,13035,13225,13315,12875,13000,13215,-35,180,1116,1050
20150706,13000,13215,12875,12930,12420,12575,12685,-640,-530,202,1054
20150707,12575,12685,12510,12595,12240,12240,12415,-445,-270,86,1056
20150708,12240,12415,12240,12240,11670,11680,11750,-735,-665,128,1052
20150709,11680,11750,11050,12245,11045,11985,11795,235,45,452,1040
20150710,11985,11795,11990,12310,11850,11980,12090,185,295,198,934
20150713,11980,12090,11860,12050,11800,11875,11905,-215,-185,38,932
20150714,11875,11905,12030,12200,11960,11960,12075,55,170,36,940
20150715,11960,12075,12060,12075,11915,12040,12015,-35,-60,66,952
20150716,12040,12015,11880,12080,11770,11985,11940,-30,-75,96,960
20150717,11985,11940,12045,12045,11940,11975,11975,35,35,32,956
20150720,11975,11975,11945,12130,11885,12050,11995,75,20,92,950
20150721,12050,11995,12050,12195,12025,12195,12100,200,105,52,960
20150722,12195,12100,12240,12310,12000,12110,12145,10,45,40,958
20150723,12110,12145,11965,12100,11965,12080,12055,-65,-90,34,958
20150724,12080,12055,12000,12000,11665,11670,11735,-385,-320,98,938
20150727,11670,11735,11670,11800,11500,11500,11695,-235,-40,154,914
20150728,11500,11695,11720,11965,11500,11730,11690,35,-5,588,698
20150729,11730,11690,11830,12010,11650,11750,11830,60,140,128,742
20150730,11750,11830,11780,11875,11705,11740,11810,-90,-20,282,818
20150731,11740,11810,11700,11750,11695,11695,11740,-115,-70,76,876
20150803,11695,11740,11725,11730,11145,11350,11605,-390,-135,722,1204
20150804,11350,11605,11250,11405,11080,11240,11260,-365,-345,604,928
20150805,11240,11260,11570,11585,11080,11260,11170,0,-90,414,804
20150806,11260,11170,11235,11250,11105,11125,11165,-45,-5,86,798
20150807,11125,11165,11135,11180,10995,11120,11060,-45,-105,270,728
20150810,11120,11060,11135,11160,11050,11140,11095,80,35,66,726
20150811,11140,11095,11125,11255,11045,11065,11140,-30,45,104,736
20150812,11065,11140,10900,11020,10750,11020,10855,-120,-285,226,712
20150813,11020,10855,11120,11210,10920,11015,11085,160,230,94,688
20150814,11015,11085,11025,11195,11025,11085,11105,0,20,262,704
20150817,11085,11105,11095,11175,10900,10930,10980,-175,-125,164,760
20150818,10930,10980,10980,11040,10900,10900,10950,-80,-30,112,754
20150819,10900,10950,10840,11135,10805,10940,10870,-10,-80,48,758
20150820,10940,10870,10980,10990,10885,10895,10935,25,65,90,794
20150821,10895,10935,10810,11040,10810,10965,10955,30,20,34,806
20150824,10965,10955,10955,10955,10295,10315,10565,-640,-390,284,918
20150825,10315,10565,10235,10365,10135,10175,10260,-390,-305,254,804
20150826,10175,10260,10420,10595,10100,10100,10255,-160,-5,128,830
20150827,10100,10255,10100,10300,10035,10295,10205,40,-50,144,800
20150828,10295,10205,10345,10680,10270,10380,10445,175,240,186,790
20150831,10380,10445,10295,10480,10210,10210,10335,-235,-110,214,820
20150901,10210,10335,10210,10305,10020,10275,10210,-60,-125,132,810
20150902,10275,10210,10180,10225,10120,10140,10170,-70,-40,222,784
20150907,10140,10170,10250,10400,10190,10300,10285,130,115,192,740
20150908,10300,10285,10310,10385,10240,10380,10345,95,60,60,744
20150909,10380,10345,10425,10660,10425,10520,10575,175,230,120,750
20150910,10520,10575,10505,10525,10335,10480,10410,-95,-165,94,752
20150911,10480,10410,10500,10780,10500,10615,10625,205,215,154,676
20150914,10615,10625,10665,10665,10495,10495,10620,-130,-5,54,644
20150915,10495,10620,10410,10535,10375,10375,10450,-245,-170,26,636
20150916,10375,10450,10475,10550,10450,10525,10505,75,55,44,648
20150917,10525,10505,10550,10695,10550,10590,10595,85,90,60,628
20150918,10590,10595,10600,10600,10515,10515,10555,-80,-40,4,624
20150921,10515,10555,10495,10640,10390,10635,10475,80,-80,138,706
20150922,10635,10475,10650,10650,10455,10500,10535,25,60,32,696
20150923,10500,10535,10455,10495,10405,10495,10435,-40,-100,114,688
20150924,10495,10435,10540,10555,10450,10490,10475,55,40,68,704
20150925,10490,10475,10650,10730,10445,10545,10570,70,95,748,752
20150928,10545,10570,10600,10600,10530,10545,10540,-25,-30,190,700
20150929,10545,10540,10440,10440,10325,10330,10355,-210,-185,182,726
20150930,10330,10355,10340,10340,10300,10300,10325,-55,-30,74,700
20151008,10300,10325,10210,10860,10210,10460,10480,135,155,74,686
20151009,10460,10480,10400,10575,10345,10575,10510,95,30,82,686
20151012,10575,10510,10545,10685,10545,10555,10595,45,85,14,682
20151013,10555,10595,10500,10500,10370,10500,10480,-95,-115,170,700
20151014,10500,10480,10215,10550,10215,10500,10430,20,-50,260,628
20151015,10500,10430,10540,10600,10400,10520,10505,90,75,94,634
ru1511,20150105,13205,13230,12880,13105,12820,12840,12875,-390,-355,572,1658
20150106,12840,12875,12755,13045,12755,12950,12955,75,80,1660,1882
20150107,12950,12955,12800,13060,12800,12860,12920,-95,-35,812,2036
20150108,12860,12920,12915,12915,12640,12785,12775,-135,-145,404,2120
20150109,12785,12775,12745,13090,12680,12910,12810,135,35,536,2240
20150112,12910,12810,12950,13120,12890,12910,13000,100,190,436,2368
20150113,12910,13000,12750,12825,12560,12575,12670,-425,-330,670,2628
20150114,12575,12670,12500,12565,12015,12180,12275,-490,-395,258,2662
20150115,12180,12275,12160,12400,12105,12320,12250,45,-25,78,2646
20150116,12320,12250,12450,12600,12245,12350,12385,100,135,284,2660
20150119,12350,12385,12455,12475,12340,12400,12410,15,25,76,2662
20150120,12400,12410,12370,12500,12320,12370,12380,-40,-30,124,2656
20150121,12370,12380,12370,12630,12225,12600,12460,220,80,344,2722
20150122,12600,12460,12600,12875,12585,12690,12750,230,290,352,2806
20150123,12690,12750,12700,12725,12570,12615,12625,-135,-125,204,2788
20150126,12615,12625,12720,12830,12400,12565,12580,-60,-45,198,2768
20150127,12565,12580,12650,12940,12650,12815,12815,235,235,248,2768
20150128,12815,12815,12720,12895,12695,12715,12785,-100,-30,220,2790
20150129,12715,12785,12775,12775,12590,12660,12665,-125,-120,160,2820
20150130,12660,12665,12620,12740,12400,12400,12580,-265,-85,1182,2922
20150202,12400,12580,12445,12800,12350,12780,12555,200,-25,418,2902
20150203,12780,12555,12780,12915,12735,12840,12830,285,275,398,3014
20150204,12840,12830,12845,13275,12805,13010,13145,180,315,2074,4124
20150205,13010,13145,13055,13170,12935,12975,13055,-170,-90,1182,4462
20150206,12975,13055,13005,13290,13005,13290,13215,235,160,518,4638
20150209,13290,13215,13255,13415,13065,13080,13200,-135,-15,2322,4534
20150210,13080,13200,13045,13145,12980,13005,13055,-195,-145,826,4624
20150211,13005,13055,12985,13110,12900,13100,13060,45,5,274,4650
20150212,13100,13060,13075,13125,12950,13050,13055,-10,-5,398,4718
20150213,13050,13055,13130,13275,13070,13180,13165,125,110,904,5060
20150216,13180,13165,13155,13270,13070,13230,13180,65,15,1274,5090
20150217,13230,13180,13200,13230,12965,13005,13055,-175,-125,938,5372
20150225,13005,13055,12985,13025,12915,12945,12955,-110,-100,408,5446
20150226,12945,12955,12955,13445,12950,13445,13235,490,280,1274,5160
20150227,13445,13235,13425,13505,13285,13310,13435,75,200,1508,5328
20150302,13310,13435,13325,13500,13090,13145,13235,-290,-200,844,5378
20150303,13145,13235,13160,13190,12760,12845,12920,-390,-315,1336,5510
20150304,12845,12920,12840,13025,12840,12880,12945,-40,25,548,5508
20150305,12880,12945,12805,12905,12605,12770,12710,-175,-235,1098,5472
20150306,12770,12710,12845,12850,12540,12610,12700,-100,-10,1524,5562
20150309,12610,12700,12600,12770,12455,12700,12680,0,-20,2382,5500
20150310,12700,12680,12680,12700,12405,12420,12580,-260,-100,1082,5598
20150311,12420,12580,12395,12660,12370,12560,12555,-20,-25,1444,5852
20150312,12560,12555,12560,12730,12525,12720,12660,165,105,1206,5664
20150313,12720,12660,12720,12735,12605,12605,12660,-55,0,564,5688
20150316,12605,12660,12610,12610,12280,12485,12460,-175,-200,996,5830
20150317,12485,12460,12500,12585,12410,12435,12485,-25,25,816,5906
20150318,12435,12485,12415,12470,12300,12405,12400,-80,-85,912,5994
20150319,12405,12400,12400,12570,12345,12455,12470,55,70,1180,6130
20150320,12455,12470,12465,12540,12360,12470,12465,0,-5,978,6224
20150323,12470,12465,12540,12980,12520,12885,12750,420,285,3314,7282
20150324,12885,12750,12885,13175,12870,13030,13040,280,290,3436,7450
20150325,13030,13040,13025,13055,12885,12915,12955,-125,-85,1892,7602
20150326,12915,12955,12935,13155,12910,13020,13030,65,75,2296,7656
20150327,13020,13030,13015,13035,12585,12760,12775,-270,-255,3060,7648
20150330,12760,12775,12765,12780,12585,12610,12680,-165,-95,1930,7726
20150331,12610,12680,12645,12690,12500,12510,12615,-170,-65,1598,7688
20150401,12510,12615,12510,12675,12495,12580,12590,-35,-25,1338,7730
20150402,12580,12590,12600,12825,12580,12755,12725,165,135,1666,8068
20150403,12755,12725,12725,12790,12600,12730,12710,5,-15,994,8098
20150407,12730,12710,12750,12880,12750,12770,12810,60,100,1032,8152
20150408,12770,12810,12770,12800,12495,12575,12615,-235,-195,1714,8104
20150409,12575,12615,12575,12575,12190,12255,12315,-360,-300,2738,8672
20150410,12255,12315,12285,12300,12175,12270,12240,-45,-75,1260,9030
20150413,12270,12240,12300,12625,12300,12550,12480,310,240,1844,9140
20150414,12550,12480,12585,12595,12410,12565,12495,85,15,1154,9228
20150415,12565,12495,12535,12660,12515,12540,12590,45,95,1190,9294
20150416,12540,12590,12530,12745,12475,12650,12665,60,75,1174,9236
20150417,12650,12665,12700,12735,12575,12640,12665,-25,0,1214,9318
20150420,12640,12665,12605,12745,12530,12645,12675,-20,10,834,9390
20150421,12645,12675,12600,13100,12560,13100,12935,425,260,2160,9228
20150422,13100,12935,13090,13175,13030,13110,13105,175,170,1120,9118
20150423,13110,13105,13125,13440,13125,13215,13260,110,155,2084,8900
20150424,13215,13260,13260,13350,13215,13350,13280,90,20,1370,8988
20150427,13350,13280,13380,14075,13290,14075,13770,795,490,2316,8912
20150428,14075,13770,14110,14400,13955,14075,14180,305,410,4080,8266
20150429,14075,14180,14145,14145,13685,13850,13965,-330,-215,1922,8166
20150430,13850,13965,13905,14310,13880,14220,14195,255,230,3022,8822
20150504,14220,14195,14400,15045,14345,14810,14740,615,545,4172,9388
20150505,14810,14740,14885,14945,14675,14860,14795,120,55,1202,9424
20150506,14860,14795,14900,14980,14710,14845,14840,50,45,1612,9590
20150507,14845,14840,14925,15090,14415,14505,14725,-335,-115,3406,9452
20150508,14505,14725,14490,14625,14360,14450,14485,-275,-240,1312,9524
20150511,14450,14485,14530,14700,14350,14565,14480,80,-5,1700,9420
20150512,14565,14480,14565,14660,14400,14435,14505,-45,25,1190,9418
20150513,14435,14505,14500,14650,14400,14505,14525,0,20,1630,9476
20150514,14505,14525,14515,14540,13950,14050,14065,-475,-460,3412,8624
20150515,14050,14065,14100,14205,14050,14100,14125,35,60,836,8616
20150518,14100,14125,14085,14445,14030,14320,14285,195,160,2400,8624
20150519,14320,14285,14350,14350,14090,14200,14235,-85,-50,1252,8730
20150520,14200,14235,14185,14185,13400,13540,13670,-695,-565,2604,9238
20150521,13540,13670,13600,13795,13590,13715,13705,45,35,1232,9238
20150522,13715,13705,13780,13935,13650,13760,13800,55,95,1300,9202
20150525,13760,13800,13725,13855,13570,13810,13680,10,-120,1280,9264
20150526,13810,13680,13925,14495,13900,14235,14225,555,545,4584,9422
20150527,14235,14225,14225,14440,14220,14360,14335,135,110,2862,9026
20150528,14360,14335,14325,15000,14310,14570,14745,235,410,5296,9184
20150529,14570,14745,14510,14880,14295,14875,14630,130,-115,1770,9140
20150601,14875,14630,14915,15070,14635,14650,14795,20,165,3882,9038
20150602,14650,14795,14640,14865,14455,14610,14640,-185,-155,2488,8990
20150603,14610,14640,14700,14755,14285,14350,14540,-290,-100,2100,9138
20150604,14350,14540,14235,14350,13970,14350,14195,-190,-345,2836,9226
20150605,14350,14195,14370,14415,14105,14245,14250,50,55,1632,9304
20150608,14245,14250,14260,14405,14130,14155,14220,-95,-30,1874,9702
20150609,14155,14220,14100,14320,14050,14190,14240,-30,20,1168,9776
20150610,14190,14240,14250,14340,14200,14300,14260,60,20,1132,9798
20150611,14300,14260,14350,14485,14300,14320,14385,60,125,1862,10236
20150612,14320,14385,14230,14340,13710,13755,13960,-630,-425,2290,10428
20150615,13755,13960,13795,13870,13640,13725,13750,-235,-210,1186,10590
20150616,13725,13750,13780,13965,13590,13830,13800,80,50,1460,10794
20150617,13830,13800,13860,13900,13675,13720,13770,-80,-30,1520,10870
20150618,13720,13770,13790,13855,13515,13535,13650,-235,-120,1960,11166
20150619,13535,13650,13565,13710,13460,13550,13580,-100,-70,1798,11636
20150623,13550,13580,13550,13765,13550,13700,13670,120,90,1480,11762
20150624,13700,13670,13720,13780,13650,13660,13705,-10,35,1442,11710
20150625,13660,13705,13670,13700,13200,13200,13420,-505,-285,1998,12224
20150626,13200,13420,13220,13325,13030,13215,13165,-205,-255,3532,12318
20150629,13215,13165,13245,13295,13090,13155,13190,-10,25,1412,12322
20150630,13155,13190,13145,13155,12490,12685,12685,-505,-505,7504,11768
20150701,12685,12685,12615,13215,12615,13050,12930,365,245,2406,11922
20150702,13050,12930,13060,13200,12985,13130,13090,200,160,1394,11802
20150703,13130,13090,13205,13345,12910,13055,13130,-35,40,3026,11188
20150706,13055,13130,12985,13060,12475,12535,12700,-595,-430,4362,11788
20150707,12535,12700,12535,12715,12280,12320,12490,-380,-210,3690,11776
20150708,12320,12490,12165,12225,11740,11740,11825,-750,-665,2250,11674
20150709,11740,11825,11000,12310,10760,12080,11615,255,-210,9502,10760
20150710,12080,11615,12085,12310,11900,12010,12090,395,475,4464,10376
20150713,12010,12090,12045,12105,11835,11965,11950,-125,-140,2206,10284
20150714,11965,11950,12120,12260,11940,11960,12135,10,185,1990,10282
20150715,11960,12135,12030,12115,11970,12030,12045,-105,-90,940,10232
20150716,12030,12045,12030,12130,11740,12100,11945,55,-100,2490,10736
20150717,12100,11945,12135,12210,11970,12055,12090,110,145,1896,11014
20150720,12055,12090,11915,12160,11915,12130,12015,40,-75,2476,11064
20150721,12130,12015,12130,12280,12030,12270,12175,255,160,1850,11048
20150722,12270,12175,12295,12425,12035,12130,12265,-45,90,1850,10910
20150723,12130,12265,12090,12215,12025,12110,12110,-155,-155,1434,10896
20150724,12110,12110,12110,12165,11655,11655,11815,-455,-295,3548,10704
20150727,11655,11815,11700,11840,11500,11500,11715,-315,-100,3006,10204
20150728,11500,11715,11480,11735,11410,11685,11590,-30,-125,3044,9716
20150729,11685,11590,11720,11930,11605,11715,11760,125,170,2250,9704
20150730,11715,11760,11715,11860,11650,11780,11775,20,15,1154,9682
20150731,11780,11775,11800,11820,11685,11740,11760,-35,-15,1970,9884
20150803,11740,11760,11770,11805,11240,11465,11575,-295,-185,7574,9860
20150804,11465,11575,11350,11495,11145,11305,11350,-270,-225,6092,9534
20150805,11305,11350,11430,11500,11140,11310,11270,-40,-80,3074,9624
20150806,11310,11270,11350,11360,11165,11200,11255,-70,-15,2130,9590
20150807,11200,11255,11200,11260,11060,11185,11155,-70,-100,3486,9388
20150810,11185,11155,11160,11275,11110,11245,11185,90,30,1330,9288
20150811,11245,11185,11220,11365,11115,11115,11250,-70,65,2862,9534
20150812,11115,11250,11100,11150,10810,11145,10980,-105,-270,5962,9788
20150813,11145,10980,11140,11370,11000,11245,11210,265,230,5654,10176
20150814,11245,11210,11220,11280,11150,11195,11205,-15,-5,2138,10270
20150817,11195,11205,11215,11235,10965,11025,11100,-180,-105,2198,10752
20150818,11025,11100,11020,11075,10970,10995,11025,-105,-75,1970,10480
20150819,10995,11025,10920,11040,10840,11040,10960,15,-65,2216,10362
20150820,11040,10960,11060,11120,10940,10990,11020,30,60,1942,10600
20150821,10990,11020,11030,11080,10830,11000,11005,-20,-15,2234,10996
20150824,11000,11005,10965,11050,10340,10340,10575,-665,-430,4808,10572
20150825,10340,10575,10120,10435,10120,10205,10300,-370,-275,3956,10528
20150826,10205,10300,10400,10860,9685,10165,10320,-135,20,2964,10412
20150827,10165,10320,10165,10360,9910,10345,10265,25,-55,3364,10172
20150828,10345,10265,10350,10760,10350,10475,10540,210,275,2790,10222
20150831,10475,10540,10415,10525,10300,10315,10415,-225,-125,2522,10728
20150901,10315,10415,10265,10375,10225,10310,10300,-105,-115,1442,10752
20150902,10310,10300,10300,10300,10160,10190,10215,-110,-85,2118,10588
20150907,10190,10215,10155,10400,10130,10340,10320,125,105,2262,10420
20150908,10340,10320,10325,10445,10315,10430,10375,110,55,1212,10414
20150909,10430,10375,10520,10780,10480,10575,10620,200,245,3088,10440
20150910,10575,10620,10550,10600,10395,10580,10475,-40,-145,2906,11150
20150911,10580,10475,10605,10880,10600,10685,10740,210,265,4296,11594
20150914,10685,10740,10625,10785,10565,10580,10690,-160,-50,1762,11578
20150915,10580,10690,10505,10605,10420,10430,10510,-260,-180,1218,11418
20150916,10430,10510,10470,10645,10440,10630,10545,120,35,2252,10996
20150917,10630,10545,10650,10790,10610,10650,10695,105,150,1666,10994
20150918,10650,10695,10635,10695,10600,10630,10635,-65,-60,1370,11044
20150921,10630,10635,10630,10695,10450,10695,10535,60,-100,1380,10852
20150922,10695,10535,10690,10705,10590,10590,10635,55,100,1388,10804
20150923,10590,10635,10505,10600,10420,10575,10520,-60,-115,1496,10744
20150924,10575,10520,10600,10645,10525,10600,10580,80,60,678,10736
20150925,10600,10580,10590,10735,10550,10635,10640,55,60,1016,10536
20150928,10635,10640,10650,10700,10570,10570,10635,-70,-5,3504,10354
20150929,10570,10635,10560,10560,10370,10400,10450,-235,-185,2520,9126
20150930,10400,10450,10440,10465,10375,10400,10405,-50,-45,1294,8596
20151008,10400,10405,10685,10770,10425,10450,10570,45,165,710,8626
20151009,10450,10570,10435,10700,10430,10700,10580,130,10,1480,8424
20151012,10700,10580,10595,10800,10595,10700,10680,120,100,1086,8294
20151013,10700,10680,10680,10700,10555,10695,10615,15,-65,850,8136
20151014,10695,10615,10650,10720,10570,10590,10630,-25,15,1078,8078
20151015,10590,10630,10600,10710,10555,10600,10635,-30,5,856,7992
20151016,10600,10635,10570,10610,10520,10520,10570,-115,-65,646,7878
20151019,10520,10570,10545,10545,10270,10275,10395,-295,-175,1042,7798
20151020,10275,10395,10275,10305,10240,10300,10280,-95,-115,1218,7778
20151021,10300,10280,10300,10340,10145,10150,10225,-130,-55,716,7836
20151022,10150,10225,10200,10250,10100,10135,10140,-90,-85,574,7748
20151023,10135,10140,10170,10220,9970,10150,10085,10,-55,744,7634
20151026,10150,10085,10050,10100,9850,9860,9995,-225,-90,1014,7274
20151027,9860,9995,9830,9900,9690,9760,9780,-235,-215,1562,6962
20151028,9760,9780,9760,9880,9700,9730,9745,-50,-35,856,6986
20151029,9730,9745,9730,9900,9705,9780,9785,35,40,1256,6832
20151030,9780,9785,9745,9760,9455,9525,9540,-260,-245,1438,6438
20151102,9525,9540,9500,9650,9405,9570,9560,30,20,480,6312
20151103,9570,9560,9550,9550,9350,9350,9485,-210,-75,722,6070
20151104,9350,9485,9305,9455,9305,9450,9395,-35,-90,230,5944
20151105,9450,9395,9380,9480,9330,9340,9410,-55,15,274,5868
20151106,9340,9410,9400,9400,9300,9390,9360,-20,-50,440,5858
20151109,9390,9360,9390,9430,9200,9355,9365,-5,5,562,5526
20151110,9355,9365,9400,9480,9355,9480,9405,115,40,806,5330
20151111,9480,9405,9405,9640,9400,9400,9425,-5,20,334,5148
20151112,9400,9425,9395,9430,9365,9380,9395,-45,-30,254,5132
20151113,9380,9395,9390,9500,9390,9500,9460,105,65,114,5098
20151116,9500,9460,9405,9440,9150,9375,9320,-85,-140,196,5104
ru1601,20150116,12250,12250,12915,13390,12905,13090,13090,840,840,428,240
20150119,13090,13090,13065,13270,13005,13200,13190,110,100,652,646
20150120,13200,13190,13185,13280,13145,13145,13205,-45,15,206,686
20150121,13145,13205,13170,13460,13065,13430,13250,225,45,568,880
20150122,13430,13250,13375,13720,13375,13600,13605,350,355,384,934
20150123,13600,13605,13560,13595,13435,13590,13535,-15,-70,196,960
20150126,13590,13535,13565,13690,13355,13515,13505,-20,-30,274,936
20150127,13515,13505,13585,13810,13585,13760,13705,255,200,260,1022
20150128,13760,13705,13645,13770,13590,13640,13670,-65,-35,222,1086
20150129,13640,13670,13670,13670,13490,13550,13565,-120,-105,224,1124
20150130,13550,13565,13490,13600,13200,13200,13435,-365,-130,384,1252
20150202,13200,13435,13245,13625,13180,13620,13435,185,0,264,1308
20150203,13620,13435,13580,13735,13545,13665,13645,230,210,254,1364
20150204,13665,13645,13675,14125,13650,13850,13920,205,275,618,1656
20150205,13850,13920,13800,13990,13725,13755,13855,-165,-65,712,1802
20150206,13755,13855,13765,14095,13765,14090,13985,235,130,790,2154
20150209,14090,13985,14070,14220,13915,13980,14030,-5,45,892,2378
20150210,13980,14030,13740,14005,13740,13895,13920,-135,-110,546,2512
20150211,13895,13920,13850,13990,13745,13960,13900,40,-20,496,2584
20150212,13960,13900,13980,14015,13810,13900,13905,0,5,350,2652
20150213,13900,13905,13940,14100,13900,14035,14025,130,120,814,2940
20150216,14035,14025,14035,14100,13865,14085,14010,60,-15,1304,3266
20150217,14085,14010,14070,14070,13820,13850,13910,-160,-100,752,3224
20150225,13850,13910,13850,13855,13705,13770,13765,-140,-145,1214,3232
20150226,13770,13765,13780,14230,13745,14200,14010,435,245,1460,3846
20150227,14200,14010,14185,14250,14055,14125,14175,115,165,968,3914
20150302,14125,14175,14105,14260,13930,14050,14070,-125,-105,2216,4186
20150303,14050,14070,14005,14070,13655,13760,13795,-310,-275,1820,4206
20150304,13760,13795,13725,13920,13705,13790,13845,-5,50,2122,4522
20150305,13790,13845,13700,13845,13560,13670,13690,-175,-155,2846,4452
20150306,13670,13690,13675,13740,13380,13430,13560,-260,-130,2582,4778
20150309,13430,13560,13445,13675,13280,13575,13480,15,-80,3610,4900
20150310,13575,13480,13505,13600,13245,13265,13440,-215,-40,2768,5322
20150311,13265,13440,13215,13565,13210,13445,13375,5,-65,2944,5798
20150312,13445,13375,13430,13590,13380,13560,13510,185,135,2462,6004
20150313,13560,13510,13580,13630,13505,13545,13565,35,55,3144,6496
20150316,13545,13565,13505,13520,13150,13375,13350,-190,-215,2586,6372
20150317,13375,13350,13365,13470,13270,13290,13360,-60,10,3226,6670
20150318,13290,13360,13250,13375,13185,13290,13270,-70,-90,3164,6762
20150319,13290,13270,13255,13455,13240,13345,13355,75,85,2198,7018
20150320,13345,13355,13380,13430,13280,13385,13375,30,20,3624,7582
20150323,13385,13375,13455,14030,13430,13945,13765,570,390,7442,9276
20150324,13945,13765,13960,14235,13955,14045,14080,280,315,6778,10266
20150325,14045,14080,14025,14065,13870,13900,13955,-180,-125,5550,10310
20150326,13900,13955,13920,14020,13815,13905,13920,-50,-35,6974,11626
20150327,13905,13920,13735,13950,13500,13620,13685,-300,-235,7190,11442
20150330,13620,13685,13585,13650,13470,13495,13550,-190,-135,4306,11726
20150331,13495,13550,13505,13615,13425,13465,13535,-85,-15,6226,12684
20150401,13465,13535,13455,13615,13415,13480,13525,-55,-10,5288,13282
20150402,13480,13525,13510,13765,13490,13655,13655,130,130,5536,13988
20150403,13655,13655,13610,13720,13505,13660,13635,5,-20,5908,14850
20150407,13660,13635,13650,13795,13630,13640,13705,5,70,5930,15822
20150408,13640,13705,13640,13700,13420,13490,13535,-215,-170,9234,16090
20150409,13490,13535,13470,13495,13125,13150,13275,-385,-260,11250,15470
20150410,13150,13275,13210,13220,13080,13180,13145,-95,-130,7650,16918
20150413,13180,13145,13180,13560,13180,13460,13420,315,275,12382,18222
20150414,13460,13420,13490,13520,13315,13450,13395,30,-25,9256,18970
20150415,13450,13395,13420,13585,13420,13425,13500,30,105,10932,19416
20150416,13425,13500,13415,13665,13355,13585,13565,85,65,17850,19938
20150417,13585,13565,13585,13680,13475,13525,13585,-40,20,18870,20454
20150420,13525,13585,13465,13660,13465,13525,13575,-60,-10,16110,20380
20150421,13525,13575,13505,14030,13450,13995,13875,420,300,36334,23812
20150422,13995,13875,13960,14040,13895,13955,13965,80,90,23622,26490
20150423,13955,13965,13970,14270,13935,14060,14105,95,140,33600,28026
20150424,14060,14105,14060,14275,14060,14265,14170,160,65,23794,29836
20150427,14265,14170,14300,15020,14195,15015,14755,845,585,65856,40762
20150428,15015,14755,15030,15250,14900,14980,15080,225,325,62262,42882
20150429,14980,15080,15010,15060,14605,14805,14880,-275,-200,54794,43202
20150430,14805,14880,14880,15225,14805,15160,15085,280,205,49894,47422
20150504,15160,15085,15280,15960,15250,15680,15610,595,525,62928,51076
20150505,15680,15610,15680,15875,15560,15805,15725,195,115,55806,53174
20150506,15805,15725,15905,15980,15690,15845,15820,120,95,65284,56500
20150507,15845,15820,15900,16100,15490,15530,15720,-290,-100,64562,57436
20150508,15530,15720,15535,15725,15365,15515,15560,-205,-160,65524,57238
20150511,15515,15560,15555,15795,15405,15670,15605,110,45,51674,59606
20150512,15670,15605,15605,15765,15465,15520,15600,-85,-5,47002,60022
20150513,15520,15600,15610,15725,15455,15580,15580,-20,-20,42954,61606
20150514,15580,15580,15595,15620,15000,15120,15195,-460,-385,58742,59926
20150515,15120,15195,15140,15315,15080,15205,15195,10,0,46808,62520
20150518,15205,15195,15205,15520,15100,15385,15350,190,155,56704,60638
20150519,15385,15350,15400,15450,15155,15250,15315,-100,-35,39918,61438
20150520,15250,15315,15165,15165,14500,14615,14735,-700,-580,73588,56672
20150521,14615,14735,14700,14875,14595,14775,14780,40,45,44066,56508
20150522,14775,14780,14785,15000,14685,14870,14850,90,70,52390,59012
20150525,14870,14850,14795,14875,14535,14875,14710,25,-140,52900,60398
20150526,14875,14710,14915,15525,14915,15300,15270,590,560,92062,64124
20150527,15300,15270,15245,15490,15205,15445,15365,175,95,62516,62976
20150528,15445,15365,15485,16060,15380,15590,15725,225,360,110674,64412
20150529,15590,15725,15510,16060,15320,16035,15690,310,-35,108720,68732
20150601,16035,15690,16035,16490,15780,16075,16065,385,375,182604,75330
20150602,16075,16065,16025,16385,15860,16160,16135,95,70,179428,83774
20150603,16160,16135,16220,16330,15600,15620,16050,-515,-85,166470,85026
20150604,15620,16050,15620,15900,15360,15885,15650,-165,-400,190514,87320
20150605,15885,15650,15950,15985,15520,15745,15780,95,130,173362,89178
20150608,15745,15780,15750,15945,15600,15645,15745,-135,-35,148516,89610
20150609,15645,15745,15645,15825,15540,15565,15680,-180,-65,134176,88896
20150610,15565,15680,15600,15810,15590,15795,15690,115,10,126706,92762
20150611,15795,15690,15895,16065,15780,15860,15925,170,235,190840,106184
20150612,15860,15925,15860,15880,15055,15125,15390,-800,-535,217756,99962
20150615,15125,15390,15120,15295,15035,15090,15165,-300,-225,145562,99438
20150616,15090,15165,15050,15345,14900,15250,15170,85,5,164870,102708
20150617,15250,15170,15265,15270,14950,15075,15100,-95,-70,199654,101810
20150618,15075,15100,15190,15200,14825,14850,15010,-250,-90,188326,103078
20150619,14850,15010,14880,15095,14775,14940,14920,-70,-90,156462,100174
20150623,14940,14920,14945,15185,14930,15090,15060,170,140,121546,104076
20150624,15090,15060,15060,15215,15035,15115,15135,55,75,136540,110732
20150625,15115,15135,15125,15140,14665,14670,14895,-465,-240,203798,110876
20150626,14670,14895,14665,14745,14440,14720,14635,-175,-260,215076,101878
20150629,14720,14635,14790,14790,14530,14660,14640,25,5,211182,97736
20150630,14660,14640,14635,14670,13805,14050,14145,-590,-495,326376,89278
20150701,14050,14145,14100,14630,14055,14445,14310,300,165,263360,89908
20150702,14445,14310,14440,14540,14285,14475,14425,165,115,212936,91906
20150703,14475,14425,14515,14745,14225,14425,14535,0,110,251882,94688
20150706,14425,14535,14400,14410,13725,13910,14120,-625,-415,288866,91430
20150707,13910,14120,13910,14050,13355,13425,13765,-695,-355,310280,93690
20150708,13425,13765,13300,13330,12935,12935,13045,-830,-720,58296,89190
20150709,12935,13045,12085,13630,11870,13255,12990,210,-55,543554,78876
20150710,13255,12990,13360,13765,13070,13260,13375,270,385,454398,85132
20150713,13260,13375,13250,13435,12960,13170,13165,-205,-210,338626,92716
20150714,13170,13165,13285,13520,13070,13075,13310,-90,145,397130,105838
20150715,13075,13310,13140,13355,13120,13225,13230,-85,-80,337866,106124
20150716,13225,13230,13235,13390,12790,13335,13125,105,-105,633952,120876
20150717,13335,13125,13300,13450,13135,13220,13300,95,175,401138,121236
20150720,13220,13300,13090,13380,13055,13275,13200,-25,-100,427204,131306
20150721,13275,13200,13260,13500,13235,13480,13325,280,125,427906,140806
20150722,13480,13325,13485,13635,13180,13275,13440,-50,115,507862,138454
20150723,13275,13440,13240,13370,13115,13295,13240,-145,-200,470614,141694
20150724,13295,13240,13230,13335,12710,12720,13010,-520,-230,529372,166474
20150727,12720,13010,12820,12895,12455,12455,12705,-555,-305,505074,155742
20150728,12455,12705,12410,12765,12355,12660,12570,-45,-135,494458,150174
20150729,12660,12570,12700,12950,12550,12695,12750,125,180,515736,152906
20150730,12695,12750,12675,12880,12590,12695,12735,-55,-15,443962,150864
20150731,12695,12735,12655,12820,12560,12620,12695,-115,-40,443724,153972
20150803,12620,12695,12655,12800,12305,12415,12570,-280,-125,579240,159674
20150804,12415,12570,12390,12450,11850,12290,12195,-280,-375,730610,160490
20150805,12290,12195,12325,12405,12005,12255,12185,60,-10,567666,170856
20150806,12255,12185,12300,12330,12045,12080,12165,-105,-20,462892,172630
20150807,12080,12165,12000,12150,11800,12110,11980,-55,-185,679162,172076
20150810,12110,11980,12050,12260,11985,12250,12100,270,120,486058,174914
20150811,12250,12100,12245,12535,12150,12175,12305,75,205,635956,182942
20150812,12175,12305,12080,12330,11960,12310,12140,5,-165,666186,186554
20150813,12310,12140,12365,12585,12185,12490,12390,350,250,651886,186516
20150814,12490,12390,12440,12480,12270,12280,12375,-110,-15,463032,186360
20150817,12280,12375,12310,12430,12040,12150,12215,-225,-160,467882,192660
20150818,12150,12215,12115,12210,11990,12025,12105,-190,-110,464080,190492
20150819,12025,12105,11960,12085,11850,12075,11970,-30,-135,535206,195270
20150820,12075,11970,12080,12150,11865,11880,12000,-90,30,440898,199364
20150821,11880,12000,11990,12130,11700,12035,11985,35,-15,588530,187536
20150824,12035,11985,12050,12130,11265,11320,11590,-665,-395,726232,180504
20150825,11320,11590,11230,11530,11150,11295,11330,-295,-260,734002,166330
20150826,11295,11330,11600,11650,11165,11170,11355,-160,25,556428,178996
20150827,11170,11355,11150,11470,11060,11440,11325,85,-30,530224,166206
20150828,11440,11325,11490,11905,11430,11565,11610,240,285,624202,176150
20150831,11565,11610,11495,11665,11415,11430,11515,-180,-95,477574,176486
20150901,11430,11515,11375,11530,11295,11450,11420,-65,-95,450310,172184
20150902,11450,11420,11350,11450,11165,11220,11315,-200,-105,423956,169340
20150907,11220,11315,11180,11515,11130,11410,11410,95,95,477486,177800
20150908,11410,11410,11420,11600,11380,11600,11460,190,50,533190,192866
20150909,11600,11460,11695,11870,11580,11625,11730,165,270,975906,209566
20150910,11625,11730,11660,11780,11480,11765,11610,35,-120,758784,214962
20150911,11765,11610,11780,12080,11725,11860,11925,250,315,1273490,220272
20150914,11860,11925,11800,11960,11650,11670,11820,-255,-105,916200,211200
20150915,11670,11820,11630,11755,11485,11500,11620,-320,-200,891642,209404
20150916,11500,11620,11545,11730,11515,11730,11610,110,-10,1049618,215316
20150917,11730,11610,11760,11875,11620,11645,11735,35,125,1214810,209062
20150918,11645,11735,11615,11720,11545,11555,11645,-180,-90,1033556,215968
20150921,11555,11645,11490,11650,11370,11640,11480,-5,-165,771488,207730
20150922,11640,11480,11665,11690,11490,11495,11580,15,100,699518,209858
20150923,11495,11580,11430,11525,11285,11490,11410,-90,-170,832632,207252
20150924,11490,11410,11525,11545,11405,11500,11470,90,60,622546,206888
20150925,11500,11470,11450,11700,11445,11665,11605,195,135,817622,205590
20150928,11665,11605,11630,11810,11560,11580,11625,-25,20,394600,204932
20150929,11580,11625,11535,11540,11205,11255,11335,-370,-290,726526,194502
20150930,11255,11335,11310,11360,11255,11280,11300,-55,-35,404616,181602
20151008,11280,11300,11590,11750,11380,11390,11510,90,210,384136,192020
20151009,11390,11510,11395,11860,11355,11855,11610,345,100,911780,219454
20151012,11855,11610,11855,11930,11660,11800,11790,190,180,948782,233172
20151013,11800,11790,11775,11835,11620,11820,11710,30,-80,670126,235836
20151014,11820,11710,11790,11880,11680,11710,11770,0,60,797510,230452
20151015,11710,11770,11725,11975,11690,11725,11825,-45,55,1079734,245058
20151016,11725,11825,11720,11755,11605,11610,11685,-215,-140,846904,231280
20151019,11610,11685,11610,11650,11355,11365,11480,-320,-205,744708,243842
20151020,11365,11480,11330,11425,11295,11375,11365,-105,-115,634182,245416
20151021,11375,11365,11390,11450,11125,11145,11300,-220,-65,788790,268088
20151022,11145,11300,11130,11320,11090,11210,11215,-90,-85,808910,261334
20151023,11210,11215,11245,11340,10980,11310,11175,95,-40,1201474,252382
20151026,11310,11175,11295,11305,10960,10980,11120,-195,-55,906754,276534
20151027,10980,11120,10985,10990,10715,10805,10835,-315,-285,912478,273706
20151028,10805,10835,10825,10880,10740,10830,10810,-5,-25,648244,275258
20151029,10830,10810,10840,11060,10815,10920,10910,110,100,682066,272682
20151030,10920,10910,10900,10965,10770,10810,10850,-100,-60,578832,274512
20151102,10810,10850,10810,10985,10705,10890,10880,40,30,547276,267450
20151103,10890,10880,10895,10920,10600,10615,10775,-265,-105,598008,282622
20151104,10615,10775,10620,10740,10600,10705,10665,-70,-110,556616,269508
20151105,10705,10665,10705,10810,10485,10540,10625,-125,-40,651730,275284
20151106,10540,10625,10550,10585,10410,10545,10505,-80,-120,712326,269780
20151109,10545,10505,10550,10565,10380,10500,10490,-5,-15,615832,264354
20151110,10500,10490,10510,10745,10455,10740,10555,250,65,742612,259960
20151111,10740,10555,10745,10835,10655,10675,10720,120,165,815266,236670
20151112,10675,10720,10660,10830,10630,10760,10740,40,20,647750,227914
20151113,10760,10740,10680,10970,10660,10870,10830,130,90,620878,205824
20151116,10870,10830,10865,10910,10460,10520,10670,-310,-160,642898,220234
20151117,10520,10670,10540,10590,10365,10520,10495,-150,-175,640530,212902
20151118,10520,10495,10530,10550,10375,10480,10465,-15,-30,443222,210792
20151119,10480,10465,10485,10515,10185,10300,10340,-165,-125,493570,205708
20151120,10300,10340,10245,10470,10210,10340,10330,0,-10,452946,188948
20151123,10340,10330,10310,10435,10235,10395,10325,65,-5,479578,164624
20151124,10395,10325,10390,10485,10015,10395,10225,70,-100,553584,150926
20151125,10395,10225,10400,10800,10380,10775,10615,550,390,430710,132798
20151126,10775,10615,10760,11240,10690,10975,10935,360,320,341314,111854
20151127,10975,10935,10925,11055,10855,10900,10940,-35,5,164804,101676
20151130,10900,10940,10895,10935,10785,10895,10850,-45,-90,100682,88850
ru1603,20150317,13350,13350,13370,13475,13350,13360,13400,10,50,22,14
20150318,13360,13400,,,,13400,13400,0,0,0,14
20150319,13400,13400,13305,13470,13305,13440,13380,40,-20,12,20
20150320,13440,13380,13510,13515,13400,13435,13485,55,105,22,38
20150323,13435,13485,13605,14020,13605,13980,13905,495,420,22,40
20150324,13980,13905,14090,14275,14090,14245,14175,340,270,32,50
20150325,14245,14175,14070,14105,14000,14020,14035,-155,-140,12,56
20150326,14020,14035,14020,14070,13960,14070,14020,35,-15,20,54
20150327,14070,14020,14000,14000,13680,13705,13850,-315,-170,18,52
20150330,13705,13850,,,,13850,13850,0,0,0,52
20150331,13850,13850,13630,13755,13500,13500,13620,-350,-230,14,54
20150401,13500,13620,13565,13600,13565,13600,13575,-20,-45,6,54
20150402,13600,13575,13705,13810,13660,13770,13755,195,180,34,82
20150403,13770,13755,13700,13820,13700,13810,13755,55,0,12,88
20150407,13810,13755,13815,13825,13815,13825,13820,70,65,4,86
20150408,13825,13820,13600,13680,13600,13620,13630,-200,-190,6,90
20150409,13620,13630,13340,13425,13240,13320,13340,-310,-290,28,80
20150410,13320,13340,13280,13300,13280,13300,13290,-40,-50,4,82
20150413,13300,13290,13500,13620,13500,13550,13600,260,310,50,100
20150414,13550,13600,13500,13540,13500,13540,13520,-60,-80,4,104
20150415,13540,13520,13700,13700,13640,13640,13670,120,150,4,106
20150416,13640,13670,13660,13780,13660,13780,13720,110,50,4,108
20150417,13780,13720,13705,13810,13685,13760,13765,40,45,92,150
20150420,13760,13765,13695,13815,13630,13660,13690,-105,-75,108,128
20150421,13660,13690,13700,14120,13575,13980,13790,290,100,58,106
20150422,13980,13790,14145,14170,13935,14140,14090,350,300,24,104
20150423,14140,14090,14195,14355,14195,14350,14270,260,180,12,106
20150424,14350,14270,14185,14350,14185,14310,14265,40,-5,20,110
20150427,14310,14265,14380,15120,14380,15120,14985,855,720,58,126
20150428,15120,14985,15425,15425,15080,15100,15220,115,235,50,120
20150429,15100,15220,15060,15125,14660,14900,15015,-320,-205,74,126
20150430,14900,15015,15055,15320,15055,15260,15205,245,190,30,130
20150504,15260,15205,15435,16000,15435,15880,15740,675,535,44,130
20150505,15880,15740,15860,15960,15800,15930,15905,190,165,12,132
20150506,15930,15905,16000,16005,15860,16005,15960,100,55,18,130
20150507,16005,15960,16190,16190,15695,15695,15820,-265,-140,28,122
20150508,15695,15820,15525,15760,15525,15715,15660,-105,-160,12,122
20150511,15715,15660,15910,15910,15775,15775,15820,115,160,6,124
20150512,15775,15820,,,,15815,15815,-5,-5,0,124
20150513,15815,15815,15750,15750,15750,15750,15750,-65,-65,2,126
20150514,15750,15750,15560,15560,15245,15245,15320,-505,-430,36,128
20150515,15245,15320,15320,15405,15320,15405,15360,85,40,4,126
20150518,15405,15360,15670,15670,15670,15670,15670,310,310,30,156
20150519,15670,15670,15560,15560,15470,15520,15550,-150,-120,34,154
20150520,15520,15550,15070,15070,14760,14760,14835,-790,-715,30,180
20150521,14760,14835,14975,15000,14885,15000,14940,165,105,14,180
20150522,15000,14940,15060,15060,14915,14915,14975,-25,35,6,180
20150525,14915,14975,,,,14835,14835,-140,-140,0,180
20150526,14835,14835,15205,15650,15205,15650,15425,815,590,20,174
20150527,15650,15425,15530,15560,15455,15455,15535,30,110,22,158
20150528,15455,15535,15640,16005,15640,15685,15800,150,265,54,120
20150529,15685,15800,15720,16100,15720,16100,15845,300,45,24,114
20150601,16100,15845,16215,16620,16085,16320,16325,475,480,22,118
20150602,16320,16325,16160,16450,16160,16170,16340,-155,15,30,120
20150603,16170,16340,16190,16190,15800,15800,16010,-540,-330,8,118
20150604,15800,16010,15630,16005,15630,16005,15815,-5,-195,6,116
20150605,16005,15815,16145,16145,15775,16000,16015,185,200,10,120
20150608,16000,16015,15920,15920,15920,15920,15920,-95,-95,2,120
20150609,15920,15920,15910,15975,15910,15950,15945,30,25,8,124
20150610,15950,15945,15830,15905,15820,15870,15845,-75,-100,14,126
20150611,15870,15845,16070,16070,16035,16035,16040,190,195,8,124
20150612,16035,16040,15930,15930,15430,15430,15510,-610,-530,170,128
20150615,15430,15510,15450,15475,15315,15330,15390,-180,-120,20,116
20150616,15330,15390,15465,15465,15345,15345,15405,-45,15,4,118
20150617,15345,15405,15335,15335,15290,15290,15300,-115,-105,10,114
20150618,15290,15300,15275,15275,15235,15235,15250,-65,-50,12,118
20150619,15235,15250,15120,15120,15020,15105,15060,-145,-190,26,98
20150623,15105,15060,15325,15325,15190,15190,15255,130,195,4,98
20150624,15190,15255,,,,15255,15255,0,0,0,98
20150625,15255,15255,15215,15215,14945,14945,15080,-310,-175,4,98
20150626,14945,15080,14900,14900,14675,14675,14830,-405,-250,28,88
20150629,14675,14830,14810,14810,14810,14810,14810,-20,-20,2,88
20150630,14810,14810,14505,14505,14065,14120,14200,-690,-610,10,86
20150701,14120,14200,,,,14365,14365,165,165,0,86
20150702,14365,14365,14550,14625,14550,14625,14585,260,220,4,84
20150703,14625,14585,14850,14850,14600,14600,14680,15,95,6,78
20150706,14600,14680,14405,14485,14000,14000,14260,-680,-420,12,76
20150707,14000,14260,14095,14165,13780,13780,13960,-480,-300,42,80
20150708,13780,13960,13500,13500,13225,13225,13315,-735,-645,20,84
20150709,13225,13315,12520,13620,12520,13620,13005,305,-310,56,64
20150710,13620,13005,13440,13770,13440,13555,13550,550,545,8,56
20150713,13555,13550,13455,13560,13255,13270,13365,-280,-185,12,56
20150714,13270,13365,13710,13710,13650,13650,13680,285,315,4,56
20150715,13650,13680,13450,13480,13420,13420,13440,-260,-240,28,56
20150716,13420,13440,13040,13545,13040,13545,13375,105,-65,6,60
20150717,13545,13375,13585,13600,13340,13435,13495,60,120,18,58
20150720,13435,13495,13335,13475,13300,13475,13380,-20,-115,22,62
20150721,13475,13380,13515,13550,13320,13515,13495,135,115,20,58
20150722,13515,13495,13710,13800,13510,13510,13645,15,150,8,56
20150723,13510,13645,,,,13440,13440,-205,-205,0,56
20150724,13440,13440,13470,13470,12900,12900,13120,-540,-320,44,58
20150727,12900,13120,12875,12895,12875,12895,12885,-225,-235,4,60
20150728,12895,12885,12680,12855,12580,12780,12710,-105,-175,24,58
20150729,12780,12710,13035,13035,13035,13035,13035,325,325,2,58
20150730,13035,13035,12955,12955,12955,12955,12955,-80,-80,2,58
20150731,12955,12955,,,,12915,12915,-40,-40,0,58
20150803,12915,12915,12850,12960,12795,12840,12850,-75,-65,14,64
20150804,12840,12850,12305,12305,12075,12265,12150,-585,-700,38,64
20150805,12265,12150,12440,12440,12300,12300,12390,150,240,6,62
20150806,12300,12390,12440,12440,12255,12315,12325,-75,-65,34,58
20150807,12315,12325,12170,12170,11960,12020,12005,-305,-320,22,52
20150810,12020,12005,12175,12175,12175,12175,12175,170,170,4,52
20150811,12175,12175,12515,12515,12515,12515,12515,340,340,2,50
20150812,12515,12515,12310,12425,12230,12425,12330,-90,-185,32,60
20150813,12425,12330,12700,12700,12360,12545,12560,215,230,40,76
20150814,12545,12560,12565,12565,12480,12505,12515,-55,-45,36,58
20150817,12505,12515,12565,12565,12310,12310,12435,-205,-80,4,58
20150818,12310,12435,12325,12325,12305,12305,12315,-130,-120,4,56
20150819,12305,12315,12115,12165,12060,12165,12100,-150,-215,12,54
20150820,12165,12100,,,,12130,12130,30,30,0,54
20150821,12130,12130,12145,12235,12060,12195,12155,65,25,16,52
20150824,12195,12155,,,,11755,11755,-400,-400,0,52
20150825,11755,11755,11445,11650,11405,11465,11505,-290,-250,24,50
20150826,11465,11505,11450,11490,11440,11490,11460,-15,-45,20,52
20150827,11490,11460,11350,11515,11350,11515,11485,55,25,12,48
20150828,11515,11485,11605,11935,11605,11730,11800,245,315,58,68
20150831,11730,11800,,,,11705,11705,-95,-95,0,68
20150901,11705,11705,11460,11500,11460,11500,11480,-205,-225,4,68
20150902,11500,11480,11370,11370,11370,11370,11370,-110,-110,2,70
20150907,11370,11370,,,,11465,11465,95,95,0,70
20150908,11465,11465,,,,11515,11515,50,50,0,70
20150909,11515,11515,11850,11935,11850,11935,11885,420,370,42,70
20150910,11935,11885,11670,11845,11670,11845,11730,-40,-155,8,68
20150911,11845,11730,11830,12125,11825,11960,11995,230,265,78,74
20150914,11960,11995,11940,12075,11940,12010,12005,15,10,10,74
20150915,12010,12005,11790,11805,11720,11720,11775,-285,-230,16,74
20150916,11720,11775,11720,11795,11665,11665,11710,-110,-65,22,70
20150917,11665,11710,11950,11950,11815,11815,11880,105,170,4,72
20150918,11815,11880,11780,11780,11780,11780,11780,-100,-100,4,68
20150921,11780,11780,11595,11615,11595,11615,11605,-165,-175,4,68
20150922,11615,11605,11615,11730,11615,11660,11680,55,75,8,68
20150923,11660,11680,11595,11595,11445,11445,11495,-235,-185,8,66
20150924,11445,11495,11630,11720,11395,11560,11585,65,90,32,66
20150925,11560,11585,,,,11720,11720,135,135,0,66
20150928,11720,11720,,,,11740,11740,20,20,0,66
20150929,11740,11740,11520,11520,11325,11325,11420,-415,-320,10,64
20150930,11325,11420,11455,11455,11410,11410,11430,-10,10,4,64
20151008,11410,11430,,,,11645,11645,215,215,0,64
20151009,11645,11645,11825,11880,11820,11825,11835,180,190,8,64
20151012,11825,11835,,,,11835,11835,0,0,0,64
20151013,11835,11835,11840,11840,11840,11840,11840,5,5,2,64
20151014,11840,11840,12060,12060,11845,11850,11935,10,95,12,64
20151015,11850,11935,11865,12005,11820,11830,11890,-105,-45,32,68
20151016,11830,11890,,,,11750,11750,-140,-140,0,68
20151019,11750,11750,11640,11640,11500,11500,11570,-250,-180,4,66
20151020,11500,11570,11520,11520,11385,11385,11455,-185,-115,10,66
20151021,11385,11455,11385,11525,11385,11415,11445,-40,-10,60,68
20151022,11415,11445,11235,11400,11235,11325,11330,-120,-115,10,64
20151023,11325,11330,11380,11400,11250,11340,11325,10,-5,10,64
20151026,11340,11325,11275,11275,11190,11205,11230,-120,-95,28,68
20151027,11205,11230,10990,10990,10855,10875,10905,-355,-325,8,64
20151028,10875,10905,10885,10885,10885,10885,10885,-20,-20,2,64
20151029,10885,10885,,,,10985,10985,100,100,0,64
20151030,10985,10985,,,,10925,10925,-60,-60,0,64
20151102,10925,10925,,,,10955,10955,30,30,0,64
20151103,10955,10955,10935,10935,10745,10745,10840,-210,-115,4,64
20151104,10745,10840,10675,10755,10655,10755,10680,-85,-160,14,66
20151105,10755,10680,10690,10690,10640,10640,10665,-40,-15,8,68
20151106,10640,10665,10595,10595,10595,10595,10595,-70,-70,2,66
20151109,10595,10595,10585,10590,10480,10480,10510,-115,-85,96,144
20151110,10480,10510,10540,10730,10460,10700,10580,190,70,246,240
20151111,10700,10580,10640,10750,10600,10625,10665,45,85,204,268
20151112,10625,10665,10540,10610,10515,10610,10540,-55,-125,102,210
20151113,10610,10540,10545,10670,10545,10610,10635,70,95,26,214
20151116,10610,10635,10635,10685,10380,10380,10540,-255,-95,22,208
20151117,10380,10540,10265,10335,10250,10255,10280,-285,-260,18,202
20151118,10255,10280,,,,10280,10280,0,0,0,202
20151119,10280,10280,9945,10150,9945,10150,10045,-130,-235,4,202
20151120,10150,10045,9915,10245,9915,10030,10005,-15,-40,18,204
20151123,10030,10005,9985,9985,9680,9680,9800,-325,-205,18,204
20151124,9680,9800,9475,9900,9405,9760,9580,-40,-220,44,198
20151125,9760,9580,9680,9860,9670,9860,9790,280,210,26,196
20151126,9860,9790,9575,10280,9575,10105,10030,315,240,52,196
20151127,10105,10030,9895,10280,9895,9995,10020,-35,-10,80,198
20151130,9995,10020,9970,9970,9810,9915,9870,-105,-150,50,192
ru1604,20150416,13670,13670,13755,13795,13755,13775,13775,105,105,12,12
20150417,13775,13775,,,,13820,13820,45,45,0,12
20150420,13820,13820,13865,13865,13850,13850,13855,30,35,12,20
20150421,13850,13855,13750,13830,13415,13780,13710,-75,-145,12,22
20150422,13780,13710,14290,14290,14130,14135,14190,425,480,10,22
20150423,14135,14190,14420,14420,14175,14265,14285,75,95,6,20
20150424,14265,14285,14215,14385,14215,14385,14290,100,5,18,26
20150427,14385,14290,14430,15110,14315,15010,14660,720,370,14,32
20150428,15010,14660,15105,15385,15105,15125,15230,465,570,34,32
20150429,15125,15230,15040,15040,14775,14775,14840,-455,-390,14,36
20150430,14775,14840,15400,15400,15240,15295,15300,455,460,12,42
20150504,15295,15300,15495,16160,15495,15990,15975,690,675,38,38
20150505,15990,15975,15955,16030,15900,16030,15980,55,5,10,38
20150506,16030,15980,16100,16155,16025,16080,16065,100,85,44,54
20150507,16080,16065,16250,16250,15800,15800,16035,-265,-30,22,58
20150508,15800,16035,15755,15935,15730,15780,15845,-255,-190,16,66
20150511,15780,15845,15910,15945,15800,15890,15895,45,50,16,74
20150512,15890,15895,15980,15995,15675,15675,15895,-220,0,16,78
20150513,15675,15895,15950,15950,15800,15810,15855,-85,-40,8,80
20150514,15810,15855,15450,15470,15340,15400,15405,-455,-450,30,82
20150515,15400,15405,15560,15585,15560,15585,15565,180,160,6,88
20150518,15585,15565,15475,15795,15475,15795,15550,230,-15,10,90
20150519,15795,15550,15655,15655,15620,15620,15635,70,85,4,90
20150520,15620,15635,15300,15300,14860,14860,14995,-775,-640,30,94
20150521,14860,14995,15065,15065,15005,15025,15040,30,45,8,92
20150522,15025,15040,15210,15210,15030,15185,15130,145,90,8,92
20150525,15185,15130,15095,15105,14990,15105,15060,-25,-70,6,92
20150526,15105,15060,15540,15595,15540,15595,15555,535,495,6,90
20150527,15595,15555,15625,15755,15625,15755,15710,200,155,6,90
20150528,15755,15710,15950,16100,15800,15800,16000,90,290,12,86
20150529,15800,16000,16050,16100,16050,16100,16080,100,80,6,82
20150601,16100,16080,,,,16565,16565,485,485,0,82
20150602,16565,16565,,,,16565,16565,0,0,0,82
20150603,16565,16565,,,,16230,16230,-335,-335,0,82
20150604,16230,16230,15840,15900,15800,15900,15850,-330,-380,16,80
20150605,15900,15850,16110,16220,15850,16050,16050,200,200,14,78
20150608,16050,16050,,,,16050,16050,0,0,0,78
20150609,16050,16050,15980,15980,15935,15935,15950,-115,-100,6,82
20150610,15935,15950,15955,16120,15955,16120,16035,170,85,4,86
20150611,16120,16035,16160,16265,16140,16265,16160,230,125,14,82
20150612,16265,16160,16130,16130,15520,15520,15930,-640,-230,14,82
20150615,15520,15930,15540,15540,15455,15455,15495,-475,-435,12,88
20150616,15455,15495,15380,15580,15320,15420,15390,-75,-105,16,88
20150617,15420,15390,,,,15285,15285,-105,-105,0,88
20150618,15285,15285,15285,15285,15285,15285,15285,0,0,2,86
20150619,15285,15285,,,,15095,15095,-190,-190,0,86
20150623,15095,15095,15300,15300,15280,15300,15290,205,195,12,86
20150624,15300,15290,15440,15485,15375,15375,15420,85,130,8,84
20150625,15375,15420,,,,15420,15420,0,0,0,84
20150626,15420,15420,14900,15065,14900,14975,14980,-445,-440,6,82
20150629,14975,14980,14960,14960,14935,14935,14945,-45,-35,4,84
20150630,14935,14945,14195,14355,14155,14355,14195,-590,-750,18,72
20150701,14355,14195,,,,14195,14195,0,0,0,72
20150702,14195,14195,14720,14720,14720,14720,14720,525,525,2,70
20150703,14720,14720,14900,14900,14655,14655,14735,-65,15,6,70
20150706,14655,14735,,,,14735,14735,0,0,0,70
20150707,14735,14735,14000,14075,13855,13855,13985,-880,-750,42,44
20150708,13855,13985,13260,13260,13150,13150,13170,-835,-815,10,48
20150709,13150,13170,12380,13655,12375,13520,12905,350,-265,46,38
20150710,13520,12905,13530,13675,13420,13670,13570,765,665,18,30
20150713,13670,13570,13455,13455,13100,13185,13170,-385,-400,64,36
20150714,13185,13170,13450,13450,13450,13450,13450,280,280,2,34
20150715,13450,13450,,,,13210,13210,-240,-240,0,34
20150716,13210,13210,,,,13210,13210,0,0,0,34
20150717,13210,13210,13465,13465,13465,13465,13465,255,255,2,32
20150720,13465,13465,,,,13350,13350,-115,-115,0,32
20150721,13350,13350,13595,13595,13360,13570,13505,220,155,6,32
20150722,13570,13505,13795,13880,13700,13700,13800,195,295,10,36
20150723,13700,13800,13440,13440,13440,13440,13440,-360,-360,2,34
20150724,13440,13440,13130,13160,13105,13160,13130,-280,-310,6,32
20150727,13160,13130,,,,13130,13130,0,0,0,32
20150728,13130,13130,12545,12855,12545,12855,12645,-275,-485,84,32
20150729,12855,12645,13015,13015,12915,12995,12985,350,340,10,30
20150730,12995,12985,12905,13040,12890,13040,12980,55,-5,14,30
20150731,13040,12980,,,,12940,12940,-40,-40,0,30
20150803,12940,12940,,,,12875,12875,-65,-65,0,30
20150804,12875,12875,,,,12175,12175,-700,-700,0,30
20150805,12175,12175,,,,12175,12175,0,0,0,30
20150806,12175,12175,,,,12110,12110,-65,-65,0,30
20150807,12110,12110,12085,12175,12085,12175,12130,65,20,4,32
20150810,12175,12130,,,,12130,12130,0,0,0,32
20150811,12130,12130,,,,12130,12130,0,0,0,32
20150812,12130,12130,12255,12380,12255,12380,12305,250,175,6,34
20150813,12380,12305,,,,12525,12525,220,220,0,34
20150814,12525,12525,12560,12765,12560,12620,12645,95,120,18,36
20150817,12620,12645,,,,12645,12645,0,0,0,36
20150818,12645,12645,,,,12520,12520,-125,-125,0,36
20150819,12520,12520,12250,12250,12230,12250,12240,-270,-280,10,34
20150820,12250,12240,12205,12205,12130,12130,12165,-110,-75,4,36
20150821,12130,12165,12205,12225,12135,12225,12190,60,25,8,32
20150824,12225,12190,11480,11480,11480,11480,11480,-710,-710,4,28
20150825,11480,11480,,,,11480,11480,0,0,0,28
20150826,11480,11480,,,,11455,11455,-25,-25,0,28
20150827,11455,11455,,,,11480,11480,25,25,0,28
20150828,11480,11480,,,,11480,11480,0,0,0,28
20150831,11480,11480,,,,11390,11390,-90,-90,0,28
20150901,11390,11390,,,,11585,11585,195,195,0,28
20150902,11585,11585,11700,11700,11600,11600,11635,15,50,12,32
20150907,11600,11635,,,,11730,11730,95,95,0,32
20150908,11730,11730,,,,11780,11780,50,50,0,32
20150909,11780,11780,12185,12185,11880,11880,12060,100,280,34,36
20150910,11880,12060,11835,11965,11685,11965,11825,-95,-235,36,40
20150911,11965,11825,12165,12165,12080,12080,12120,255,295,4,40
20150914,12080,12120,12105,12105,12075,12075,12090,-45,-30,4,40
20150915,12075,12090,11900,11900,11900,11900,11900,-190,-190,4,40
20150916,11900,11900,,,,11835,11835,-65,-65,0,40
20150917,11835,11835,11835,12005,11770,11870,11880,35,45,32,42
20150918,11870,11880,11765,11800,11700,11800,11755,-80,-125,6,42
20150921,11800,11755,11705,11850,11705,11765,11715,10,-40,34,72
20150922,11765,11715,11740,11740,11665,11665,11680,-50,-35,10,80
20150923,11665,11680,11635,11640,11545,11620,11615,-60,-65,54,44
20150924,11620,11615,11620,11645,11555,11645,11600,30,-15,36,60
20150925,11645,11600,11615,11755,11615,11755,11670,155,70,6,58
20150928,11755,11670,11705,11925,11705,11820,11815,150,145,6,58
20150929,11820,11815,,,,11490,11490,-325,-325,0,58
20150930,11490,11490,,,,11485,11485,-5,-5,0,58
20151008,11485,11485,11665,11665,11665,11665,11665,180,180,2,58
20151009,11665,11665,11520,11955,11520,11940,11630,275,-35,36,56
20151012,11940,11630,11920,11920,11840,11855,11895,225,265,14,44
20151013,11855,11895,11880,11880,11800,11800,11840,-95,-55,4,40
20151014,11800,11840,,,,11935,11935,95,95,0,40
20151015,11935,11935,12040,12045,12040,12045,12040,110,105,4,40
20151016,12045,12040,11895,11895,11895,11895,11895,-145,-145,2,42
20151019,11895,11895,11530,11540,11530,11530,11530,-365,-365,10,36
20151020,11530,11530,,,,11415,11415,-115,-115,0,36
20151021,11415,11415,,,,11405,11405,-10,-10,0,36
20151022,11405,11405,11400,11400,11290,11290,11345,-115,-60,4,36
20151023,11290,11345,,,,11340,11340,-5,-5,0,36
20151026,11340,11340,11300,11300,11300,11300,11300,-40,-40,2,36
20151027,11300,11300,11100,11100,10975,10975,11030,-325,-270,22,38
20151028,10975,11030,10865,10880,10865,10875,10870,-155,-160,6,40
20151029,10875,10870,,,,10970,10970,100,100,0,40
20151030,10970,10970,11035,11035,10980,10985,10995,15,25,10,42
20151102,10985,10995,10835,11165,10835,10985,10875,-10,-120,92,102
20151103,10985,10875,10960,10990,10765,10795,10885,-80,10,160,54
20151104,10795,10885,10705,10705,10665,10665,10680,-220,-205,18,42
20151105,10665,10680,,,,10665,10665,-15,-15,0,42
20151106,10665,10665,10485,11300,10485,11300,10755,635,90,6,42
20151109,11300,10755,,,,10755,10755,0,0,0,42
20151110,10755,10755,,,,10755,10755,0,0,0,42
20151111,10755,10755,10815,10815,10480,10630,10615,-125,-140,14,40
20151112,10630,10615,10460,10550,10410,10485,10480,-130,-135,30,42
20151113,10485,10480,10600,10645,10540,10615,10585,135,105,18,42
20151116,10615,10585,10345,10345,10345,10345,10345,-240,-240,2,42
20151117,10345,10345,,,,10345,10345,0,0,0,42
20151118,10345,10345,,,,10345,10345,0,0,0,42
20151119,10345,10345,,,,10345,10345,0,0,0,42
20151120,10345,10345,,,,10345,10345,0,0,0,42
20151123,10345,10345,9985,9985,9720,9720,9805,-625,-540,6,46
20151124,9720,9805,9520,9700,9365,9700,9490,-105,-315,24,48
20151125,9700,9490,9795,9960,9630,9915,9775,425,285,28,48
20151126,9915,9775,9860,10360,9860,10355,10290,580,515,64,48
20151127,10355,10290,10140,10250,10100,10200,10170,-90,-120,20,50
20151130,10200,10170,10170,10170,9850,9890,9970,-280,-200,6,50
ru1605,20150518,15565,15565,14665,15950,14665,15705,15670,140,105,124,80
20150519,15705,15670,15770,15770,15585,15665,15660,-5,-10,168,180
20150520,15665,15660,15400,15400,14930,15135,15080,-525,-580,358,424
20150521,15135,15080,15135,15240,15090,15140,15165,60,85,170,472
20150522,15140,15165,15195,15350,15100,15215,15230,50,65,302,628
20150525,15215,15230,15145,15265,14935,15225,15095,-5,-135,194,704
20150526,15225,15095,15330,15850,15325,15510,15635,415,540,518,726
20150527,15510,15635,15510,15735,15510,15680,15665,45,30,142,712
20150528,15680,15665,15795,16300,15780,15825,15970,160,305,272,714
20150529,15825,15970,15730,16390,15605,16390,16065,420,95,472,864
20150601,16390,16065,16380,16735,16150,16450,16395,385,330,1382,878
20150602,16450,16395,16400,16680,16260,16500,16495,105,100,662,900
20150603,16500,16495,16555,16630,16010,16010,16445,-485,-50,844,1244
20150604,16010,16445,16020,16245,15750,16245,16015,-200,-430,1054,1516
20150605,16245,16015,16210,16330,15900,16095,16130,80,115,634,1524
20150608,16095,16130,16010,16320,15980,16000,16060,-130,-70,434,1636
20150609,16000,16060,15970,16175,15900,15965,16020,-95,-40,440,1742
20150610,15965,16020,16000,16130,15975,16130,16060,110,40,292,1788
20150611,16130,16060,16215,16405,16140,16200,16255,140,195,552,1902
20150612,16200,16255,16200,16200,15400,15430,15635,-825,-620,804,1946
20150615,15430,15635,15595,15685,15410,15440,15550,-195,-85,386,2106
20150616,15440,15550,15450,15700,15280,15580,15510,30,-40,640,2320
20150617,15580,15510,15615,15615,15315,15400,15455,-110,-55,726,2456
20150618,15400,15455,15550,15550,15210,15210,15365,-245,-90,490,2512
20150619,15210,15365,15250,15450,15165,15300,15300,-65,-65,580,2422
20150623,15300,15300,15260,15515,15260,15435,15395,135,95,498,2510
20150624,15435,15395,15435,15595,15390,15460,15490,65,95,338,2520
20150625,15460,15490,15475,15480,15010,15025,15235,-465,-255,680,2626
20150626,15025,15235,14985,15110,14815,15085,14995,-150,-240,1240,2920
20150629,15085,14995,15075,15100,14900,15025,14995,30,0,774,2920
20150630,15025,14995,14975,14980,14175,14400,14485,-595,-510,2614,3228
20150701,14400,14485,14420,14950,14420,14770,14635,285,150,1328,3368
20150702,14770,14635,14800,14865,14650,14795,14745,160,110,574,3392
20150703,14795,14745,14845,15055,14540,14770,14830,25,85,1070,3418
20150706,14770,14830,14725,14725,14065,14235,14435,-595,-395,1376,3446
20150707,14235,14435,14190,14350,13680,13725,14025,-710,-410,1374,3476
20150708,13725,14025,13700,13700,13180,13180,13245,-845,-780,1354,3444
20150709,13180,13245,12300,13815,12050,13450,12985,205,-260,3630,3122
20150710,13450,12985,13500,13760,13330,13505,13595,520,610,2052,3430
20150713,13505,13595,13550,13665,13195,13350,13400,-245,-195,1610,3378
20150714,13350,13400,13415,13710,13335,13345,13550,-55,150,1200,3518
20150715,13345,13550,13395,13570,13370,13440,13485,-110,-65,1592,4100
20150716,13440,13485,13490,13630,13030,13615,13370,130,-115,3120,4632
20150717,13615,13370,13615,13700,13400,13485,13545,115,175,1860,4768
20150720,13485,13545,13410,13600,13315,13525,13435,-20,-110,1686,4900
20150721,13525,13435,13505,13730,13490,13715,13585,280,150,1578,4990
20150722,13715,13585,13760,13980,13400,13535,13685,-50,100,5622,5932
20150723,13535,13685,13545,13635,13380,13555,13505,-130,-180,3250,6526
20150724,13555,13505,13540,13585,12970,12980,13185,-525,-320,4344,6616
20150727,12980,13185,13010,13125,12750,12770,12965,-415,-220,4288,7028
20150728,12770,12965,12795,13030,12630,12930,12845,-35,-120,2918,7076
20150729,12930,12845,12955,13200,12825,12945,13005,100,160,2664,7230
20150730,12945,13005,12935,13135,12850,12980,13050,-25,45,3530,8030
20150731,12980,13050,12980,13100,12855,12900,12980,-150,-70,2712,8290
20150803,12900,12980,12945,13070,12600,12690,12790,-290,-190,5964,7836
20150804,12690,12790,12660,12725,12160,12510,12430,-280,-360,6116,8318
20150805,12510,12430,12670,12670,12295,12535,12470,105,40,6034,9344
20150806,12535,12470,12535,12600,12365,12380,12470,-90,0,5746,10810
20150807,12380,12470,12350,12430,12105,12370,12250,-100,-220,9604,11212
20150810,12370,12250,12315,12565,12300,12550,12385,300,135,7360,12598
20150811,12550,12385,12540,12805,12500,12515,12615,130,230,13258,14422
20150812,12515,12615,12355,12635,12305,12620,12465,5,-150,12786,15070
20150813,12620,12465,12650,12945,12535,12830,12740,365,275,16250,16520
20150814,12830,12740,12815,12815,12610,12615,12720,-125,-20,9752,16578
20150817,12615,12720,12670,12735,12400,12505,12560,-215,-160,10640,16620
20150818,12505,12560,12485,12550,12325,12360,12445,-200,-115,10366,17086
20150819,12360,12445,12305,12370,12155,12360,12270,-85,-175,13706,18782
20150820,12360,12270,12380,12440,12165,12180,12290,-90,20,14694,19726
20150821,12180,12290,12290,12410,12030,12330,12285,40,-5,18026,20870
20150824,12330,12285,12305,12400,11545,11570,11840,-715,-445,39264,20826
20150825,11570,11840,11515,11830,11425,11570,11630,-270,-210,42576,19906
20150826,11570,11630,11850,11935,11450,11470,11625,-160,-5,34932,21590
20150827,11470,11625,11410,11760,11360,11715,11600,90,-25,28118,21520
20150828,11715,11600,11900,12175,11715,11875,11905,275,305,33912,23330
20150831,11875,11905,11815,12000,11705,11720,11805,-185,-100,35642,27622
20150901,11720,11805,11690,11805,11575,11735,11700,-70,-105,21904,28550
20150902,11735,11700,11650,11705,11420,11470,11570,-230,-130,27006,28396
20150907,11470,11570,11410,11765,11390,11670,11665,100,95,29870,29878
20150908,11670,11665,11705,11850,11640,11840,11720,175,55,21506,31830
20150909,11840,11720,11930,12130,11860,11910,11990,190,270,53882,34852
20150910,11910,11990,11960,12060,11750,12060,11890,70,-100,40286,36586
20150911,12060,11890,11990,12375,11990,12165,12220,275,330,78962,40606
20150914,12165,12220,12115,12260,11960,11965,12130,-255,-90,49598,40586
20150915,11965,12130,11955,12040,11770,11785,11910,-345,-220,49902,39546
20150916,11785,11910,11860,12020,11810,12005,11895,95,-15,41648,40648
20150917,12005,11895,12030,12160,11890,11920,12015,25,120,72202,43676
20150918,11920,12015,11905,11980,11790,11810,11900,-205,-115,48192,44838
20150921,11810,11900,11730,11880,11620,11875,11730,-25,-170,42702,44332
20150922,11875,11730,11920,11920,11750,11750,11840,20,110,31350,45270
20150923,11750,11840,11685,11735,11495,11700,11635,-140,-205,42336,46994
20150924,11700,11635,11745,11770,11605,11680,11675,45,40,25792,48450
20150925,11680,11675,11630,11885,11620,11835,11780,160,105,39022,49498
20150928,11835,11780,11820,11950,11745,11765,11810,-15,30,14076,49716
20150929,11765,11810,11720,11725,11410,11475,11545,-335,-265,32128,47354
20150930,11475,11545,11545,11570,11445,11480,11495,-65,-50,15680,46646
20151008,11480,11495,11750,11890,11570,11580,11705,85,210,18284,48936
20151009,11580,11705,11585,12040,11570,12035,11835,330,130,55448,52810
20151012,12035,11835,12080,12115,11880,12005,12005,170,170,50748,58528
20151013,12005,12005,11995,12030,11815,12010,11905,5,-100,32908,59532
20151014,12010,11905,11985,12040,11855,11880,11945,-25,40,41078,63142
20151015,11880,11945,11900,12100,11865,11870,11980,-75,35,69528,71024
20151016,11870,11980,11880,11880,11720,11750,11805,-230,-175,47818,71484
20151019,11750,11805,11715,11775,11525,11530,11630,-275,-175,45410,70992
20151020,11530,11630,11470,11595,11460,11560,11535,-70,-95,41514,72514
20151021,11560,11535,11585,11635,11320,11330,11470,-205,-65,59752,77014
20151022,11330,11470,11330,11510,11280,11395,11405,-75,-65,58100,79026
20151023,11395,11405,11450,11535,11165,11485,11360,80,-45,98720,81218
20151026,11485,11360,11500,11500,11095,11110,11280,-250,-80,79156,89246
20151027,11110,11280,11105,11120,10860,10985,10970,-295,-310,80042,92936
20151028,10985,10970,10970,11085,10940,11035,11010,65,40,68014,93876
20151029,11035,11010,11035,11260,11025,11080,11105,70,95,61818,96714
20151030,11080,11105,11065,11135,10960,10975,11030,-130,-75,54282,96242
20151102,10975,11030,10960,11145,10880,11045,11040,15,10,53784,100852
20151103,11045,11040,11050,11070,10655,10655,10870,-385,-170,100570,115922
20151104,10655,10870,10680,10780,10620,10740,10705,-130,-165,93806,115216
20151105,10740,10705,10760,10855,10530,10550,10660,-155,-45,123844,120684
20151106,10550,10660,10550,10645,10480,10620,10575,-40,-85,103532,113686
20151109,10620,10575,10605,10675,10485,10615,10600,40,25,95458,112936
20151110,10615,10600,10640,10790,10560,10770,10640,170,40,115204,117634
20151111,10770,10640,10800,10800,10505,10510,10655,-130,15,169006,128736
20151112,10510,10655,10515,10590,10355,10515,10470,-140,-185,186986,135974
20151113,10515,10470,10450,10645,10410,10560,10550,90,80,185028,136752
20151116,10560,10550,10560,10635,10240,10250,10415,-300,-135,186594,152242
20151117,10250,10415,10280,10350,10165,10260,10260,-155,-155,178946,152126
20151118,10260,10260,10275,10300,10155,10215,10215,-45,-45,136448,153874
20151119,10215,10215,10210,10275,9925,10015,10065,-200,-150,244664,163914
20151120,10015,10065,9990,10140,9930,9960,10015,-105,-50,236750,168164
20151123,9960,10015,9965,10005,9485,9515,9755,-500,-260,416178,179880
20151124,9515,9755,9560,9825,9350,9675,9535,-80,-220,435654,190844
20151125,9675,9535,9630,9925,9605,9845,9765,310,230,564500,189162
20151126,9845,9765,9760,10350,9680,10105,10070,340,305,854126,190884
20151127,10105,10070,10060,10330,9975,10020,10110,-50,40,619878,192056
20151130,10020,10110,10005,10035,9825,9880,9900,-230,-210,528248,199100
ru1606,20150616,15550,15550,15690,16560,15690,16560,16040,1010,490,10,10
20150617,16560,16040,15435,15530,15395,15470,15465,-570,-575,22,10
20150618,15470,15465,,,,15465,15465,0,0,0,10
20150619,15465,15465,,,,15465,15465,0,0,0,10
20150623,15465,15465,,,,15465,15465,0,0,0,10
20150624,15465,15465,,,,15465,15465,0,0,0,10
20150625,15465,15465,15180,15180,15180,15180,15180,-285,-285,2,10
20150626,15180,15180,14880,14895,14880,14895,14885,-285,-295,4,12
20150629,14895,14885,14955,14955,14955,14955,14955,70,70,2,14
20150630,14955,14955,14380,14500,14060,14500,14255,-455,-700,36,28
20150701,14500,14255,14390,14700,14390,14700,14520,445,265,10,30
20150702,14700,14520,,,,14630,14630,110,110,0,30
20150703,14630,14630,14810,14950,14800,14800,14850,170,220,6,28
20150706,14800,14850,,,,14850,14850,0,0,0,28
20150707,14850,14850,14300,14300,13960,13960,14140,-890,-710,18,34
20150708,13960,14140,,,,13290,13290,-850,-850,0,34
20150709,13290,13290,12490,13910,12490,13875,12760,585,-530,48,38
20150710,13875,12760,12230,13525,12230,13525,13325,765,565,14,40
20150713,13525,13325,13945,14120,13300,13300,13575,-25,250,22,36
20150714,13300,13575,13225,14335,13225,13395,13815,-180,240,8,38
20150715,13395,13815,13480,13485,13480,13485,13480,-330,-335,4,40
20150716,13485,13480,13380,13705,13200,13590,13485,110,5,12,44
20150717,13590,13485,13690,13700,13690,13700,13695,215,210,4,42
20150720,13700,13695,,,,13695,13695,0,0,0,42
20150721,13695,13695,13620,13620,13620,13620,13620,-75,-75,2,40
20150722,13620,13620,,,,13620,13620,0,0,0,40
20150723,13620,13620,,,,13620,13620,0,0,0,40
20150724,13620,13620,13195,13195,13195,13195,13195,-425,-425,2,40
20150727,13195,13195,,,,12975,12975,-220,-220,0,40
20150728,12975,12975,13025,13025,12690,12905,12800,-70,-175,10,40
20150729,12905,12800,13065,13065,13065,13065,13065,265,265,2,40
20150730,13065,13065,13085,13085,13085,13085,13085,20,20,2,38
20150731,13085,13085,,,,13085,13085,0,0,0,38
20150803,13085,13085,13000,13000,12640,12640,12830,-445,-255,8,44
20150804,12640,12830,12540,12540,12350,12500,12445,-330,-385,8,42
20150805,12500,12445,12345,12505,12345,12505,12425,60,-20,4,40
20150806,12505,12425,12535,12535,12415,12415,12475,-10,50,4,40
20150807,12415,12475,,,,12255,12255,-220,-220,0,40
20150810,12255,12255,12390,12400,12390,12400,12395,145,140,4,36
20150811,12400,12395,12600,12800,12495,12630,12645,235,250,46,32
20150812,12630,12645,12420,12570,12420,12570,12510,-75,-135,10,32
20150813,12570,12510,12745,12850,12745,12850,12780,340,270,8,30
20150814,12850,12780,12580,12815,12580,12790,12720,10,-60,18,32
20150817,12790,12720,,,,12720,12720,0,0,0,32
20150818,12720,12720,12545,12545,12545,12545,12545,-175,-175,6,36
20150819,12545,12545,12230,12345,12230,12345,12295,-200,-250,6,36
20150820,12345,12295,,,,12315,12315,20,20,0,36
20150821,12315,12315,,,,12315,12315,0,0,0,36
20150824,12315,12315,12415,12415,11575,11575,11830,-740,-485,8,40
20150825,11575,11830,11575,11730,11460,11680,11605,-150,-225,12,38
20150826,11680,11605,11575,11665,11510,11510,11580,-95,-25,10,40
20150827,11510,11580,11515,11820,11515,11820,11630,240,50,14,42
20150828,11820,11630,12000,12095,12000,12095,12045,465,415,4,40
20150831,12095,12045,11825,11825,11825,11825,11825,-220,-220,4,40
20150901,11825,11825,,,,11820,11820,-5,-5,0,40
20150902,11820,11820,11520,11520,11480,11480,11500,-340,-320,6,42
20150907,11480,11500,,,,11595,11595,95,95,0,42
20150908,11595,11595,11795,11800,11795,11800,11795,205,200,4,40
20150909,11800,11795,12020,12080,12000,12000,12060,205,265,16,48
20150910,12000,12060,11970,12055,11785,11860,11900,-200,-160,12,48
20150911,11860,11900,12460,12460,12120,12120,12330,220,430,14,42
20150914,12120,12330,12210,12280,12055,12100,12135,-230,-195,26,44
20150915,12100,12135,12000,12000,11925,11925,11960,-210,-175,4,44
20150916,11925,11960,,,,11990,11990,30,30,0,44
20150917,11990,11990,12050,12080,12050,12080,12070,90,80,6,44
20150918,12080,12070,,,,11870,11870,-200,-200,0,44
20150921,11870,11870,11810,11810,11780,11780,11795,-90,-75,4,42
20150922,11780,11795,11885,11900,11885,11900,11890,105,95,4,38
20150923,11900,11890,,,,11680,11680,-210,-210,0,38
20150924,11680,11680,,,,11720,11720,40,40,0,38
20150925,11720,11720,,,,11720,11720,0,0,0,38
20150928,11720,11720,11910,11910,11910,11910,11910,190,190,2,38
20150929,11910,11910,11675,11675,11675,11675,11675,-235,-235,4,36
20150930,11675,11675,,,,11625,11625,-50,-50,0,36
20151008,11625,11625,11735,11735,11725,11725,11730,100,105,4,32
20151009,11725,11730,,,,11860,11860,130,130,0,32
20151012,11860,11860,12090,12090,12090,12090,12090,230,230,2,32
20151013,12090,12090,,,,12090,12090,0,0,0,32
20151014,12090,12090,,,,12090,12090,0,0,0,32
20151015,12090,12090,,,,12080,12080,-10,-10,0,32
20151016,12080,12080,,,,12080,12080,0,0,0,32
20151019,12080,12080,,,,12080,12080,0,0,0,32
20151020,12080,12080,11495,11600,11495,11570,11540,-510,-540,14,36
20151021,11570,11540,11600,11600,11460,11460,11550,-80,10,6,34
20151022,11460,11550,11510,11510,11355,11355,11430,-195,-120,4,36
20151023,11355,11430,11445,11445,11415,11415,11430,-15,0,4,34
20151026,11415,11430,11200,11200,11200,11200,11200,-230,-230,2,36
20151027,11200,11200,10940,10940,10940,10940,10940,-260,-260,2,38
20151028,10940,10940,,,,10940,10940,0,0,0,38
20151029,10940,10940,11095,11095,11095,11095,11095,155,155,2,36
20151030,11095,11095,10995,10995,10995,10995,10995,-100,-100,2,36
20151102,10995,10995,11045,11045,10980,10980,11010,-15,15,4,36
20151103,10980,11010,11015,11015,11015,11015,11015,5,5,2,38
20151104,11015,11015,10665,10665,10665,10665,10665,-350,-350,4,36
20151105,10665,10665,10680,10680,10510,10560,10595,-105,-70,44,36
20151106,10560,10595,10630,10630,10625,10625,10625,30,30,4,36
20151109,10625,10625,,,,10625,10625,0,0,0,36
20151110,10625,10625,,,,10625,10625,0,0,0,36
20151111,10625,10625,10665,10665,10540,10540,10580,-85,-45,8,38
20151112,10540,10580,10300,10485,10300,10485,10360,-95,-220,12,36
20151113,10485,10360,10555,10555,10555,10555,10555,195,195,2,34
20151116,10555,10555,10550,10550,10405,10405,10490,-150,-65,10,38
20151117,10405,10490,10385,10385,10270,10270,10305,-220,-185,6,42
20151118,10270,10305,,,,10305,10305,0,0,0,42
20151119,10305,10305,10200,10200,10200,10200,10200,-105,-105,2,42
20151120,10200,10200,10020,10040,10020,10040,10025,-160,-175,6,40
20151123,10040,10025,9950,10175,9500,9745,9825,-280,-200,58,56
20151124,9745,9825,9540,9800,9395,9700,9620,-125,-205,36,66
20151125,9700,9620,9790,9855,9705,9770,9735,150,115,56,70
20151126,9770,9735,9680,10315,9680,10105,10210,370,475,1386,1064
20151127,10105,10210,10065,10230,9940,10030,10105,-180,-105,242,1060
20151130,10030,10105,9720,9920,9720,9830,9850,-275,-255,198,1068
ru1607,20150716,13480,13480,,,,13480,13480,0,0,0,0
20150717,13480,13480,,,,13685,13685,205,205,0,0
20150720,13685,13685,,,,13685,13685,0,0,0,0
20150721,13685,13685,,,,13685,13685,0,0,0,0
20150722,13685,13685,,,,13685,13685,0,0,0,0
20150723,13685,13685,,,,13685,13685,0,0,0,0
20150724,13685,13685,13820,13820,13060,13060,13345,-625,-340,6,6
20150727,13060,13345,13160,13160,13060,13060,13110,-285,-235,4,10
20150728,13060,13110,13100,13100,12915,12915,13005,-195,-105,4,10
20150729,12915,13005,13105,13105,13105,13105,13105,100,100,2,8
20150730,13105,13105,,,,13105,13105,0,0,0,8
20150731,13105,13105,,,,13035,13035,-70,-70,0,8
20150803,13035,13035,,,,13035,13035,0,0,0,8
20150804,13035,13035,12460,12460,12460,12460,12460,-575,-575,4,10
20150805,12460,12460,12660,12660,12300,12480,12425,20,-35,22,18
20150806,12480,12425,12460,12545,12460,12545,12490,120,65,10,28
20150807,12545,12490,12180,12180,12180,12180,12180,-310,-310,2,28
20150810,12180,12180,12300,12400,12300,12400,12365,220,185,6,30
20150811,12400,12365,,,,12380,12380,15,15,0,30
20150812,12380,12380,12340,12600,12305,12600,12405,220,25,26,34
20150813,12600,12405,12800,12845,12600,12750,12740,345,335,24,42
20150814,12750,12740,12600,12600,12600,12600,12600,-140,-140,2,42
20150817,12600,12600,,,,12440,12440,-160,-160,0,42
20150818,12440,12440,12460,12460,12380,12380,12400,-60,-40,20,54
20150819,12380,12400,12340,12390,12300,12390,12335,-10,-65,28,60
20150820,12390,12335,12440,12440,12245,12305,12330,-30,-5,6,60
20150821,12305,12330,12330,12355,12330,12355,12340,25,10,4,60
20150824,12355,12340,11595,11595,11595,11595,11595,-745,-745,4,62
20150825,11595,11595,11600,11640,11575,11575,11615,-20,20,26,72
20150826,11575,11615,11795,11800,11575,11600,11670,-15,55,18,72
20150827,11600,11670,11750,11750,11750,11750,11750,80,80,2,74
20150828,11750,11750,11840,12380,11800,11935,12030,185,280,14,82
20150831,11935,12030,11800,12000,11800,11825,11875,-205,-155,26,92
20150901,11825,11875,,,,11765,11765,-110,-110,0,92
20150902,11765,11765,11720,11720,11655,11655,11675,-110,-90,10,96
20150907,11655,11675,11810,11810,11810,11810,11810,135,135,2,94
20150908,11810,11810,11785,11785,11785,11785,11785,-25,-25,2,92
20150909,11785,11785,12035,12200,12035,12045,12100,260,315,18,94
20150910,12045,12100,,,,12100,12100,0,0,0,94
20150911,12100,12100,12270,12270,12270,12270,12270,170,170,2,92
20150914,12270,12270,12280,12280,12220,12220,12265,-50,-5,10,100
20150915,12220,12265,12070,12070,11950,11950,11995,-315,-270,10,104
20150916,11950,11995,11955,11965,11955,11965,11960,-30,-35,6,102
20150917,11965,11960,12100,12100,12010,12035,12045,75,85,12,102
20150918,12035,12045,11995,11995,11995,11995,11995,-50,-50,2,100
20150921,11995,11995,11765,11795,11765,11795,11780,-200,-215,4,100
20150922,11795,11780,11925,11925,11890,11900,11900,120,120,12,100
20150923,11900,11900,11715,11745,11715,11745,11725,-155,-175,8,104
20150924,11745,11725,,,,11725,11725,0,0,0,104
20150925,11725,11725,11860,11860,11845,11850,11850,125,125,14,98
20150928,11850,11850,,,,12040,12040,190,190,0,98
20150929,12040,12040,11560,11560,11525,11525,11545,-515,-495,6,96
20150930,11525,11545,11530,11545,11500,11545,11525,0,-20,8,100
20151008,11545,11525,11800,11800,11780,11780,11790,255,265,4,104
20151009,11780,11790,11740,11740,11740,11740,11740,-50,-50,2,104
20151012,11740,11740,,,,11740,11740,0,0,0,104
20151013,11740,11740,11975,11975,11925,11925,11945,185,205,6,106
20151014,11925,11945,,,,11945,11945,0,0,0,106
20151015,11945,11945,11930,12085,11770,11950,11990,5,45,106,156
20151016,11950,11990,11830,11830,11800,11800,11810,-190,-180,6,156
20151019,11800,11810,11760,11760,11615,11615,11690,-195,-120,8,154
20151020,11615,11690,11505,11555,11490,11520,11515,-170,-175,8,154
20151021,11520,11515,,,,11515,11515,0,0,0,154
20151022,11515,11515,,,,11395,11395,-120,-120,0,154
20151023,11395,11395,11430,11430,11430,11430,11430,35,35,6,154
20151026,11430,11430,11290,11300,11280,11280,11290,-150,-140,6,154
20151027,11280,11290,10950,11120,10830,11000,10905,-290,-385,70,172
20151028,11000,10905,10930,11015,10890,10890,10975,-15,70,88,150
20151029,10890,10975,11040,11085,11040,11085,11060,110,85,4,150
20151030,11085,11060,11130,11130,11000,11000,11085,-60,25,6,154
20151102,11000,11085,,,,11085,11085,0,0,0,154
20151103,11085,11085,10680,10680,10680,10680,10680,-405,-405,2,152
20151104,10680,10680,10680,10710,10605,10710,10660,30,-20,46,146
20151105,10710,10660,10795,10820,10580,10580,10640,-80,-20,40,140
20151106,10580,10640,10600,10600,10590,10590,10595,-50,-45,6,136
20151109,10590,10595,,,,10620,10620,25,25,0,136
20151110,10620,10620,10745,10745,10575,10575,10680,-45,60,8,138
20151111,10575,10680,10575,10615,10545,10545,10580,-135,-100,14,144
20151112,10545,10580,10435,10470,10400,10410,10425,-170,-155,8,142
20151113,10410,10425,,,,10620,10620,195,195,0,142
20151116,10620,10620,10310,10310,10310,10310,10310,-310,-310,2,142
20151117,10310,10310,10240,10240,10240,10240,10240,-70,-70,2,140
20151118,10240,10240,10100,10185,10100,10185,10140,-55,-100,4,138
20151119,10185,10140,10245,10245,10245,10245,10245,105,105,2,136
20151120,10245,10245,9950,10170,9940,10030,10020,-215,-225,8,134
20151123,10030,10020,9830,9930,9505,9505,9695,-515,-325,16,138
20151124,9505,9695,9550,9550,9550,9550,9550,-145,-145,2,136
20151125,9550,9550,9780,9845,9780,9845,9820,295,270,6,140
20151126,9845,9820,9650,10405,9650,10080,10155,260,335,46,146
20151127,10080,10155,10010,10045,9940,9940,9985,-215,-170,8,148
20151130,9940,9985,9850,9850,9750,9750,9790,-235,-195,10,144
ru1608,20150818,12440,12440,,,,12440,12440,0,0,0,0
20150819,12440,12440,12135,12625,12135,12395,12365,-45,-75,12,4
20150820,12395,12365,12280,12280,12280,12280,12280,-85,-85,2,6
20150821,12280,12280,12275,12300,12275,12300,12285,20,5,4,6
20150824,12300,12285,11930,11930,11640,11710,11760,-575,-525,38,28
20150825,11710,11760,,,,11760,11760,0,0,0,28
20150826,11760,11760,11910,11910,11910,11910,11910,150,150,2,28
20150827,11910,11910,,,,11990,11990,80,80,0,28
20150828,11990,11990,,,,12275,12275,285,285,0,28
20150831,12275,12275,11955,11955,11955,11955,11955,-320,-320,2,28
20150901,11955,11955,,,,11845,11845,-110,-110,0,28
20150902,11845,11845,,,,11755,11755,-90,-90,0,28
20150907,11755,11755,,,,11890,11890,135,135,0,28
20150908,11890,11890,,,,11860,11860,-30,-30,0,28
20150909,11860,11860,,,,12180,12180,320,320,0,28
20150910,12180,12180,11835,12025,11835,12025,11930,-155,-250,4,30
20150911,12025,11930,12355,12450,12265,12275,12355,345,425,10,32
20150914,12275,12355,12320,12320,12320,12320,12320,-35,-35,2,34
20150915,12320,12320,11995,12165,11995,12165,12085,-155,-235,6,32
20150916,12165,12085,,,,12050,12050,-35,-35,0,32
20150917,12050,12050,,,,12135,12135,85,85,0,32
20150918,12135,12135,,,,12080,12080,-55,-55,0,32
20150921,12080,12080,,,,11860,11860,-220,-220,0,32
20150922,11860,11860,11935,11935,11935,11935,11935,75,75,8,32
20150923,11935,11935,,,,11760,11760,-175,-175,0,32
20150924,11760,11760,,,,11800,11800,40,40,0,32
20150925,11800,11800,,,,11925,11925,125,125,0,32
20150928,11925,11925,,,,12115,12115,190,190,0,32
20150929,12115,12115,,,,11620,11620,-495,-495,0,32
20150930,11620,11620,,,,11600,11600,-20,-20,0,32
20151008,11600,11600,,,,11865,11865,265,265,0,32
20151009,11865,11865,,,,11865,11865,0,0,0,32
20151012,11865,11865,11980,12285,11980,12285,12130,420,265,4,32
20151013,12285,12130,,,,12130,12130,0,0,0,32
20151014,12130,12130,,,,12130,12130,0,0,0,32
20151015,12130,12130,12050,12765,11985,11985,12125,-145,-5,56,68
20151016,11985,12125,11965,11965,11675,11875,11845,-250,-280,16,70
20151019,11875,11845,11615,11615,11580,11580,11595,-265,-250,16,70
20151020,11580,11595,11340,11610,11340,11465,11505,-130,-90,10,72
20151021,11465,11505,11565,11565,11400,11400,11480,-105,-25,4,72
20151022,11400,11480,,,,11480,11480,0,0,0,72
20151023,11480,11480,11400,11400,11215,11235,11270,-245,-210,8,70
20151026,11235,11270,,,,11130,11130,-140,-140,0,70
20151027,11130,11130,10940,10940,10915,10915,10920,-215,-210,8,70
20151028,10915,10920,11145,11145,10965,10965,11055,45,135,8,72
20151029,10965,11055,,,,11055,11055,0,0,0,72
20151030,11055,11055,,,,11080,11080,25,25,0,72
20151102,11080,11080,11130,11130,11130,11130,11130,50,50,2,72
20151103,11130,11130,10810,10810,10810,10810,10810,-320,-320,2,74
20151104,10810,10810,10645,10645,10645,10645,10645,-165,-165,4,70
20151105,10645,10645,10865,10865,10580,10580,10720,-65,75,4,72
20151106,10580,10720,10760,11345,10370,10605,10680,-115,-40,12,72
20151109,10605,10680,,,,10680,10680,0,0,0,72
20151110,10680,10680,10445,10765,10445,10765,10610,85,-70,16,74
20151111,10765,10610,10705,10705,10505,10505,10580,-105,-30,10,80
20151112,10505,10580,10480,10480,10365,10365,10400,-215,-180,8,80
20151113,10365,10400,,,,10595,10595,195,195,0,80
20151116,10595,10595,10545,10545,10295,10295,10440,-300,-155,16,86
20151117,10295,10440,10230,10230,10230,10230,10230,-210,-210,2,88
20151118,10230,10230,,,,10230,10230,0,0,0,88
20151119,10230,10230,9970,9970,9965,9965,9965,-265,-265,6,88
20151120,9965,9965,,,,9965,9965,0,0,0,88
20151123,9965,9965,9715,9785,9485,9485,9660,-480,-305,16,86
20151124,9485,9660,9575,9575,9575,9575,9575,-85,-85,2,84
20151125,9575,9575,9790,9800,9790,9800,9795,225,220,4,88
20151126,9800,9795,10140,10370,9990,9990,10160,195,365,22,90
20151127,9990,10160,10100,10100,9880,9880,10025,-280,-135,8,90
20151130,9880,10025,9730,9730,9730,9730,9730,-295,-295,2,90
ru1609,20150916,12085,12085,12080,12160,11970,12125,12045,40,-40,344,178
20150917,12125,12045,12150,12310,12020,12050,12140,5,95,854,670
20150918,12050,12140,12000,12100,11905,11910,12015,-230,-125,524,882
20150921,11910,12015,11820,11960,11725,11955,11795,-60,-220,656,1040
20150922,11955,11795,12000,12010,11825,11825,11920,30,125,732,1184
20150923,11825,11920,11750,11805,11650,11745,11715,-175,-205,778,1312
20150924,11745,11715,11755,11850,11710,11765,11780,50,65,858,1736
20150925,11765,11780,11730,11960,11730,11935,11890,155,110,1372,2258
20150928,11935,11890,11920,11980,11860,11880,11920,-10,30,526,2526
20150929,11880,11920,11800,11860,11485,11560,11635,-360,-285,1568,2524
20150930,11560,11635,11560,11630,11535,11580,11580,-55,-55,354,2564
20151008,11580,11580,11655,11965,11655,11680,11780,100,200,584,2548
20151009,11680,11780,11720,12090,11490,12090,11915,310,135,1938,3108
20151012,12090,11915,12090,12180,11950,12100,12065,185,150,1740,3884
20151013,12100,12065,12090,12110,11920,12110,12000,45,-65,690,3992
20151014,12110,12000,12060,12135,11950,11970,12025,-30,25,1162,4098
20151015,11970,12025,12000,12070,11870,11870,11960,-155,-65,5358,6656
20151016,11870,11960,11870,11890,11715,11750,11805,-210,-155,2144,7382
20151019,11750,11805,11750,11770,11545,11545,11620,-260,-185,2438,8130
20151020,11545,11620,11500,11635,11495,11595,11575,-25,-45,1638,8492
20151021,11595,11575,11645,11665,11370,11375,11530,-200,-45,2590,8844
20151022,11375,11530,11365,11540,11320,11430,11425,-100,-105,1540,9164
20151023,11430,11425,11455,11540,11185,11460,11360,35,-65,4688,10778
20151026,11460,11360,11550,11550,11115,11115,11285,-245,-75,4258,11906
20151027,11115,11285,11150,11150,10880,11000,10970,-285,-315,3430,12070
20151028,11000,10970,10960,11090,10960,11050,11020,80,50,4330,13064
20151029,11050,11020,11000,11230,11000,11090,11100,70,80,3170,13518
20151030,11090,11100,11080,11135,11000,11015,11045,-85,-55,3500,14588
20151102,11015,11045,11000,11150,10920,11095,11075,50,30,3556,15376
20151103,11095,11075,11080,11105,10670,10685,10860,-390,-215,5866,16500
20151104,10685,10860,10685,10775,10615,10755,10690,-105,-170,5632,17180
20151105,10755,10690,10750,10860,10540,10550,10665,-140,-25,7150,18392
20151106,10550,10665,10555,10665,10500,10640,10590,-25,-75,6316,18456
20151109,10640,10590,10630,10700,10530,10660,10630,70,40,6268,18564
20151110,10660,10630,10700,10785,10550,10780,10635,150,5,9384,21382
20151111,10780,10635,10730,10785,10420,10440,10620,-195,-15,18280,27136
20151112,10440,10620,10455,10505,10315,10440,10410,-180,-210,14116,27998
20151113,10440,10410,10390,10550,10350,10500,10475,90,65,11856,26716
20151116,10500,10475,10475,10550,10205,10230,10355,-245,-120,13600,29120
20151117,10230,10355,10285,10310,10160,10225,10235,-130,-120,9472,29740
20151118,10225,10235,10260,10260,10120,10170,10185,-65,-50,7698,31030
20151119,10170,10185,10150,10255,9940,10010,10075,-175,-110,18340,32050
20151120,10010,10075,10010,10170,9960,10000,10045,-75,-30,15586,34202
20151123,10000,10045,10015,10025,9445,9480,9720,-565,-325,37078,40310
20151124,9480,9720,9550,9760,9305,9655,9490,-65,-230,38296,41802
20151125,9655,9490,9645,9820,9590,9715,9695,225,205,38110,44662
20151126,9715,9695,9685,10275,9555,9965,9945,270,250,67610,46138
20151127,9965,9945,9950,10035,9730,9765,9885,-180,-60,40986,48790
20151130,9765,9885,9750,9775,9595,9645,9650,-240,-235,31470,49800
ru1610,20151016,11960,11960,12080,12080,11660,11765,11875,-195,-85,26,4
20151019,11765,11875,11580,11610,11565,11565,11585,-310,-290,14,12
20151020,11565,11585,11355,11600,11355,11570,11560,-15,-25,50,38
20151021,11570,11560,11590,11615,11455,11455,11550,-105,-10,14,40
20151022,11455,11550,11375,11445,11310,11445,11360,-105,-190,28,36
20151023,11445,11360,11415,11495,11205,11435,11385,75,25,28,26
20151026,11435,11385,11300,11335,11215,11215,11275,-170,-110,30,44
20151027,11215,11275,11230,11230,10920,10955,10995,-320,-280,34,64
20151028,10955,10995,10980,11025,10980,11020,11005,25,10,6,66
20151029,11020,11005,11105,11200,11080,11080,11130,75,125,8,64
20151030,11080,11130,11075,11130,11075,11130,11100,0,-30,4,64
20151102,11130,11100,10990,11295,10990,11105,11120,5,20,10,66
20151103,11105,11120,11260,11260,10740,10740,10935,-380,-185,12,72
20151104,10740,10935,10690,10880,10645,10760,10740,-175,-195,18,80
20151105,10760,10740,10790,10790,10600,10600,10645,-140,-95,18,86
20151106,10600,10645,10560,10670,10560,10670,10600,25,-45,16,96
20151109,10670,10600,10680,10700,10680,10700,10690,100,90,6,96
20151110,10700,10690,10670,10670,10620,10620,10645,-70,-45,4,96
20151111,10620,10645,10775,10775,10545,10585,10745,-60,100,134,218
20151112,10585,10745,10450,10525,10265,10500,10400,-245,-345,46,220
20151113,10500,10400,10535,10605,10535,10590,10560,190,160,12,220
20151116,10590,10560,,,,10560,10560,0,0,0,220
20151117,10560,10560,10230,10260,10230,10260,10245,-300,-315,8,220
20151118,10260,10245,,,,10245,10245,0,0,0,220
20151119,10245,10245,9955,10080,9955,10030,10035,-215,-210,20,232
20151120,10030,10035,10135,10135,10035,10035,10085,0,50,4,232
20151123,10035,10085,10020,10020,9525,9525,9830,-560,-255,10,236
20151124,9525,9830,9400,9400,9400,9400,9400,-430,-430,2,236
20151125,9400,9400,9800,9800,9660,9660,9705,260,305,6,238
20151126,9660,9705,9860,10285,9860,10040,10185,335,480,1264,1240
20151127,10040,10185,9995,10040,9795,9805,9975,-380,-210,42,1238
20151130,9805,9975,9715,9715,9650,9695,9670,-280,-305,92,1240
ru1611,20151117,10560,10560,,,,10560,10560,0,0,0,0
20151118,10560,10560,10225,10240,10130,10140,10185,-420,-375,16,14
20151119,10140,10185,10140,10140,10030,10030,10080,-155,-105,6,14
20151120,10030,10080,10025,10025,10000,10000,10005,-80,-75,8,16
20151123,10000,10005,10110,10110,9480,9480,9760,-525,-245,142,120
20151124,9480,9760,9515,9685,9345,9610,9515,-150,-245,42,122
20151125,9610,9515,9665,9810,9600,9715,9710,200,195,80,150
20151126,9715,9710,9600,10280,9600,9945,9895,235,185,132,162
20151127,9945,9895,9950,10000,9760,9760,9825,-135,-70,62,164
20151130,9760,9825,9665,9680,9600,9655,9635,-170,-190,82,218
sn1507,20150327,120190,120190,120000,120010,115150,119270,119230,-920,-960,1798,608
20150330,119270,119230,119270,119530,115600,118080,117720,-1150,-1510,2468,830
20150331,118080,117720,117650,119800,115960,118160,117790,440,70,4522,1176
20150401,118160,117790,118020,118880,117070,117910,118280,120,490,4374,1272
20150402,117910,118280,117970,119080,117970,118620,118540,340,260,2716,1038
20150403,118620,118540,118810,119470,118560,118850,118950,310,410,1390,1000
20150407,118850,118950,118890,119090,118270,118860,118630,-90,-320,848,904
20150408,118860,118630,118710,118890,117150,117870,118200,-760,-430,848,750
20150409,117870,118200,117570,117980,116500,116790,117190,-1410,-1010,816,802
20150410,116790,117190,116500,116980,115320,115990,115860,-1200,-1330,2418,916
20150413,115990,115860,115960,116290,115270,115940,115750,80,-110,1628,1008
20150414,115940,115750,115550,115650,112300,112300,113680,-3450,-2070,5588,1894
20150415,112300,113680,112400,114140,112320,113850,113530,170,-150,4132,1692
20150416,113850,113530,113200,113700,111010,112880,112780,-650,-750,3866,1962
20150417,112880,112780,113010,113010,109300,110000,111110,-2780,-1670,11322,3584
20150420,110000,111110,112000,112960,111120,111440,111850,330,740,10518,2656
20150421,111440,111850,111840,111880,111100,111550,111470,-300,-380,3434,2964
20150422,111550,111470,112190,113430,112190,112940,112870,1470,1400,5870,2738
20150423,112940,112870,113400,113760,112960,113300,113430,430,560,3310,2468
20150424,113300,113430,113350,113950,112750,113940,113430,510,0,2088,2526
20150427,113940,113430,114400,117960,114400,117960,116530,4530,3100,16994,3096
20150428,117960,116530,117970,118550,116500,117400,117740,870,1210,31980,4452
20150429,117400,117740,117140,117720,115110,115370,116820,-2370,-920,10628,4638
20150430,115370,116820,116000,119900,115050,117640,117360,820,540,17782,5578
20150504,117640,117360,117360,119520,117360,118800,118830,1440,1470,8824,6072
20150505,118800,118830,119000,119780,118000,118680,118920,-150,90,12990,6392
20150506,118680,118920,119650,123670,119500,123400,122030,4480,3110,32668,8600
20150507,123400,122030,123300,125910,121500,122030,123860,0,1830,51604,7606
20150508,122030,123860,122700,122960,120020,121360,121310,-2500,-2550,22070,7344
20150511,121360,121310,120890,122690,120710,122400,121670,1090,360,13824,7580
20150512,122400,121670,121100,121930,119690,119970,121020,-1700,-650,17242,7502
20150513,119970,121020,120800,121100,120000,120700,120580,-320,-440,10418,7156
20150514,120700,120580,120700,122480,117800,119500,120460,-1080,-120,31286,7222
20150515,119500,120460,119190,119680,118610,119100,119170,-1360,-1290,11000,7396
20150518,119100,119170,118690,119940,118030,119250,119380,80,210,11708,7298
20150519,119250,119380,119520,119650,118070,118140,118920,-1240,-460,7572,6732
20150520,118140,118920,117690,117960,114160,115850,115840,-3070,-3080,27600,6122
20150521,115850,115840,116350,120400,115220,119190,118340,3350,2500,38176,6916
20150522,119190,118340,119500,119730,116900,117980,118650,-360,310,23976,6632
20150525,117980,118650,117170,119800,116800,117590,118620,-1060,-30,25734,6844
20150526,117590,118620,117600,119570,117600,118270,118860,-350,240,18802,6648
20150527,118270,118860,116760,117570,116200,116560,116870,-2300,-1990,17864,7100
20150528,116560,116870,116010,117510,115720,116960,116760,90,-110,15242,6654
20150529,116960,116760,116900,116900,115680,116160,116320,-600,-440,8976,6090
20150601,116160,116320,116090,116350,115630,116120,116010,-200,-310,4366,5706
20150602,116120,116010,116120,117000,115780,116520,116410,510,400,3880,5624
20150603,116520,116410,116740,116800,115020,115680,116380,-730,-30,3306,5472
20150604,115680,116380,115330,115900,114500,114800,115070,-1580,-1310,3252,5214
20150605,114800,115070,114640,114980,114260,114260,114570,-810,-500,1284,5218
20150608,114260,114570,113990,114940,113910,114700,114300,130,-270,2082,5128
20150609,114700,114300,114710,115600,114710,115080,115110,780,810,2204,5112
20150610,115080,115110,115340,115550,114850,115440,115200,330,90,1234,5090
20150611,115440,115200,115490,115670,115300,115420,115460,220,260,1014,4910
20150612,115420,115460,114420,114700,113520,113700,114110,-1760,-1350,3152,4014
20150615,113700,114110,113410,113660,112810,113160,113370,-950,-740,1276,3794
20150616,113160,113370,111720,112650,111700,111780,112240,-1590,-1130,1166,3668
20150617,111780,112240,111990,112230,111210,111730,111680,-510,-560,1016,3574
20150618,111730,111680,112290,112600,111820,112510,112290,830,610,768,3462
20150619,112510,112290,113010,114450,112470,113770,113520,1480,1230,1368,3422
20150623,113770,113520,113360,114330,113360,114100,114060,580,540,644,3304
20150624,114100,114060,113540,114150,112500,113180,113540,-880,-520,988,3194
20150625,113180,113540,112820,113300,109470,111460,112070,-2080,-1470,1352,3092
20150626,111460,112070,111280,111920,109800,110540,110740,-1530,-1330,1700,2948
20150629,110540,110740,109100,110800,108560,109720,110150,-1020,-590,1252,3000
20150630,109720,110150,109000,109400,105740,106000,106760,-4150,-3390,1384,2810
20150701,106000,106760,104010,107980,104010,106700,106290,-60,-470,278,2776
20150702,106700,106290,105610,109000,105610,108570,108100,2280,1810,180,2780
20150703,108570,108100,111100,111100,107080,108600,108320,500,220,212,2776
20150706,108600,108320,109820,109830,106950,106950,107870,-1370,-450,96,2752
20150707,106950,107870,107900,107910,105110,107790,106060,-80,-1810,428,2752
20150708,107790,106060,105620,105620,101810,101820,103530,-4240,-2530,272,2676
20150709,101820,103530,103310,107670,103310,107670,105710,4140,2180,108,2668
20150710,107670,105710,107000,108790,106500,107620,107980,1910,2270,184,2664
20150713,107620,107980,105000,106100,105000,106020,105740,-1960,-2240,52,2664
20150714,106020,105740,108300,108500,108100,108100,108300,2360,2560,28,2664
20150715,108100,108300,108500,108900,108100,108500,108540,200,240,100,2664
sn1508,20150327,120190,120190,116580,122780,116580,119260,119240,-930,-950,10,4
20150330,119260,119240,118000,118030,116000,117850,117230,-1390,-2010,38,8
20150331,117850,117230,,,,117300,117300,70,70,0,8
20150401,117300,117300,117770,118000,117770,118000,117840,700,540,12,14
20150402,118000,117840,,,,118100,118100,260,260,0,14
20150403,118100,118100,,,,118340,118340,240,240,0,14
20150407,118340,118340,,,,118340,118340,0,0,0,14
20150408,118340,118340,,,,118040,118040,-300,-300,0,14
20150409,118040,118040,,,,117040,117040,-1000,-1000,0,14
20150410,117040,117040,,,,116280,116280,-760,-760,0,14
20150413,116280,116280,,,,116170,116170,-110,-110,0,14
20150414,116170,116170,114760,114760,113460,113460,114110,-2710,-2060,4,16
20150415,113460,114110,,,,114100,114100,-10,-10,0,16
20150416,114100,114100,,,,113190,113190,-910,-910,0,16
20150417,113190,113190,112800,112800,110230,110230,111210,-2960,-1980,22,30
20150420,110230,111210,111470,113030,111050,111870,111960,660,750,34,24
20150421,111870,111960,111710,112230,111440,111850,111800,-110,-160,14,24
20150422,111850,111800,113200,113200,112900,112900,113110,1100,1310,8,24
20150423,112900,113110,113460,113760,113400,113760,113530,650,420,14,26
20150424,113760,113530,113580,113580,113580,113580,113580,50,50,4,26
20150427,113580,113580,115140,116720,115140,115940,116130,2360,2550,8,22
20150428,115940,116130,118550,120770,117870,118070,118560,1940,2430,40,36
20150429,118070,118560,116990,116990,116830,116830,116910,-1730,-1650,4,34
20150430,116830,116910,119000,119000,117890,117890,118460,980,1550,16,40
20150504,117890,118460,119070,119070,118660,118950,118930,490,470,34,42
20150505,118950,118930,119480,119480,118480,118480,119220,-450,290,24,50
20150506,118480,119220,120600,123980,120300,123290,122250,4070,3030,178,112
20150507,123290,122250,123000,124500,119580,120740,122800,-1510,550,300,220
20150508,120740,122800,121310,121700,119900,121700,120780,-1100,-2020,60,236
20150511,121700,120780,121530,122810,121080,122180,121710,1400,930,40,228
20150512,122180,121710,120510,121730,118290,120000,120570,-1710,-1140,58,220
20150513,120000,120570,119990,120730,119990,120230,120550,-340,-20,22,226
20150514,120230,120550,120570,121800,117980,118700,120420,-1850,-130,64,228
20150515,118700,120420,,,,119620,119620,-800,-800,0,228
20150518,119620,119620,119600,119600,119220,119540,119490,-80,-130,42,222
20150519,119540,119490,119200,119330,117690,117690,118460,-1800,-1030,36,214
20150520,117690,118460,116600,116600,114910,115220,115560,-3240,-2900,30,224
20150521,115220,115560,116520,119790,116400,118320,118060,2760,2500,138,226
20150522,118320,118060,119160,119160,116750,118020,118080,-40,20,28,228
20150525,118020,118080,117260,118600,117260,117350,117970,-730,-110,50,238
20150526,117350,117970,118390,119170,117810,117810,118360,-160,390,12,234
20150527,117810,118360,117180,117180,116640,117070,117040,-1290,-1320,158,308
20150528,117070,117040,116720,119220,116720,116760,117050,-280,10,46,296
20150529,116760,117050,116770,117000,116210,116210,116540,-840,-510,76,346
20150601,116210,116540,116490,116490,116130,116300,116280,-240,-260,54,320
20150602,116300,116280,117030,117100,116570,117100,116840,820,560,36,336
20150603,117100,116840,117480,117480,116510,116510,116940,-330,100,90,344
20150604,116510,116940,116430,118430,115680,115700,116130,-1240,-810,180,442
20150605,115700,116130,115670,115680,115200,115200,115320,-930,-810,90,496
20150608,115200,115320,114650,115410,114650,115410,114940,90,-380,46,486
20150609,115410,114940,115410,115770,115410,115700,115640,760,700,32,468
20150610,115700,115640,116340,116340,115730,115870,115970,230,330,40,482
20150611,115870,115970,116020,116250,115840,116220,116180,250,210,128,472
20150612,116220,116180,115340,115340,114210,114280,114610,-1900,-1570,50,482
20150615,114280,114610,113900,114310,113430,113430,113910,-1180,-700,18,474
20150616,113430,113910,112400,112800,112330,112350,112580,-1560,-1330,52,446
20150617,112350,112580,112400,112400,111700,112200,112000,-380,-580,110,416
20150618,112200,112000,112310,112310,112310,112310,112310,310,310,22,394
20150619,112310,112310,112950,112950,112950,112950,112950,640,640,2,394
20150623,112950,112950,112300,114000,112300,114000,113910,1050,960,42,362
20150624,114000,113910,111390,115960,111390,113420,113860,-490,-50,24,360
20150625,113420,113860,114490,115470,111600,112210,112570,-1650,-1290,250,320
20150626,112210,112570,111520,112100,111160,111160,111500,-1410,-1070,128,384
20150629,111160,111500,111100,111680,110210,110210,110840,-1290,-660,94,422
20150630,110210,110840,110050,111550,106400,107000,107820,-3840,-3020,378,414
20150701,107000,107820,107050,107700,106420,107700,107210,-120,-610,92,434
20150702,107700,107210,107970,109400,107970,109310,108910,2100,1700,70,408
20150703,109310,108910,110400,110850,109680,109680,110400,770,1490,80,424
20150706,109680,110400,107500,108360,106720,106720,107570,-3680,-2830,46,420
20150707,106720,107570,107500,107500,107500,107500,107500,-70,-70,4,424
20150708,107500,107500,103200,104380,103200,103200,103490,-4300,-4010,62,412
20150709,103200,103490,107480,107620,105210,107620,106730,4130,3240,56,400
20150710,107620,106730,109020,109020,108480,108480,108800,1750,2070,10,394
20150713,108480,108800,107140,107140,106800,106810,106860,-1990,-1940,12,390
20150714,106810,106860,108260,109000,108200,108200,108500,1340,1640,16,388
20150715,108200,108500,109990,109990,107890,108260,108750,-240,250,30,390
20150716,108260,108750,112010,112010,106810,108370,108500,-380,-250,20,386
20150717,108370,108500,,,,109270,109270,770,770,0,386
20150720,109270,109270,108680,111690,108680,110710,110940,1440,1670,102,344
20150721,110710,110940,111010,111220,110200,110450,110780,-490,-160,64,310
20150722,110450,110780,110820,110880,108090,109490,109970,-1290,-810,28,314
20150723,109490,109970,108580,108770,107910,108600,108390,-1370,-1580,26,310
20150724,108600,108390,109000,109000,108200,108260,108650,-130,260,10,310
20150727,108260,108650,107700,110790,107700,109100,108860,450,210,18,312
20150728,109100,108860,109560,109560,109560,109560,109560,700,700,6,310
20150729,109560,109560,110640,111550,109330,111500,111040,1940,1480,60,278
20150730,111500,111040,112940,112940,109030,109050,110710,-1990,-330,66,274
20150731,109050,110710,110000,110900,109000,109000,109960,-1710,-750,6,272
20150803,109000,109960,110000,110490,110000,110490,110240,530,280,8,272
20150804,110490,110240,107500,107500,107500,107500,107500,-2740,-2740,4,268
20150805,107500,107500,106110,106640,106110,106640,106280,-860,-1220,12,264
20150806,106640,106280,106000,106000,106000,106000,106000,-280,-280,4,260
20150807,106000,106000,106600,107490,106600,107000,107180,1000,1180,36,272
20150810,107000,107180,106980,107100,106650,107100,106920,-80,-260,124,264
20150811,107100,106920,108000,108600,107000,107000,108050,80,1130,44,244
20150812,107000,108050,105080,107240,105080,106500,105680,-1550,-2370,24,240
20150813,106500,105680,,,,106800,106800,1120,1120,0,240
20150814,106800,106800,105600,105600,105600,105600,105600,-1200,-1200,4,240
20150817,105600,105600,106840,106840,106210,106210,106520,610,920,8,244
sn1509,20150327,120190,120190,,,,120190,120190,0,0,0,0
20150330,120190,120190,117010,117010,117010,117010,117010,-3180,-3180,2,2
20150331,117010,117010,,,,117080,117080,70,70,0,2
20150401,117080,117080,,,,117620,117620,540,540,0,2
20150402,117620,117620,,,,117880,117880,260,260,0,2
20150403,117880,117880,,,,117880,117880,0,0,0,2
20150407,117880,117880,,,,117560,117560,-320,-320,0,2
20150408,117560,117560,121070,121080,117370,117370,119220,-190,1660,8,2
20150409,117370,119220,,,,118210,118210,-1010,-1010,0,2
20150410,118210,118210,117310,117310,114990,116480,116000,-1730,-2210,18,8
20150413,116480,116000,,,,115890,115890,-110,-110,0,8
20150414,115890,115890,,,,113830,113830,-2060,-2060,0,8
20150415,113830,113830,,,,113900,113900,70,70,0,8
20150416,113900,113900,112930,113750,111860,113750,112840,-150,-1060,6,8
20150417,113750,112840,112140,112140,112140,112140,112140,-700,-700,4,12
20150420,112140,112140,112640,112640,111700,111700,112170,-440,30,4,16
20150421,111700,112170,112060,112060,112010,112010,112030,-160,-140,4,20
20150422,112010,112030,112980,113830,112980,113830,113400,1800,1370,8,20
20150423,113830,113400,113960,114060,113960,114000,114000,600,600,6,16
20150424,114000,114000,114180,114180,114180,114180,114180,180,180,2,16
20150427,114180,114180,115440,118250,115400,116300,116580,2120,2400,10,16
20150428,116300,116580,119590,119820,118800,119070,119330,2490,2750,36,28
20150429,119070,119330,,,,117660,117660,-1670,-1670,0,28
20150430,117660,117660,118060,118060,118060,118060,118060,400,400,2,26
20150504,118060,118060,119370,119730,119370,119700,119620,1640,1560,8,22
20150505,119700,119620,117950,121870,117950,119250,119650,-370,30,50,18
20150506,119250,119650,121180,124110,121180,124110,122750,4460,3100,20,16
20150507,124110,122750,124190,125600,121880,122400,123050,-350,300,132,68
20150508,122400,123050,121570,122740,120900,122000,121790,-1050,-1260,94,94
20150511,122000,121790,122620,123410,121950,123400,122770,1610,980,62,96
20150512,123400,122770,121910,122500,120990,120990,121960,-1780,-810,130,44
20150513,120990,121960,120950,121690,120950,121360,121260,-600,-700,28,50
20150514,121360,121260,121960,122150,118300,119470,120350,-1790,-910,18,46
20150515,119470,120350,120280,120390,119840,120180,120170,-170,-180,10,50
20150518,120180,120170,120350,120440,119840,119840,120210,-330,40,6,50
20150519,119840,120210,120040,120040,120040,120040,120040,-170,-170,2,48
20150520,120040,120040,117580,117650,116630,116920,117080,-3120,-2960,30,44
20150521,116920,117080,117390,119960,117390,119730,119050,2650,1970,70,68
20150522,119730,119050,119570,120280,119540,120250,119880,1200,830,10,68
20150525,120250,119880,119030,119060,117790,119060,118830,-820,-1050,18,72
20150526,119060,118830,119600,120420,119090,119290,119650,460,820,78,124
20150527,119290,119650,117830,118240,116810,117500,117570,-2150,-2080,128,154
20150528,117500,117570,117670,117930,117020,117330,117360,-240,-210,210,174
20150529,117330,117360,117330,117370,116810,116860,117040,-500,-320,144,154
20150601,116860,117040,117020,117320,116570,117100,116850,60,-190,92,182
20150602,117100,116850,117480,118040,117480,117840,117830,990,980,314,360
20150603,117840,117830,118190,118680,116400,116980,117510,-850,-320,504,290
20150604,116980,117510,116980,117430,116140,116140,116830,-1370,-680,322,318
20150605,116140,116830,116250,116250,115530,116200,115940,-630,-890,136,344
20150608,116200,115940,115740,116180,115210,116180,115570,240,-370,150,358
20150609,116180,115570,115730,116650,115610,116130,116280,560,710,256,372
20150610,116130,116280,116500,116560,116100,116420,116370,140,90,196,414
20150611,116420,116370,116880,116890,116110,116500,116470,130,100,190,464
20150612,116500,116470,115640,115990,114000,114110,114820,-2360,-1650,562,734
20150615,114110,114820,112510,114250,112510,113350,113820,-1470,-1000,192,736
20150616,113350,113820,112800,113180,112000,112160,112600,-1660,-1220,864,966
20150617,112160,112600,112360,112400,111310,111810,111930,-790,-670,340,1008
20150618,111810,111930,112440,113030,111920,112620,112530,690,600,182,988
20150619,112620,112530,112890,114500,112500,113930,113810,1400,1280,410,978
20150623,113930,113810,114110,115290,113960,115010,114570,1200,760,298,1014
20150624,115010,114570,114210,114870,113810,114790,114480,220,-90,310,1016
20150625,114790,114480,114700,115320,112600,112840,113670,-1640,-810,574,1074
20150626,112840,113670,112000,112950,111860,112160,112290,-1510,-1380,1160,1532
20150629,112160,112290,112160,112700,110720,111320,111870,-970,-420,1550,1996
20150630,111320,111870,109710,111150,107390,107530,108600,-4340,-3270,2832,2534
20150701,107530,108600,107300,108680,106240,108260,107730,-340,-870,2858,2930
20150702,108260,107730,109800,109990,108560,109700,109390,1970,1660,2598,2810
20150703,109700,109390,110370,111140,109390,110000,110490,610,1100,2348,2900
20150706,110000,110490,107960,109850,106510,107090,107880,-3400,-2610,2102,2884
20150707,107090,107880,108500,109190,106800,107080,108040,-800,160,2356,2794
20150708,107080,108040,106000,106430,103710,103710,104200,-4330,-3840,3870,2882
20150709,103710,104200,104670,110020,104010,107800,106840,3600,2640,3426,2426
20150710,107800,106840,108200,110440,106580,107840,108820,1000,1980,3844,2666
20150713,107840,108820,107750,108500,106900,107530,107610,-1290,-1210,2170,2586
20150714,107530,107610,108000,110490,108000,108800,109270,1190,1660,2830,2336
20150715,108800,109270,109030,110300,108270,109690,109200,420,-70,2168,2256
20150716,109690,109200,109880,110220,108120,109350,109030,150,-170,1928,2220
20150717,109350,109030,109520,110790,109320,110490,110060,1460,1030,2288,2314
20150720,110490,110060,112400,112490,111100,111530,111720,1470,1660,6298,2316
20150721,111530,111720,111860,111860,110790,111000,111230,-720,-490,3266,2140
20150722,111000,111230,110780,111190,108560,108800,110310,-2430,-920,2200,2098
20150723,108800,110310,108250,108940,108060,108940,108560,-1370,-1750,1550,2130
20150724,108940,108560,109200,109490,108120,108210,108830,-350,270,1462,2078
20150727,108210,108830,108280,111400,107030,108170,109280,-660,450,3556,2084
20150728,108170,109280,108400,109940,107920,109820,108890,540,-390,1906,2068
20150729,109820,108890,110980,112360,110800,111770,111540,2880,2650,3144,2024
20150730,111770,111540,111260,111780,110120,110180,111150,-1360,-390,2828,1958
20150731,110180,111150,109600,111140,109280,109960,110440,-1190,-710,1278,1960
20150803,109960,110440,110440,111370,108720,108720,110600,-1720,160,1688,1906
20150804,108720,110600,107800,108860,107500,108750,108400,-1850,-2200,1578,1744
20150805,108750,108400,108900,109190,106900,107490,107900,-910,-500,1078,1792
20150806,107490,107900,107500,108480,106390,107350,107140,-550,-760,1482,1736
20150807,107350,107140,107600,108080,106790,107410,107340,270,200,810,1680
20150810,107410,107340,107100,107960,106510,107810,107220,470,-120,816,1590
20150811,107810,107220,107400,111350,107260,108490,108920,1270,1700,1200,1506
20150812,108490,108920,108100,108620,107070,108400,107680,-520,-1240,1104,1536
20150813,108400,107680,108620,109320,107500,107790,108380,110,700,1550,1476
20150814,107790,108380,107620,108210,107200,107200,107770,-1180,-610,610,1458
20150817,107200,107770,109200,109200,107060,107390,107900,-380,130,950,1512
20150818,107390,107900,107330,107770,106800,107160,107240,-740,-660,562,1526
20150819,107160,107240,106710,107360,106550,107280,106980,40,-260,760,1364
20150820,107280,106980,107560,108680,106680,106940,107270,-40,290,576,1280
20150821,106940,107270,107100,107450,105310,105380,106230,-1890,-1040,712,1288
20150824,105380,106230,104000,105790,101980,101980,103690,-4250,-2540,1358,1264
20150825,101980,103690,100050,101580,100010,100760,100840,-2930,-2850,782,1196
20150826,100760,100840,100710,102040,100210,100210,101170,-630,330,566,1104
20150827,100210,101170,99580,100460,98210,100110,99770,-1060,-1400,478,1060
20150828,100110,99770,100090,102980,99610,101000,101420,1230,1650,1190,1028
20150831,101000,101420,101000,102090,99210,99500,100470,-1920,-950,690,916
20150901,99500,100470,100490,100500,99510,99820,100030,-650,-440,76,880
20150902,99820,100030,100500,100580,97210,99600,99280,-430,-750,156,868
20150907,99600,99280,100000,100000,97630,100000,99750,720,470,104,796
20150908,100000,99750,98240,100150,98240,100150,99400,400,-350,76,760
20150909,100150,99400,101570,102200,100000,100400,100850,1000,1450,68,756
20150910,100400,100850,100020,101000,99530,101000,100460,150,-390,256,644
20150911,101000,100460,101500,102990,101500,101600,102030,1140,1570,96,592
20150914,101600,102030,99560,101010,99560,100130,100420,-1900,-1610,16,592
20150915,100130,100420,98020,100500,98020,99600,99810,-820,-610,32,600
sn1510,20150327,120190,120190,120200,122580,117000,120190,119680,0,-510,14,6
20150330,120190,119680,117730,117730,117730,117730,117730,-1950,-1950,2,6
20150331,117730,117730,,,,117800,117800,70,70,0,6
20150401,117800,117800,118500,118500,118500,118500,118500,700,700,2,6
20150402,118500,118500,118700,118700,118480,118480,118650,-20,150,10,8
20150403,118480,118650,,,,118650,118650,0,0,0,8
20150407,118650,118650,,,,118330,118330,-320,-320,0,8
20150408,118330,118330,,,,120000,120000,1670,1670,0,8
20150409,120000,120000,117960,117960,117960,117960,117960,-2040,-2040,4,4
20150410,117960,117960,117360,117360,117360,117360,117360,-600,-600,2,6
20150413,117360,117360,,,,117250,117250,-110,-110,0,6
20150414,117250,117250,115240,115240,115240,115240,115240,-2010,-2010,2,8
20150415,115240,115240,,,,115080,115080,-160,-160,0,8
20150416,115080,115080,115090,115090,115090,115090,115090,10,10,2,8
20150417,115090,115090,112850,114130,111330,111550,112260,-3540,-2830,16,16
20150420,111550,112260,112340,113460,112310,113460,112780,1200,520,10,20
20150421,113460,112780,112220,113300,112220,113300,112760,520,-20,4,20
20150422,113300,112760,113870,113870,113470,113470,113670,710,910,4,20
20150423,113470,113670,113500,114000,113500,114000,113750,330,80,4,18
20150424,114000,113750,114000,114990,114000,114990,114630,1240,880,6,14
20150427,114990,114630,118530,119090,115000,119090,117360,4460,2730,14,16
20150428,119090,117360,120660,120660,118010,119990,119490,2630,2130,22,10
20150429,119990,119490,120160,120160,116010,116010,118080,-3480,-1410,4,10
20150430,116010,118080,,,,118080,118080,0,0,0,10
20150504,118080,118080,118470,118470,118470,118470,118470,390,390,2,8
20150505,118470,118470,116740,116740,116740,116740,116740,-1730,-1730,4,8
20150506,116740,116740,120680,121400,120680,121400,121040,4660,4300,4,8
20150507,121400,121040,,,,121340,121340,300,300,0,8
20150508,121340,121340,122060,122310,122060,122310,122180,970,840,4,8
20150511,122310,122180,,,,123160,123160,980,980,0,8
20150512,123160,123160,,,,122340,122340,-820,-820,0,8
20150513,122340,122340,,,,122340,122340,0,0,0,8
20150514,122340,122340,,,,122170,122170,-170,-170,0,8
20150515,122170,122170,,,,121980,121980,-190,-190,0,8
20150518,121980,121980,,,,122020,122020,40,40,0,8
20150519,122020,122020,,,,121840,121840,-180,-180,0,8
20150520,121840,121840,116960,118170,116960,118170,117440,-3670,-4400,16,16
20150521,118170,117440,,,,119420,119420,1980,1980,0,16
20150522,119420,119420,,,,120250,120250,830,830,0,16
20150525,120250,120250,,,,119200,119200,-1050,-1050,0,16
20150526,119200,119200,,,,120030,120030,830,830,0,16
20150527,120030,120030,,,,117940,117940,-2090,-2090,0,16
20150528,117940,117940,117530,118010,117530,118010,117850,70,-90,6,14
20150529,118010,117850,,,,117850,117850,0,0,0,14
20150601,117850,117850,,,,117660,117660,-190,-190,0,14
20150602,117660,117660,,,,118650,118650,990,990,0,14
20150603,118650,118650,,,,118330,118330,-320,-320,0,14
20150604,118330,118330,,,,117650,117650,-680,-680,0,14
20150605,117650,117650,117010,117010,116910,116910,116960,-740,-690,4,14
20150608,116910,116960,,,,116590,116590,-370,-370,0,14
20150609,116590,116590,117220,117220,117220,117220,117220,630,630,2,14
20150610,117220,117220,117220,117220,117010,117010,117050,-210,-170,10,16
20150611,117010,117050,,,,117050,117050,0,0,0,16
20150612,117050,117050,,,,117050,117050,0,0,0,16
20150615,117050,117050,,,,117050,117050,0,0,0,16
20150616,117050,117050,114690,114690,114000,114000,114460,-3050,-2590,6,16
20150617,114000,114460,113490,113490,113000,113010,113170,-1450,-1290,14,18
20150618,113010,113170,113530,113530,113530,113530,113530,360,360,2,20
20150619,113530,113530,,,,113700,113700,170,170,0,20
20150623,113700,113700,,,,113700,113700,0,0,0,20
20150624,113700,113700,,,,113610,113610,-90,-90,0,20
20150625,113610,113610,,,,112800,112800,-810,-810,0,20
20150626,112800,112800,112900,113680,112820,113400,113080,600,280,26,34
20150629,113400,113080,113500,113500,112310,112310,112620,-770,-460,24,50
20150630,112310,112620,112640,112640,108300,109000,109550,-3620,-3070,148,124
20150701,109000,109550,109190,109190,106860,108030,108690,-1520,-860,78,170
20150702,108030,108690,110260,110260,110260,110260,110260,1570,1570,2,170
20150703,110260,110260,,,,110260,110260,0,0,0,170
20150706,110260,110260,,,,110260,110260,0,0,0,170
20150707,110260,110260,108810,108810,108810,108810,108810,-1450,-1450,2,172
20150708,108810,108810,105670,105670,105220,105470,105560,-3340,-3250,12,168
20150709,105470,105560,106060,106820,106010,106820,106320,1260,760,10,168
20150710,106820,106320,107610,107610,107610,107610,107610,1290,1290,2,166
20150713,107610,107610,108540,108540,108540,108540,108540,930,930,4,170
20150714,108540,108540,,,,110210,110210,1670,1670,0,170
20150715,110210,110210,,,,110140,110140,-70,-70,0,170
20150716,110140,110140,110100,110100,109410,110050,109850,-90,-290,6,172
20150717,110050,109850,110990,110990,110940,110940,110950,1090,1100,10,182
20150720,110940,110950,112990,112990,111900,111900,112440,950,1490,4,184
20150721,111900,112440,,,,111950,111950,-490,-490,0,184
20150722,111950,111950,111260,111590,111060,111590,111300,-360,-650,6,186
20150723,111590,111300,108360,109940,108360,109300,109330,-2000,-1970,36,202
20150724,109300,109330,,,,109600,109600,270,270,0,202
20150727,109600,109600,109500,110700,109370,109370,109860,-230,260,30,208
20150728,109370,109860,109500,109500,109140,109140,109260,-720,-600,6,208
20150729,109140,109260,111310,112080,111300,111600,111520,2340,2260,40,194
20150730,111600,111520,111600,111600,110680,110680,111310,-840,-210,14,200
20150731,110680,111310,,,,110600,110600,-710,-710,0,200
20150803,110600,110600,111010,111010,110100,110300,110590,-300,-10,46,204
20150804,110300,110590,108100,109790,107510,108790,108550,-1800,-2040,80,220
20150805,108790,108550,110510,110510,107900,109760,109040,1210,490,28,238
20150806,109760,109040,108110,108180,106540,107910,107810,-1130,-1230,54,268
20150807,107910,107810,108390,108390,107500,107950,107890,140,80,20,266
20150810,107950,107890,107120,107820,107120,107820,107430,-70,-460,12,264
20150811,107820,107430,108990,109800,108340,108990,108780,1560,1350,44,252
20150812,108990,108780,108000,108780,107770,108300,107980,-480,-800,42,270
20150813,108300,107980,110850,110850,107940,107940,108400,-40,420,18,276
20150814,107940,108400,,,,108400,108400,0,0,0,276
20150817,108400,108400,108200,108880,107850,107850,108090,-550,-310,14,284
20150818,107850,108090,107600,108490,107500,107700,107950,-390,-140,10,286
20150819,107700,107950,107120,107120,107120,107120,107120,-830,-830,2,288
20150820,107120,107120,108050,108340,107000,108020,107940,900,820,24,288
20150821,108020,107940,107480,108020,104150,105030,105630,-2910,-2310,58,306
20150824,105030,105630,104500,105500,101720,102250,103350,-3380,-2280,76,310
20150825,102250,103350,100840,102000,100000,101000,101090,-2350,-2260,36,306
20150826,101000,101090,101500,101800,101000,101300,101510,210,420,30,316
20150827,101300,101510,100800,101200,99510,99510,100560,-2000,-950,34,328
20150828,99510,100560,101490,102800,99500,101400,101630,840,1070,208,338
20150831,101400,101630,100200,101980,100000,101030,100820,-600,-810,208,418
20150901,101030,100820,101020,101030,100000,100010,100290,-810,-530,36,428
20150902,100010,100290,100980,100980,99710,99710,100280,-580,-10,26,430
20150907,99710,100280,99250,101130,99250,100570,100320,290,40,38,444
20150908,100570,100320,100580,101500,99640,101500,100080,1180,-240,108,494
20150909,101500,100080,100910,103500,100400,100870,101640,790,1560,534,574
20150910,100870,101640,101700,101940,100020,101180,101120,-460,-520,398,592
20150911,101180,101120,103780,103850,101300,101680,102010,560,890,126,564
20150914,101680,102010,101510,102210,100700,100970,101370,-1040,-640,98,576
20150915,100970,101370,100410,101000,100050,100110,100600,-1260,-770,130,598
20150916,100110,100600,100500,101300,100230,100730,100730,130,130,170,598
20150917,100730,100730,101460,101470,100750,100800,100920,70,190,126,598
20150918,100800,100920,101140,101240,100600,100600,101030,-320,110,72,602
20150921,100600,101030,100030,100050,98410,99310,99380,-1720,-1650,172,596
20150922,99310,99380,99000,99000,98520,98520,98750,-860,-630,74,590
20150923,98520,98750,98520,98520,97020,98000,97810,-750,-940,106,572
20150924,98000,97810,97620,98290,97380,98290,97770,480,-40,28,576
20150925,98290,97770,98000,98190,97800,98190,98070,420,300,98,598
20150928,98190,98070,97070,97070,94970,96200,95930,-1870,-2140,336,528
20150929,96200,95930,95890,96490,95550,95800,95840,-130,-90,108,466
20150930,95800,95840,95800,96930,95800,96000,96250,160,410,88,448
20151008,96000,96250,97200,97200,96690,96690,96910,440,660,20,436
20151009,96690,96910,96580,97600,95150,97400,96800,490,-110,132,448
20151012,97400,96800,97400,97700,97000,97500,97230,700,430,136,496
20151013,97500,97230,97500,98000,97500,98000,97770,770,540,40,528
20151014,98000,97770,,,,97200,97200,-570,-570,0,528
20151015,97200,97200,96000,96000,96000,96000,96000,-1200,-1200,72,456
sn1511,20150327,120190,120190,,,,120190,120190,0,0,0,0
20150330,120190,120190,,,,118230,118230,-1960,-1960,0,0
20150331,118230,118230,,,,118300,118300,70,70,0,0
20150401,118300,118300,,,,119000,119000,700,700,0,0
20150402,119000,119000,,,,119150,119150,150,150,0,0
20150403,119150,119150,,,,119560,119560,410,410,0,0
20150407,119560,119560,,,,119230,119230,-330,-330,0,0
20150408,119230,119230,,,,120910,120910,1680,1680,0,0
20150409,120910,120910,,,,118850,118850,-2060,-2060,0,0
20150410,118850,118850,,,,118240,118240,-610,-610,0,0
20150413,118240,118240,,,,118130,118130,-110,-110,0,0
20150414,118130,118130,,,,116100,116100,-2030,-2030,0,0
20150415,116100,116100,,,,115940,115940,-160,-160,0,0
20150416,115940,115940,,,,115950,115950,10,10,0,0
20150417,115950,115950,,,,113100,113100,-2850,-2850,0,0
20150420,113100,113100,,,,113620,113620,520,520,0,0
20150421,113620,113620,,,,113590,113590,-30,-30,0,0
20150422,113590,113590,,,,114500,114500,910,910,0,0
20150423,114500,114500,,,,114580,114580,80,80,0,0
20150424,114580,114580,,,,115460,115460,880,880,0,0
20150427,115460,115460,,,,118210,118210,2750,2750,0,0
20150428,118210,118210,,,,120350,120350,2140,2140,0,0
20150429,120350,120350,,,,120350,120350,0,0,0,0
20150430,120350,120350,,,,120750,120750,400,400,0,0
20150504,120750,120750,,,,121140,121140,390,390,0,0
20150505,121140,121140,,,,119370,119370,-1770,-1770,0,0
20150506,119370,119370,,,,123760,123760,4390,4390,0,0
20150507,123760,123760,,,,124070,124070,310,310,0,0
20150508,124070,124070,,,,124930,124930,860,860,0,0
20150511,124930,124930,,,,125940,125940,1010,1010,0,0
20150512,125940,125940,,,,125100,125100,-840,-840,0,0
20150513,125100,125100,,,,124380,124380,-720,-720,0,0
20150514,124380,124380,,,,123440,123440,-940,-940,0,0
20150515,123440,123440,,,,123250,123250,-190,-190,0,0
20150518,123250,123250,,,,123290,123290,40,40,0,0
20150519,123290,123290,,,,123110,123110,-180,-180,0,0
20150520,123110,123110,,,,119500,119500,-3610,-3610,0,0
20150521,119500,119500,,,,121510,121510,2010,2010,0,0
20150522,121510,121510,,,,122360,122360,850,850,0,0
20150525,122360,122360,,,,121290,121290,-1070,-1070,0,0
20150526,121290,121290,,,,122130,122130,840,840,0,0
20150527,122130,122130,,,,120000,120000,-2130,-2130,0,0
20150528,120000,120000,,,,119900,119900,-100,-100,0,0
20150529,119900,119900,,,,119570,119570,-330,-330,0,0
20150601,119570,119570,,,,119380,119380,-190,-190,0,0
20150602,119380,119380,,,,120380,120380,1000,1000,0,0
20150603,120380,120380,,,,120380,120380,0,0,0,0
20150604,120380,120380,119500,119500,114010,114010,116750,-6370,-3630,16,4
20150605,114010,116750,,,,116060,116060,-690,-690,0,4
20150608,116060,116060,,,,115690,115690,-370,-370,0,4
20150609,115690,115690,,,,116310,116310,620,620,0,4
20150610,116310,116310,,,,116140,116140,-170,-170,0,4
20150611,116140,116140,,,,116140,116140,0,0,0,4
20150612,116140,116140,,,,116140,116140,0,0,0,4
20150615,116140,116140,,,,115130,115130,-1010,-1010,0,4
20150616,115130,115130,,,,115130,115130,0,0,0,4
20150617,115130,115130,,,,113830,113830,-1300,-1300,0,4
20150618,113830,113830,,,,113830,113830,0,0,0,4
20150619,113830,113830,116000,116000,116000,116000,116000,2170,2170,2,4
20150623,116000,116000,,,,116000,116000,0,0,0,4
20150624,116000,116000,,,,116000,116000,0,0,0,4
20150625,116000,116000,114920,114920,114920,114920,114920,-1080,-1080,2,4
20150626,114920,114920,,,,114920,114920,0,0,0,4
20150629,114920,114920,,,,114690,114690,-230,-230,0,4
20150630,114690,114690,111300,111300,110100,110100,110220,-4590,-4470,20,18
20150701,110100,110220,108900,110120,108900,109000,109600,-1220,-620,30,30
20150702,109000,109600,110290,110480,108920,110020,109870,420,270,14,28
20150703,110020,109870,,,,110200,110200,330,330,0,28
20150706,110200,110200,,,,110200,110200,0,0,0,28
20150707,110200,110200,,,,108750,108750,-1450,-1450,0,28
20150708,108750,108750,104400,104400,104400,104400,104400,-4350,-4350,4,28
20150709,104400,104400,,,,108570,108570,4170,4170,0,28
20150710,108570,108570,107750,107750,107750,107750,107750,-820,-820,2,28
20150713,107750,107750,,,,108680,108680,930,930,0,28
20150714,108680,108680,,,,110350,110350,1670,1670,0,28
20150715,110350,110350,,,,110280,110280,-70,-70,0,28
20150716,110280,110280,,,,109990,109990,-290,-290,0,28
20150717,109990,109990,,,,110000,110000,10,10,0,28
20150720,110000,110000,,,,111400,111400,1400,1400,0,28
20150721,111400,111400,,,,110910,110910,-490,-490,0,28
20150722,110910,110910,,,,110910,110910,0,0,0,28
20150723,110910,110910,,,,110910,110910,0,0,0,28
20150724,110910,110910,,,,110910,110910,0,0,0,28
20150727,110910,110910,,,,111170,111170,260,260,0,28
20150728,111170,111170,,,,111170,111170,0,0,0,28
20150729,111170,111170,,,,111170,111170,0,0,0,28
20150730,111170,111170,,,,110960,110960,-210,-210,0,28
20150731,110960,110960,,,,110960,110960,0,0,0,28
20150803,110960,110960,,,,110950,110950,-10,-10,0,28
20150804,110950,110950,109660,109660,109660,109660,109660,-1290,-1290,2,28
20150805,109660,109660,,,,110160,110160,500,500,0,28
20150806,110160,110160,108600,108700,108500,108500,108600,-1660,-1560,6,30
20150807,108500,108600,109130,109130,108180,108180,108570,-420,-30,8,30
20150810,108180,108570,,,,108570,108570,0,0,0,30
20150811,108570,108570,109020,109020,109020,109020,109020,450,450,2,28
20150812,109020,109020,,,,109020,109020,0,0,0,28
20150813,109020,109020,,,,109020,109020,0,0,0,28
20150814,109020,109020,,,,109020,109020,0,0,0,28
20150817,109020,109020,,,,109020,109020,0,0,0,28
20150818,109020,109020,,,,109020,109020,0,0,0,28
20150819,109020,109020,,,,108180,108180,-840,-840,0,28
20150820,108180,108180,,,,109010,109010,830,830,0,28
20150821,109010,109010,,,,107980,107980,-1030,-1030,0,28
20150824,107980,107980,,,,105650,105650,-2330,-2330,0,28
20150825,105650,105650,,,,103340,103340,-2310,-2310,0,28
20150826,103340,103340,,,,102390,102390,-950,-950,0,28
20150827,102390,102390,,,,101790,101790,-600,-600,0,28
20150828,101790,101790,,,,101790,101790,0,0,0,28
20150831,101790,101790,,,,101790,101790,0,0,0,28
20150901,101790,101790,,,,101790,101790,0,0,0,28
20150902,101790,101790,,,,101790,101790,0,0,0,28
20150907,101790,101790,,,,101830,101830,40,40,0,28
20150908,101830,101830,,,,101580,101580,-250,-250,0,28
20150909,101580,101580,,,,103160,103160,1580,1580,0,28
20150910,103160,103160,,,,102900,102900,-260,-260,0,28
20150911,102900,102900,,,,102900,102900,0,0,0,28
20150914,102900,102900,,,,102250,102250,-650,-650,0,28
20150915,102250,102250,,,,101200,101200,-1050,-1050,0,28
20150916,101200,101200,,,,101200,101200,0,0,0,28
20150917,101200,101200,,,,101200,101200,0,0,0,28
20150918,101200,101200,,,,101200,101200,0,0,0,28
20150921,101200,101200,,,,100600,100600,-600,-600,0,28
20150922,100600,100600,,,,99800,99800,-800,-800,0,28
20150923,99800,99800,,,,98450,98450,-1350,-1350,0,28
20150924,98450,98450,,,,98450,98450,0,0,0,28
20150925,98450,98450,,,,98450,98450,0,0,0,28
20150928,98450,98450,,,,97500,97500,-950,-950,0,28
20150929,97500,97500,,,,97000,97000,-500,-500,0,28
20150930,97000,97000,94520,96990,94520,96250,95920,-750,-1080,6,30
20151008,96250,95920,,,,95920,95920,0,0,0,30
20151009,95920,95920,,,,96200,96200,280,280,0,30
20151012,96200,96200,96650,97490,96650,97490,97070,1290,870,4,28
20151013,97490,97070,,,,97070,97070,0,0,0,28
20151014,97070,97070,96000,96000,96000,96000,96000,-1070,-1070,2,26
20151015,96000,96000,97500,98100,97500,98100,97820,2100,1820,12,26
20151016,98100,97820,,,,97820,97820,0,0,0,26
20151019,97820,97820,,,,97800,97800,-20,-20,0,26
20151020,97800,97800,,,,97800,97800,0,0,0,26
20151021,97800,97800,97000,97790,97000,97200,97220,-600,-580,58,64
20151022,97200,97220,,,,97220,97220,0,0,0,64
20151023,97220,97220,,,,97220,97220,0,0,0,64
20151026,97220,97220,96000,96000,96000,96000,96000,-1220,-1220,22,64
20151027,96000,96000,96000,96000,96000,96000,96000,0,0,22,64
20151028,96000,96000,94100,94100,94100,94100,94100,-1900,-1900,10,64
20151029,94100,94100,,,,94100,94100,0,0,0,64
20151030,94100,94100,92200,92200,92000,92000,92130,-2100,-1970,6,64
20151102,92000,92130,,,,92130,92130,0,0,0,64
20151103,92130,92130,,,,92130,92130,0,0,0,64
20151104,92130,92130,,,,92130,92130,0,0,0,64
20151105,92130,92130,,,,92130,92130,0,0,0,64
20151106,92130,92130,,,,92130,92130,0,0,0,64
20151109,92130,92130,,,,91700,91700,-430,-430,0,64
20151110,91700,91700,,,,91700,91700,0,0,0,64
20151111,91700,91700,,,,91700,91700,0,0,0,64
20151112,91700,91700,,,,91700,91700,0,0,0,64
20151113,91700,91700,,,,91700,91700,0,0,0,64
20151116,91700,91700,,,,90000,90000,-1700,-1700,0,64
sn1512,20150327,120190,120190,,,,120190,120190,0,0,0,0
20150330,120190,120190,,,,118230,118230,-1960,-1960,0,0
20150331,118230,118230,,,,118300,118300,70,70,0,0
20150401,118300,118300,,,,119000,119000,700,700,0,0
20150402,119000,119000,,,,119150,119150,150,150,0,0
20150403,119150,119150,121280,121280,116680,116680,118980,-2470,-170,4,2
20150407,116680,118980,,,,118660,118660,-320,-320,0,2
20150408,118660,118660,,,,120340,120340,1680,1680,0,2
20150409,120340,120340,,,,118290,118290,-2050,-2050,0,2
20150410,118290,118290,,,,117680,117680,-610,-610,0,2
20150413,117680,117680,,,,117570,117570,-110,-110,0,2
20150414,117570,117570,,,,115550,115550,-2020,-2020,0,2
20150415,115550,115550,,,,115390,115390,-160,-160,0,2
20150416,115390,115390,,,,115400,115400,10,10,0,2
20150417,115400,115400,,,,112560,112560,-2840,-2840,0,2
20150420,112560,112560,,,,113080,113080,520,520,0,2
20150421,113080,113080,,,,113050,113050,-30,-30,0,2
20150422,113050,113050,,,,113960,113960,910,910,0,2
20150423,113960,113960,,,,114040,114040,80,80,0,2
20150424,114040,114040,,,,114920,114920,880,880,0,2
20150427,114920,114920,,,,117660,117660,2740,2740,0,2
20150428,117660,117660,,,,119790,119790,2130,2130,0,2
20150429,119790,119790,,,,118380,118380,-1410,-1410,0,2
20150430,118380,118380,,,,118780,118780,400,400,0,2
20150504,118780,118780,,,,119170,119170,390,390,0,2
20150505,119170,119170,121270,121270,117640,118590,119480,-580,310,12,2
20150506,118590,119480,,,,123880,123880,4400,4400,0,2
20150507,123880,123880,,,,124190,124190,310,310,0,2
20150508,124190,124190,,,,125050,125050,860,860,0,2
20150511,125050,125050,125300,125300,125300,125300,125300,250,250,2,4
20150512,125300,125300,123140,123140,120360,121810,121760,-3490,-3540,12,6
20150513,121810,121760,,,,121060,121060,-700,-700,0,6
20150514,121060,121060,,,,120150,120150,-910,-910,0,6
20150515,120150,120150,,,,119970,119970,-180,-180,0,6
20150518,119970,119970,,,,120000,120000,30,30,0,6
20150519,120000,120000,,,,119830,119830,-170,-170,0,6
20150520,119830,119830,,,,115500,115500,-4330,-4330,0,6
20150521,115500,115500,,,,117440,117440,1940,1940,0,6
20150522,117440,117440,,,,118260,118260,820,820,0,6
20150525,118260,118260,120120,122990,120120,122990,121550,4730,3290,4,6
20150526,122990,121550,125450,125450,120780,120780,123110,-770,1560,4,6
20150527,120780,123110,,,,120970,120970,-2140,-2140,0,6
20150528,120970,120970,,,,120970,120970,0,0,0,6
20150529,120970,120970,,,,120640,120640,-330,-330,0,6
20150601,120640,120640,,,,120450,120450,-190,-190,0,6
20150602,120450,120450,,,,120450,120450,0,0,0,6
20150603,120450,120450,,,,120450,120450,0,0,0,6
20150604,120450,120450,,,,116820,116820,-3630,-3630,0,6
20150605,116820,116820,119710,119710,119710,119710,119710,2890,2890,6,10
20150608,119710,119710,,,,119710,119710,0,0,0,10
20150609,119710,119710,,,,120350,120350,640,640,0,10
20150610,120350,120350,,,,120170,120170,-180,-180,0,10
20150611,120170,120170,,,,120170,120170,0,0,0,10
20150612,120170,120170,,,,118500,118500,-1670,-1670,0,10
20150615,118500,118500,,,,118380,118380,-120,-120,0,10
20150616,118380,118380,,,,117000,117000,-1380,-1380,0,10
20150617,117000,117000,,,,116240,116240,-760,-760,0,10
20150618,116240,116240,,,,116000,116000,-240,-240,0,10
20150619,116000,116000,115800,115800,115800,115800,115800,-200,-200,2,10
20150623,115800,115800,119000,119000,115010,115020,116910,-780,1110,16,12
20150624,115020,116910,118560,118560,115250,115250,116900,-1660,-10,4,12
20150625,115250,116900,115480,115480,115480,115480,115480,-1420,-1420,2,12
20150626,115480,115480,115580,115580,115580,115580,115580,100,100,2,10
20150629,115580,115580,,,,115580,115580,0,0,0,10
20150630,115580,115580,111400,111980,111400,111980,111830,-3600,-3750,8,16
20150701,111980,111830,110840,112510,109510,110600,110500,-1230,-1330,18,20
20150702,110600,110500,,,,110500,110500,0,0,0,20
20150703,110500,110500,,,,110500,110500,0,0,0,20
20150706,110500,110500,,,,110500,110500,0,0,0,20
20150707,110500,110500,,,,110500,110500,0,0,0,20
20150708,110500,110500,107700,107700,106080,106080,106890,-4420,-3610,4,20
20150709,106080,106890,103650,111160,103650,111160,105940,4270,-950,16,12
20150710,111160,105940,,,,105130,105130,-810,-810,0,12
20150713,105130,105130,,,,106030,106030,900,900,0,12
20150714,106030,106030,,,,107660,107660,1630,1630,0,12
20150715,107660,107660,,,,107590,107590,-70,-70,0,12
20150716,107590,107590,,,,107300,107300,-290,-290,0,12
20150717,107300,107300,,,,108370,108370,1070,1070,0,12
20150720,108370,108370,,,,109830,109830,1460,1460,0,12
20150721,109830,109830,,,,109350,109350,-480,-480,0,12
20150722,109350,109350,,,,109350,109350,0,0,0,12
20150723,109350,109350,,,,107420,107420,-1930,-1930,0,12
20150724,107420,107420,111710,111710,106870,106870,111010,-550,3590,14,14
20150727,106870,111010,,,,111010,111010,0,0,0,14
20150728,111010,111010,,,,111010,111010,0,0,0,14
20150729,111010,111010,,,,111010,111010,0,0,0,14
20150730,111010,111010,,,,110800,110800,-210,-210,0,14
20150731,110800,110800,108280,108280,108280,108280,108280,-2520,-2520,2,14
20150803,108280,108280,112610,112610,112610,112610,112610,4330,4330,2,12
20150804,112610,112610,,,,112290,112290,-320,-320,0,12
20150805,112290,112290,,,,112290,112290,0,0,0,12
20150806,112290,112290,,,,110690,110690,-1600,-1600,0,12
20150807,110690,110690,,,,110660,110660,-30,-30,0,12
20150810,110660,110660,,,,109800,109800,-860,-860,0,12
20150811,109800,109800,,,,109800,109800,0,0,0,12
20150812,109800,109800,,,,108990,108990,-810,-810,0,12
20150813,108990,108990,,,,109420,109420,430,430,0,12
20150814,109420,109420,,,,108800,108800,-620,-620,0,12
20150817,108800,108800,,,,108490,108490,-310,-310,0,12
20150818,108490,108490,,,,108350,108350,-140,-140,0,12
20150819,108350,108350,,,,107510,107510,-840,-840,0,12
20150820,107510,107510,,,,108330,108330,820,820,0,12
20150821,108330,108330,104960,107800,104960,107030,106710,-1300,-1620,12,10
20150824,107030,106710,,,,105150,105150,-1560,-1560,0,10
20150825,105150,105150,103820,103820,103820,103820,103820,-1330,-1330,2,10
20150826,103820,103820,,,,104250,104250,430,430,0,10
20150827,104250,104250,100090,100090,100090,100090,100090,-4160,-4160,2,12
20150828,100090,100090,103080,103080,103080,103080,103080,2990,2990,2,10
20150831,103080,103080,,,,103080,103080,0,0,0,10
20150901,103080,103080,,,,103080,103080,0,0,0,10
20150902,103080,103080,,,,103070,103070,-10,-10,0,10
20150907,103070,103070,,,,103110,103110,40,40,0,10
20150908,103110,103110,,,,102860,102860,-250,-250,0,10
20150909,102860,102860,,,,104460,104460,1600,1600,0,10
20150910,104460,104460,,,,104000,104000,-460,-460,0,10
20150911,104000,104000,103200,103200,103180,103180,103190,-820,-810,16,10
20150914,103180,103190,,,,102540,102540,-650,-650,0,10
20150915,102540,102540,,,,101760,101760,-780,-780,0,10
20150916,101760,101760,,,,101890,101890,130,130,0,10
20150917,101890,101890,103100,103100,99800,99800,101450,-2090,-440,4,10
20150918,99800,101450,,,,101450,101450,0,0,0,10
20150921,101450,101450,,,,101200,101200,-250,-250,0,10
20150922,101200,101200,,,,100560,100560,-640,-640,0,10
20150923,100560,100560,,,,99610,99610,-950,-950,0,10
20150924,99610,99610,,,,99610,99610,0,0,0,10
20150925,99610,99610,,,,99910,99910,300,300,0,10
20150928,99910,99910,,,,97730,97730,-2180,-2180,0,10
20150929,97730,97730,,,,97640,97640,-90,-90,0,10
20150930,97640,97640,,,,96550,96550,-1090,-1090,0,10
20151008,96550,96550,,,,97210,97210,660,660,0,10
20151009,97210,97210,,,,97100,97100,-110,-110,0,10
20151012,97100,97100,98000,98000,98000,98000,98000,900,900,2,10
20151013,98000,98000,,,,98540,98540,540,540,0,10
20151014,98540,98540,,,,97450,97450,-1090,-1090,0,10
20151015,97450,97450,98000,99200,97150,99200,98140,1750,690,10,10
20151016,99200,98140,,,,98140,98140,0,0,0,10
20151019,98140,98140,,,,98140,98140,0,0,0,10
20151020,98140,98140,,,,98140,98140,0,0,0,10
20151021,98140,98140,,,,97560,97560,-580,-580,0,10
20151022,97560,97560,,,,97560,97560,0,0,0,10
20151023,97560,97560,97900,97900,95750,95750,96820,-1810,-740,4,12
20151026,95750,96820,,,,95600,95600,-1220,-1220,0,12
20151027,95600,95600,94320,95440,94310,95440,94660,-160,-940,8,14
20151028,95440,94660,95000,95200,94600,94600,94930,-60,270,64,66
20151029,94600,94930,94820,94940,92810,94940,94300,10,-630,10,66
20151030,94940,94300,94000,94000,92600,93190,92930,-1110,-1370,12,64
20151102,93190,92930,93890,93890,93010,93010,93450,80,520,4,64
20151103,93010,93450,92900,92900,92900,92900,92900,-550,-550,2,62
20151104,92900,92900,,,,92900,92900,0,0,0,62
20151105,92900,92900,,,,92900,92900,0,0,0,62
20151106,92900,92900,,,,92090,92090,-810,-810,0,62
20151109,92090,92090,,,,91600,91600,-490,-490,0,62
20151110,91600,91600,90100,90100,90000,90000,90080,-1600,-1520,14,72
20151111,90000,90080,,,,90080,90080,0,0,0,72
20151112,90080,90080,,,,90080,90080,0,0,0,72
20151113,90080,90080,,,,90080,90080,0,0,0,72
20151116,90080,90080,,,,90000,90000,-80,-80,0,72
20151117,90000,90000,87000,89490,87000,89490,88240,-510,-1760,4,72
20151118,89490,88240,90390,90390,86150,86810,87570,-1430,-670,8,70
20151119,86810,87570,,,,87030,87030,-540,-540,0,70
20151120,87030,87030,,,,87030,87030,0,0,0,70
20151123,87030,87030,83540,83540,83540,83540,83540,-3490,-3490,2,70
20151124,83540,83540,81500,81500,80500,81500,81250,-2040,-2290,8,68
20151125,81500,81250,83000,83000,83000,83000,83000,1750,1750,6,68
20151126,83000,83000,,,,83000,83000,0,0,0,68
20151127,83000,83000,,,,83000,83000,0,0,0,68
20151130,83000,83000,83020,83020,83020,83020,83020,20,20,2,68
sn1601,20150327,120190,120190,120190,123080,119060,119100,120660,-1090,470,10,2
20150330,119100,120660,119100,119100,115840,118280,117740,-2380,-2920,6,4
20150331,118280,117740,,,,117810,117810,70,70,0,4
20150401,117810,117810,,,,118510,118510,700,700,0,4
20150402,118510,118510,118790,118790,118790,118790,118790,280,280,2,2
20150403,118790,118790,,,,118620,118620,-170,-170,0,2
20150407,118620,118620,,,,118300,118300,-320,-320,0,2
20150408,118300,118300,118730,118730,118420,118420,118570,120,270,4,4
20150409,118420,118570,,,,116550,116550,-2020,-2020,0,4
20150410,116550,116550,,,,115950,115950,-600,-600,0,4
20150413,115950,115950,,,,115840,115840,-110,-110,0,4
20150414,115840,115840,,,,113850,113850,-1990,-1990,0,4
20150415,113850,113850,,,,113700,113700,-150,-150,0,4
20150416,113700,113700,,,,113700,113700,0,0,0,4
20150417,113700,113700,,,,110900,110900,-2800,-2800,0,4
20150420,110900,110900,112800,112800,112800,112800,112800,1900,1900,2,4
20150421,112800,112800,,,,112770,112770,-30,-30,0,4
20150422,112770,112770,,,,113680,113680,910,910,0,4
20150423,113680,113680,,,,113760,113760,80,80,0,4
20150424,113760,113760,,,,114640,114640,880,880,0,4
20150427,114640,114640,,,,117370,117370,2730,2730,0,4
20150428,117370,117370,,,,119500,119500,2130,2130,0,4
20150429,119500,119500,,,,118090,118090,-1410,-1410,0,4
20150430,118090,118090,,,,118490,118490,400,400,0,4
20150504,118490,118490,,,,118880,118880,390,390,0,4
20150505,118880,118880,,,,119190,119190,310,310,0,4
20150506,119190,119190,,,,123580,123580,4390,4390,0,4
20150507,123580,123580,,,,123890,123890,310,310,0,4
20150508,123890,123890,,,,124750,124750,860,860,0,4
20150511,124750,124750,122590,125450,119790,125450,122480,700,-2270,8,10
20150512,125450,122480,122280,122280,122280,122280,122280,-200,-200,2,10
20150513,122280,122280,,,,121580,121580,-700,-700,0,10
20150514,121580,121580,123350,123350,121850,121850,122700,270,1120,22,26
20150515,121850,122700,,,,122510,122510,-190,-190,0,26
20150518,122510,122510,,,,122550,122550,40,40,0,26
20150519,122550,122550,,,,122370,122370,-180,-180,0,26
20150520,122370,122370,,,,117950,117950,-4420,-4420,0,26
20150521,117950,117950,118660,122050,118660,121890,121290,3940,3340,22,38
20150522,121890,121290,122590,122600,122090,122090,122340,800,1050,8,46
20150525,122090,122340,122200,124000,122200,123030,123280,690,940,28,64
20150526,123030,123280,124990,125970,124990,125970,125380,2690,2100,6,70
20150527,125970,125380,,,,124400,124400,-980,-980,0,70
20150528,124400,124400,122170,122200,121500,121500,121990,-2900,-2410,28,80
20150529,121500,121990,120810,120810,118210,120000,118680,-1990,-3310,46,40
20150601,120000,118680,120000,120000,115740,119430,118060,750,-620,48,20
20150602,119430,118060,121980,121980,119080,120000,120290,1940,2230,26,20
20150603,120000,120290,,,,120000,120000,-290,-290,0,20
20150604,120000,120000,118340,119230,116550,119230,118090,-770,-1910,14,18
20150605,119230,118090,118010,118950,117500,117600,117850,-490,-240,22,34
20150608,117600,117850,116510,117600,116510,117600,117250,-250,-600,8,34
20150609,117600,117250,117900,118190,117000,117000,117870,-250,620,16,34
20150610,117000,117870,118400,118500,117880,117880,118160,10,290,8,36
20150611,117880,118160,,,,117990,117990,-170,-170,0,36
20150612,117990,117990,116480,116480,116060,116060,116390,-1930,-1600,12,30
20150615,116060,116390,116490,116490,116490,116490,116490,100,100,2,30
20150616,116490,116490,115190,115500,115190,115500,115340,-990,-1150,4,30
20150617,115500,115340,,,,115340,115340,0,0,0,30
20150618,115340,115340,115210,115210,115210,115210,115210,-130,-130,2,30
20150619,115210,115210,115900,116750,115900,116750,116380,1540,1170,6,30
20150623,116750,116380,,,,116380,116380,0,0,0,30
20150624,116380,116380,,,,116380,116380,0,0,0,30
20150625,116380,116380,115490,115490,115480,115480,115480,-900,-900,4,28
20150626,115480,115480,115340,116480,115320,115470,115630,-10,150,16,30
20150629,115470,115630,114260,114500,114260,114290,114350,-1340,-1280,6,28
20150630,114290,114350,111610,111880,109780,110030,111040,-4320,-3310,24,38
20150701,110030,111040,109010,110870,109010,110610,110020,-430,-1020,8,40
20150702,110610,110020,107520,114350,107520,111380,111360,1360,1340,26,40
20150703,111380,111360,110020,110020,110020,110020,110020,-1340,-1340,4,40
20150706,110020,110020,108510,111280,108510,110010,110160,-10,140,28,46
20150707,110010,110160,,,,110160,110160,0,0,0,46
20150708,110160,110160,106040,106810,105750,105750,106030,-4410,-4130,24,46
20150709,105750,106030,100330,112890,100330,112890,109850,6860,3820,40,36
20150710,112890,109850,110000,112740,109960,109960,110900,110,1050,6,36
20150713,109960,110900,,,,110900,110900,0,0,0,36
20150714,110900,110900,,,,110900,110900,0,0,0,36
20150715,110900,110900,,,,110900,110900,0,0,0,36
20150716,110900,110900,,,,110900,110900,0,0,0,36
20150717,110900,110900,,,,112000,112000,1100,1100,0,36
20150720,112000,112000,112000,115940,112000,113990,114390,1990,2390,16,40
20150721,113990,114390,111520,112560,111520,112560,112040,-1830,-2350,4,40
20150722,112560,112040,114490,114500,112520,112670,113710,630,1670,30,40
20150723,112670,113710,111000,112040,111000,112040,111680,-1670,-2030,6,40
20150724,112040,111680,,,,111680,111680,0,0,0,40
20150727,111680,111680,110100,113990,110100,113990,112040,2310,360,4,40
20150728,113990,112040,,,,112040,112040,0,0,0,40
20150729,112040,112040,113850,114210,113850,114210,113970,2170,1930,6,40
20150730,114210,113970,111740,113970,111740,113970,112660,0,-1310,12,42
20150731,113970,112660,,,,112660,112660,0,0,0,42
20150803,112660,112660,114970,115370,114410,114410,114980,1750,2320,16,56
20150804,114410,114980,112520,113330,110620,112290,111830,-2690,-3150,36,56
20150805,112290,111830,113460,113460,110790,110790,111870,-1040,40,18,58
20150806,110790,111870,109940,110390,109810,110040,109920,-1830,-1950,26,58
20150807,110040,109920,108510,109190,107800,108020,108490,-1900,-1430,48,72
20150810,108020,108490,107500,108970,107110,108970,107820,480,-670,40,86
20150811,108970,107820,111090,111090,108690,110000,110200,2180,2380,22,86
20150812,110000,110200,108790,109630,108540,109360,109240,-840,-960,22,84
20150813,109360,109240,109450,109990,109450,109990,109910,750,670,16,84
20150814,109990,109910,109910,110550,108310,109910,109920,0,10,34,102
20150817,109910,109920,110530,110530,109300,109530,109630,-390,-290,44,110
20150818,109530,109630,109600,109650,109160,109160,109500,-470,-130,30,112
20150819,109160,109500,108900,109190,107370,108980,108170,-520,-1330,114,130
20150820,108980,108170,108890,109500,108460,108680,108890,510,720,66,156
20150821,108680,108890,107770,108350,107410,107500,107810,-1390,-1080,82,142
20150824,107500,107810,105620,107450,103490,103500,104950,-4310,-2860,138,166
20150825,103500,104950,102690,103800,102030,102030,102940,-2920,-2010,158,214
20150826,102030,102940,103790,103790,102500,102500,103160,-440,220,138,252
20150827,102500,103160,101800,102320,100510,101550,101610,-1610,-1550,164,252
20150828,101550,101610,102050,104000,101700,103020,102870,1410,1260,146,276
20150831,103020,102870,103000,103490,100100,101800,102140,-1070,-730,134,318
20150901,101800,102140,101630,102940,101100,101840,101800,-300,-340,44,322
20150902,101840,101800,102750,102860,101380,101540,101910,-260,110,238,404
20150907,101540,101910,101280,101880,101280,101680,101610,-230,-300,122,380
20150908,101680,101610,101620,102060,101030,102060,101460,450,-150,80,374
20150909,102060,101460,102050,104010,101630,102140,102840,680,1380,576,406
20150910,102140,102840,102900,103250,101700,102500,102560,-340,-280,754,546
20150911,102500,102560,103020,103460,102910,103030,103190,470,630,1060,856
20150914,103030,103190,103180,103760,102030,102120,103170,-1070,-20,574,830
20150915,102120,103170,102170,102520,101160,101460,101590,-1710,-1580,432,868
20150916,101460,101590,102150,102400,101560,102190,101890,600,300,296,864
20150917,102190,101890,102480,102480,101830,101850,102160,-40,270,196,870
20150918,101850,102160,101040,101800,101040,101300,101520,-860,-640,328,762
20150921,101300,101520,101310,101310,99520,100550,100350,-970,-1170,630,788
20150922,100550,100350,100500,100500,99050,99050,99820,-1300,-530,454,776
20150923,99050,99820,99080,99080,97080,98800,98510,-1020,-1310,544,776
20150924,98800,98510,98500,99570,98090,98740,98590,230,80,304,798
20150925,98740,98590,99390,99690,98410,98980,99100,390,510,354,764
20150928,98980,99100,99070,99070,97220,97400,97790,-1700,-1310,466,876
20150929,97400,97790,97050,97520,96220,97100,97050,-690,-740,696,968
20150930,97100,97050,97390,98080,97010,97100,97560,50,510,498,1054
20151008,97100,97560,97960,99990,97610,98130,98320,570,760,352,1050
20151009,98130,98320,98100,99280,97170,99100,98450,780,130,1146,1236
20151012,99100,98450,100500,100500,98460,99010,99090,560,640,706,1364
20151013,99010,99090,99110,99700,98400,98560,99060,-530,-30,1414,1686
20151014,98560,99060,98210,98700,97290,97510,98010,-1550,-1050,1070,1896
20151015,97510,98010,97860,101000,97620,99600,99220,1590,1210,2736,2616
20151016,99600,99220,99700,100230,97250,98460,99250,-760,30,2108,2448
20151019,98460,99250,98410,99320,97280,98010,98370,-1240,-880,1976,2332
20151020,98010,98370,97910,98500,97680,98190,98050,-180,-320,788,2442
20151021,98190,98050,98570,99200,98310,98420,98670,370,620,2036,2762
20151022,98420,98670,98070,98880,97840,98500,98290,-170,-380,1110,2734
20151023,98500,98290,98400,98680,97500,98490,98140,200,-150,1914,2680
20151026,98490,98140,98980,99090,97280,97450,97810,-690,-330,2398,2678
20151027,97450,97810,96990,97800,96330,97200,96870,-610,-940,2664,2822
20151028,97200,96870,96900,97470,94700,95070,95870,-1800,-1000,2088,3134
20151029,95070,95870,94670,95900,94350,94530,95000,-1340,-870,4442,3520
20151030,94530,95000,94000,94360,92680,93350,93490,-1650,-1510,5608,4010
20151102,93350,93490,93060,93920,93040,93610,93560,120,70,2946,3688
20151103,93610,93560,93600,94440,93210,93220,93530,-340,-30,1218,3372
20151104,93220,93530,93210,93510,92610,93010,93040,-520,-490,1502,3386
20151105,93010,93040,93010,93850,92800,93210,93210,170,170,2090,3262
20151106,93210,93210,93020,93020,91100,91760,91960,-1450,-1250,3454,3416
20151109,91760,91960,91890,92150,91280,91560,91690,-400,-270,2466,3300
20151110,91560,91690,91440,91580,89820,90770,90710,-920,-980,2568,3296
20151111,90770,90710,90710,90990,89810,90040,90180,-670,-530,2654,3532
20151112,90040,90180,90000,91490,90000,90880,90560,700,380,2260,3692
20151113,90880,90560,90000,90850,89550,89850,90250,-710,-310,2776,3610
20151116,89850,90250,90190,90460,89700,89700,90240,-550,-10,1710,3548
20151117,89700,90240,90480,90490,88020,88600,89380,-1640,-860,2836,3448
20151118,88600,89380,88660,89280,87540,88000,88280,-1380,-1100,3416,3878
20151119,88000,88280,88000,88150,85210,85640,86440,-2640,-1840,5340,4244
20151120,85640,86440,85050,85610,83640,85120,84440,-1320,-2000,7442,4056
20151123,85120,84440,85310,85490,81230,81350,82900,-3090,-1540,6700,3920
20151124,81350,82900,81480,81950,80000,81260,80790,-1640,-2110,8838,3870
20151125,81260,80790,80800,83780,80500,83320,82610,2530,1820,7450,3542
20151126,83320,82610,82890,85910,82110,84230,84140,1620,1530,8380,3588
20151127,84230,84140,84990,87060,84520,84770,85850,630,1710,10582,3778
20151130,84770,85850,84920,85470,84000,84840,84730,-1010,-1120,5504,4058
sn1602,20150327,120190,120190,,,,120660,120660,470,470,0,0
20150330,120660,120660,117900,117900,117900,117900,117900,-2760,-2760,2,2
20150331,117900,117900,,,,117970,117970,70,70,0,2
20150401,117970,117970,118470,118470,118470,118470,118470,500,500,2,2
20150402,118470,118470,,,,118740,118740,270,270,0,2
20150403,118740,118740,,,,118570,118570,-170,-170,0,2
20150407,118570,118570,,,,118250,118250,-320,-320,0,2
20150408,118250,118250,,,,118520,118520,270,270,0,2
20150409,118520,118520,,,,116500,116500,-2020,-2020,0,2
20150410,116500,116500,,,,115900,115900,-600,-600,0,2
20150413,115900,115900,,,,115790,115790,-110,-110,0,2
20150414,115790,115790,,,,113800,113800,-1990,-1990,0,2
20150415,113800,113800,,,,113650,113650,-150,-150,0,2
20150416,113650,113650,,,,113650,113650,0,0,0,2
20150417,113650,113650,,,,110860,110860,-2790,-2790,0,2
20150420,110860,110860,,,,112750,112750,1890,1890,0,2
20150421,112750,112750,,,,112730,112730,-20,-20,0,2
20150422,112730,112730,113850,113850,113850,113850,113850,1120,1120,2,4
20150423,113850,113850,,,,113930,113930,80,80,0,4
20150424,113930,113930,,,,114810,114810,880,880,0,4
20150427,114810,114810,,,,117550,117550,2740,2740,0,4
20150428,117550,117550,,,,119680,119680,2130,2130,0,4
20150429,119680,119680,116810,116810,116810,116810,116810,-2870,-2870,2,2
20150430,116810,116810,,,,117200,117200,390,390,0,2
20150504,117200,117200,,,,117580,117580,380,380,0,2
20150505,117580,117580,,,,117880,117880,300,300,0,2
20150506,117880,117880,,,,122220,122220,4340,4340,0,2
20150507,122220,122220,124810,124810,124810,124810,124810,2590,2590,2,0
20150508,124810,124810,,,,125670,125670,860,860,0,0
20150511,125670,125670,,,,123380,123380,-2290,-2290,0,0
20150512,123380,123380,,,,123170,123170,-210,-210,0,0
20150513,123170,123170,,,,122460,122460,-710,-710,0,0
20150514,122460,122460,,,,123590,123590,1130,1130,0,0
20150515,123590,123590,,,,123400,123400,-190,-190,0,0
20150518,123400,123400,,,,123440,123440,40,40,0,0
20150519,123440,123440,,,,123260,123260,-180,-180,0,0
20150520,123260,123260,,,,118800,118800,-4460,-4460,0,0
20150521,118800,118800,,,,122160,122160,3360,3360,0,0
20150522,122160,122160,,,,123220,123220,1060,1060,0,0
20150525,123220,123220,121870,121870,121870,121870,121870,-1350,-1350,2,2
20150526,121870,121870,,,,122810,122810,940,940,0,2
20150527,122810,122810,,,,122810,122810,0,0,0,2
20150528,122810,122810,,,,122810,122810,0,0,0,2
20150529,122810,122810,,,,119480,119480,-3330,-3330,0,2
20150601,119480,119480,119480,119480,119480,119480,119480,0,0,2,2
20150602,119480,119480,,,,121740,121740,2260,2260,0,2
20150603,121740,121740,,,,121740,121740,0,0,0,2
20150604,121740,121740,,,,119800,119800,-1940,-1940,0,2
20150605,119800,119800,,,,119550,119550,-250,-250,0,2
20150608,119550,119550,,,,119550,119550,0,0,0,2
20150609,119550,119550,,,,120180,120180,630,630,0,2
20150610,120180,120180,,,,120480,120480,300,300,0,2
20150611,120480,120480,,,,120480,120480,0,0,0,2
20150612,120480,120480,,,,118840,118840,-1640,-1640,0,2
20150615,118840,118840,,,,118940,118940,100,100,0,2
20150616,118940,118940,,,,117770,117770,-1170,-1170,0,2
20150617,117770,117770,,,,116440,116440,-1330,-1330,0,2
20150618,116440,116440,,,,116300,116300,-140,-140,0,2
20150619,116300,116300,,,,116300,116300,0,0,0,2
20150623,116300,116300,,,,116300,116300,0,0,0,2
20150624,116300,116300,,,,116290,116290,-10,-10,0,2
20150625,116290,116290,,,,116290,116290,0,0,0,2
20150626,116290,116290,,,,116290,116290,0,0,0,2
20150629,116290,116290,,,,115000,115000,-1290,-1290,0,2
20150630,115000,115000,,,,111670,111670,-3330,-3330,0,2
20150701,111670,111670,,,,110650,110650,-1020,-1020,0,2
20150702,110650,110650,,,,112000,112000,1350,1350,0,2
20150703,112000,112000,,,,112000,112000,0,0,0,2
20150706,112000,112000,,,,112000,112000,0,0,0,2
20150707,112000,112000,,,,110520,110520,-1480,-1480,0,2
20150708,110520,110520,,,,106380,106380,-4140,-4140,0,2
20150709,106380,106380,110630,110630,110630,110630,110630,4250,4250,2,0
20150710,110630,110630,,,,111680,111680,1050,1050,0,0
20150713,111680,111680,,,,111680,111680,0,0,0,0
20150714,111680,111680,,,,113400,113400,1720,1720,0,0
20150715,113400,113400,,,,113330,113330,-70,-70,0,0
20150716,113330,113330,,,,113030,113030,-300,-300,0,0
20150717,113030,113030,,,,114160,114160,1130,1130,0,0
20150720,114160,114160,,,,114160,114160,0,0,0,0
20150721,114160,114160,,,,111810,111810,-2350,-2350,0,0
20150722,111810,111810,,,,113480,113480,1670,1670,0,0
20150723,113480,113480,,,,111450,111450,-2030,-2030,0,0
20150724,111450,111450,,,,115180,115180,3730,3730,0,0
20150727,115180,115180,,,,115550,115550,370,370,0,0
20150728,115550,115550,,,,114910,114910,-640,-640,0,0
20150729,114910,114910,,,,116890,116890,1980,1980,0,0
20150730,116890,116890,,,,115540,115540,-1350,-1350,0,0
20150731,115540,115540,,,,112910,112910,-2630,-2630,0,0
20150803,112910,112910,113000,113000,111000,111000,112000,-1910,-910,4,0
20150804,111000,112000,,,,108930,108930,-3070,-3070,0,0
20150805,108930,108930,,,,108970,108970,40,40,0,0
20150806,108970,108970,,,,107070,107070,-1900,-1900,0,0
20150807,107070,107070,,,,105680,105680,-1390,-1390,0,0
20150810,105680,105680,,,,105030,105030,-650,-650,0,0
20150811,105030,105030,,,,109230,109230,4200,4200,0,0
20150812,109230,109230,,,,108280,108280,-950,-950,0,0
20150813,108280,108280,,,,108940,108940,660,660,0,0
20150814,108940,108940,,,,108950,108950,10,10,0,0
20150817,108950,108950,,,,108660,108660,-290,-290,0,0
20150818,108660,108660,,,,108530,108530,-130,-130,0,0
20150819,108530,108530,,,,107210,107210,-1320,-1320,0,0
20150820,107210,107210,,,,107920,107920,710,710,0,0
20150821,107920,107920,,,,106850,106850,-1070,-1070,0,0
20150824,106850,106850,,,,104020,104020,-2830,-2830,0,0
20150825,104020,104020,,,,102030,102030,-1990,-1990,0,0
20150826,102030,102030,,,,102250,102250,220,220,0,0
20150827,102250,102250,,,,100720,100720,-1530,-1530,0,0
20150828,100720,100720,,,,101960,101960,1240,1240,0,0
20150831,101960,101960,,,,101230,101230,-730,-730,0,0
20150901,101230,101230,,,,100900,100900,-330,-330,0,0
20150902,100900,100900,,,,101010,101010,110,110,0,0
20150907,101010,101010,,,,100710,100710,-300,-300,0,0
20150908,100710,100710,,,,100560,100560,-150,-150,0,0
20150909,100560,100560,,,,101930,101930,1370,1370,0,0
20150910,101930,101930,100730,103990,100730,103990,101540,2060,-390,8,6
20150911,103990,101540,,,,102160,102160,620,620,0,6
20150914,102160,102160,,,,102140,102140,-20,-20,0,6
20150915,102140,102140,,,,100580,100580,-1560,-1560,0,6
20150916,100580,100580,103200,104360,103200,104360,103580,3780,3000,6,2
20150917,104360,103580,,,,103860,103860,280,280,0,2
20150918,103860,103860,,,,103210,103210,-650,-650,0,2
20150921,103210,103210,,,,103210,103210,0,0,0,2
20150922,103210,103210,,,,102670,102670,-540,-540,0,2
20150923,102670,102670,,,,101330,101330,-1340,-1340,0,2
20150924,101330,101330,,,,101300,101300,-30,-30,0,2
20150925,101300,101300,,,,101830,101830,530,530,0,2
20150928,101830,101830,,,,100480,100480,-1350,-1350,0,2
20150929,100480,100480,,,,99720,99720,-760,-760,0,2
20150930,99720,99720,,,,100250,100250,530,530,0,2
20151008,100250,100250,,,,101030,101030,780,780,0,2
20151009,101030,101030,,,,101170,101170,140,140,0,2
20151012,101170,101170,,,,101830,101830,660,660,0,2
20151013,101830,101830,,,,101800,101800,-30,-30,0,2
20151014,101800,101800,,,,100720,100720,-1080,-1080,0,2
20151015,100720,100720,,,,101960,101960,1240,1240,0,2
20151016,101960,101960,,,,101960,101960,0,0,0,2
20151019,101960,101960,,,,101050,101050,-910,-910,0,2
20151020,101050,101050,,,,100720,100720,-330,-330,0,2
20151021,100720,100720,,,,101360,101360,640,640,0,2
20151022,101360,101360,,,,100970,100970,-390,-390,0,2
20151023,100970,100970,,,,100810,100810,-160,-160,0,2
20151026,100810,100810,,,,100470,100470,-340,-340,0,2
20151027,100470,100470,,,,99500,99500,-970,-970,0,2
20151028,99500,99500,,,,98470,98470,-1030,-1030,0,2
20151029,98470,98470,,,,97580,97580,-890,-890,0,2
20151030,97580,97580,,,,96030,96030,-1550,-1550,0,2
20151102,96030,96030,,,,96100,96100,70,70,0,2
20151103,96100,96100,,,,96060,96060,-40,-40,0,2
20151104,96060,96060,,,,95560,95560,-500,-500,0,2
20151105,95560,95560,,,,95740,95740,180,180,0,2
20151106,95740,95740,91910,91910,91910,91910,91910,-3830,-3830,2,2
20151109,91910,91910,,,,91640,91640,-270,-270,0,2
20151110,91640,91640,,,,90660,90660,-980,-980,0,2
20151111,90660,90660,,,,90130,90130,-530,-530,0,2
20151112,90130,90130,,,,90510,90510,380,380,0,2
20151113,90510,90510,,,,90200,90200,-310,-310,0,2
20151116,90200,90200,,,,90190,90190,-10,-10,0,2
20151117,90190,90190,88110,88110,88110,88110,88110,-2080,-2080,2,2
20151118,88110,88110,,,,87030,87030,-1080,-1080,0,2
20151119,87030,87030,,,,85210,85210,-1820,-1820,0,2
20151120,85210,85210,,,,85210,85210,0,0,0,2
20151123,85210,85210,,,,83650,83650,-1560,-1560,0,2
20151124,83650,83650,,,,81520,81520,-2130,-2130,0,2
20151125,81520,81520,84760,84780,82350,82350,83950,830,2430,108,2
20151126,82350,83950,,,,85510,85510,1560,1560,0,2
20151127,85510,85510,,,,87240,87240,1730,1730,0,2
20151130,87240,87240,,,,86100,86100,-1140,-1140,0,2
sn1603,20150327,120190,120190,,,,120660,120660,470,470,0,0
20150330,120660,120660,,,,117900,117900,-2760,-2760,0,0
20150331,117900,117900,,,,117970,117970,70,70,0,0
20150401,117970,117970,,,,118470,118470,500,500,0,0
20150402,118470,118470,,,,118740,118740,270,270,0,0
20150403,118740,118740,,,,118570,118570,-170,-170,0,0
20150407,118570,118570,,,,118250,118250,-320,-320,0,0
20150408,118250,118250,,,,118520,118520,270,270,0,0
20150409,118520,118520,,,,116500,116500,-2020,-2020,0,0
20150410,116500,116500,,,,115900,115900,-600,-600,0,0
20150413,115900,115900,,,,115790,115790,-110,-110,0,0
20150414,115790,115790,,,,113800,113800,-1990,-1990,0,0
20150415,113800,113800,,,,113650,113650,-150,-150,0,0
20150416,113650,113650,,,,113650,113650,0,0,0,0
20150417,113650,113650,,,,110860,110860,-2790,-2790,0,0
20150420,110860,110860,,,,112750,112750,1890,1890,0,0
20150421,112750,112750,,,,112730,112730,-20,-20,0,0
20150422,112730,112730,,,,113850,113850,1120,1120,0,0
20150423,113850,113850,,,,113930,113930,80,80,0,0
20150424,113930,113930,,,,114810,114810,880,880,0,0
20150427,114810,114810,,,,117550,117550,2740,2740,0,0
20150428,117550,117550,,,,119680,119680,2130,2130,0,0
20150429,119680,119680,,,,116810,116810,-2870,-2870,0,0
20150430,116810,116810,,,,117200,117200,390,390,0,0
20150504,117200,117200,,,,117580,117580,380,380,0,0
20150505,117580,117580,,,,117880,117880,300,300,0,0
20150506,117880,117880,,,,122220,122220,4340,4340,0,0
20150507,122220,122220,,,,124810,124810,2590,2590,0,0
20150508,124810,124810,,,,125670,125670,860,860,0,0
20150511,125670,125670,,,,123380,123380,-2290,-2290,0,0
20150512,123380,123380,,,,123170,123170,-210,-210,0,0
20150513,123170,123170,,,,122460,122460,-710,-710,0,0
20150514,122460,122460,,,,123590,123590,1130,1130,0,0
20150515,123590,123590,,,,123400,123400,-190,-190,0,0
20150518,123400,123400,,,,123440,123440,40,40,0,0
20150519,123440,123440,,,,123260,123260,-180,-180,0,0
20150520,123260,123260,,,,118800,118800,-4460,-4460,0,0
20150521,118800,118800,,,,122160,122160,3360,3360,0,0
20150522,122160,122160,,,,123220,123220,1060,1060,0,0
20150525,123220,123220,,,,121870,121870,-1350,-1350,0,0
20150526,121870,121870,,,,122560,122560,690,690,0,0
20150527,122560,122560,,,,120430,120430,-2130,-2130,0,0
20150528,120430,120430,,,,118100,118100,-2330,-2330,0,0
20150529,118100,118100,,,,114890,114890,-3210,-3210,0,0
20150601,114890,114890,,,,114890,114890,0,0,0,0
20150602,114890,114890,,,,117670,117670,2780,2780,0,0
20150603,117670,117670,,,,118000,118000,330,330,0,0
20150604,118000,118000,,,,116120,116120,-1880,-1880,0,0
20150605,116120,116120,,,,115880,115880,-240,-240,0,0
20150608,115880,115880,,,,115290,115290,-590,-590,0,0
20150609,115290,115290,,,,115900,115900,610,610,0,0
20150610,115900,115900,,,,116190,116190,290,290,0,0
20150611,116190,116190,,,,116290,116290,100,100,0,0
20150612,116290,116290,,,,116290,116290,0,0,0,0
20150615,116290,116290,,,,116380,116380,90,90,0,0
20150616,116380,116380,,,,116380,116380,0,0,0,0
20150617,116380,116380,,,,115060,115060,-1320,-1320,0,0
20150618,115060,115060,,,,114930,114930,-130,-130,0,0
20150619,114930,114930,,,,114930,114930,0,0,0,0
20150623,114930,114930,,,,116040,116040,1110,1110,0,0
20150624,116040,116040,,,,116030,116030,-10,-10,0,0
20150625,116030,116030,,,,116030,116030,0,0,0,0
20150626,116030,116030,,,,116030,116030,0,0,0,0
20150629,116030,116030,,,,114740,114740,-1290,-1290,0,0
20150630,114740,114740,,,,111420,111420,-3320,-3320,0,0
20150701,111420,111420,,,,110400,110400,-1020,-1020,0,0
20150702,110400,110400,,,,111750,111750,1350,1350,0,0
20150703,111750,111750,,,,110400,110400,-1350,-1350,0,0
20150706,110400,110400,,,,110400,110400,0,0,0,0
20150707,110400,110400,,,,110400,110400,0,0,0,0
20150708,110400,110400,,,,106260,106260,-4140,-4140,0,0
20150709,106260,106260,,,,106260,106260,0,0,0,0
20150710,106260,106260,,,,107270,107270,1010,1010,0,0
20150713,107270,107270,,,,108190,108190,920,920,0,0
20150714,108190,108190,,,,109860,109860,1670,1670,0,0
20150715,109860,109860,,,,109790,109790,-70,-70,0,0
20150716,109790,109790,,,,109500,109500,-290,-290,0,0
20150717,109500,109500,,,,110590,110590,1090,1090,0,0
20150720,110590,110590,,,,110910,110910,320,320,0,0
20150721,110910,110910,,,,108630,108630,-2280,-2280,0,0
20150722,108630,108630,,,,110250,110250,1620,1620,0,0
20150723,110250,110250,,,,108280,108280,-1970,-1970,0,0
20150724,108280,108280,,,,111900,111900,3620,3620,0,0
20150727,111900,111900,,,,112260,112260,360,360,0,0
20150728,112260,112260,,,,111640,111640,-620,-620,0,0
20150729,111640,111640,,,,113560,113560,1920,1920,0,0
20150730,113560,113560,,,,112250,112250,-1310,-1310,0,0
20150731,112250,112250,,,,109690,109690,-2560,-2560,0,0
20150803,109690,109690,,,,108800,108800,-890,-890,0,0
20150804,108800,108800,,,,105820,105820,-2980,-2980,0,0
20150805,105820,105820,,,,105860,105860,40,40,0,0
20150806,105860,105860,,,,104010,104010,-1850,-1850,0,0
20150807,104010,104010,,,,102660,102660,-1350,-1350,0,0
20150810,102660,102660,,,,102020,102020,-640,-640,0,0
20150811,102020,102020,,,,104270,104270,2250,2250,0,0
20150812,104270,104270,,,,107810,107810,3540,3540,0,0
20150813,107810,107810,,,,108470,108470,660,660,0,0
20150814,108470,108470,,,,108480,108480,10,10,0,0
20150817,108480,108480,,,,108190,108190,-290,-290,0,0
20150818,108190,108190,,,,108060,108060,-130,-130,0,0
20150819,108060,108060,,,,106750,106750,-1310,-1310,0,0
20150820,106750,106750,,,,107460,107460,710,710,0,0
20150821,107460,107460,,,,106400,106400,-1060,-1060,0,0
20150824,106400,106400,,,,103580,103580,-2820,-2820,0,0
20150825,103580,103580,,,,101600,101600,-1980,-1980,0,0
20150826,101600,101600,,,,101820,101820,220,220,0,0
20150827,101820,101820,,,,101820,101820,0,0,0,0
20150828,101820,101820,,,,101820,101820,0,0,0,0
20150831,101820,101820,,,,101090,101090,-730,-730,0,0
20150901,101090,101090,,,,100760,100760,-330,-330,0,0
20150902,100760,100760,,,,100870,100870,110,110,0,0
20150907,100870,100870,,,,100570,100570,-300,-300,0,0
20150908,100570,100570,,,,100420,100420,-150,-150,0,0
20150909,100420,100420,,,,101470,101470,1050,1050,0,0
20150910,101470,101470,,,,101080,101080,-390,-390,0,0
20150911,101080,101080,,,,101700,101700,620,620,0,0
20150914,101700,101700,,,,101680,101680,-20,-20,0,0
20150915,101680,101680,,,,100130,100130,-1550,-1550,0,0
20150916,100130,100130,,,,103120,103120,2990,2990,0,0
20150917,103120,103120,,,,103390,103390,270,270,0,0
20150918,103390,103390,,,,102740,102740,-650,-650,0,0
20150921,102740,102740,,,,101560,101560,-1180,-1180,0,0
20150922,101560,101560,,,,101030,101030,-530,-530,0,0
20150923,101030,101030,,,,99710,99710,-1320,-1320,0,0
20150924,99710,99710,,,,99790,99790,80,80,0,0
20150925,99790,99790,,,,100310,100310,520,520,0,0
20150928,100310,100310,,,,98980,98980,-1330,-1330,0,0
20150929,98980,98980,,,,98230,98230,-750,-750,0,0
20150930,98230,98230,,,,98750,98750,520,520,0,0
20151008,98750,98750,,,,99520,99520,770,770,0,0
20151009,99520,99520,,,,99660,99660,140,140,0,0
20151012,99660,99660,,,,100310,100310,650,650,0,0
20151013,100310,100310,,,,100280,100280,-30,-30,0,0
20151014,100280,100280,,,,99220,99220,-1060,-1060,0,0
20151015,99220,99220,,,,100440,100440,1220,1220,0,0
20151016,100440,100440,,,,100470,100470,30,30,0,0
20151019,100470,100470,,,,99580,99580,-890,-890,0,0
20151020,99580,99580,,,,99260,99260,-320,-320,0,0
20151021,99260,99260,,,,99890,99890,630,630,0,0
20151022,99890,99890,,,,99500,99500,-390,-390,0,0
20151023,99500,99500,,,,99350,99350,-150,-150,0,0
20151026,99350,99350,,,,99010,99010,-340,-340,0,0
20151027,99010,99010,,,,98060,98060,-950,-950,0,0
20151028,98060,98060,,,,97050,97050,-1010,-1010,0,0
20151029,97050,97050,,,,96170,96170,-880,-880,0,0
20151030,96170,96170,,,,94640,94640,-1530,-1530,0,0
20151102,94640,94640,,,,94710,94710,70,70,0,0
20151103,94710,94710,,,,94680,94680,-30,-30,0,0
20151104,94680,94680,,,,94180,94180,-500,-500,0,0
20151105,94180,94180,,,,94360,94360,180,180,0,0
20151106,94360,94360,,,,90580,90580,-3780,-3780,0,0
20151109,90580,90580,,,,90310,90310,-270,-270,0,0
20151110,90310,90310,,,,89340,89340,-970,-970,0,0
20151111,89340,89340,,,,88820,88820,-520,-520,0,0
20151112,88820,88820,,,,88880,88880,60,60,0,0
20151113,88880,88880,,,,88570,88570,-310,-310,0,0
20151116,88570,88570,,,,88560,88560,-10,-10,0,0
20151117,88560,88560,,,,86510,86510,-2050,-2050,0,0
20151118,86510,86510,,,,85450,85450,-1060,-1060,0,0
20151119,85450,85450,,,,83660,83660,-1790,-1790,0,0
20151120,83660,83660,,,,81720,81720,-1940,-1940,0,0
20151123,81720,81720,,,,80230,80230,-1490,-1490,0,0
20151124,80230,80230,,,,78190,78190,-2040,-2040,0,0
20151125,78190,78190,,,,80520,80520,2330,2330,0,0
20151126,80520,80520,,,,82020,82020,1500,1500,0,0
20151127,82020,82020,,,,83680,83680,1660,1660,0,0
20151130,83680,83680,,,,82580,82580,-1100,-1100,0,0
sn1604,20150416,113650,113650,,,,113650,113650,0,0,0,0
20150417,113650,113650,,,,110860,110860,-2790,-2790,0,0
20150420,110860,110860,,,,112750,112750,1890,1890,0,0
20150421,112750,112750,,,,112730,112730,-20,-20,0,0
20150422,112730,112730,,,,113850,113850,1120,1120,0,0
20150423,113850,113850,,,,113930,113930,80,80,0,0
20150424,113930,113930,,,,114810,114810,880,880,0,0
20150427,114810,114810,,,,117550,117550,2740,2740,0,0
20150428,117550,117550,,,,119680,119680,2130,2130,0,0
20150429,119680,119680,,,,116810,116810,-2870,-2870,0,0
20150430,116810,116810,,,,117200,117200,390,390,0,0
20150504,117200,117200,,,,117580,117580,380,380,0,0
20150505,117580,117580,,,,117880,117880,300,300,0,0
20150506,117880,117880,,,,122220,122220,4340,4340,0,0
20150507,122220,122220,,,,124810,124810,2590,2590,0,0
20150508,124810,124810,,,,125670,125670,860,860,0,0
20150511,125670,125670,,,,123380,123380,-2290,-2290,0,0
20150512,123380,123380,124280,124360,124250,124360,124280,980,900,8,8
20150513,124360,124280,,,,123570,123570,-710,-710,0,8
20150514,123570,123570,,,,124710,124710,1140,1140,0,8
20150515,124710,124710,,,,124520,124520,-190,-190,0,8
20150518,124520,124520,,,,124560,124560,40,40,0,8
20150519,124560,124560,,,,124380,124380,-180,-180,0,8
20150520,124380,124380,,,,119880,119880,-4500,-4500,0,8
20150521,119880,119880,,,,123270,123270,3390,3390,0,8
20150522,123270,123270,,,,124330,124330,1060,1060,0,8
20150525,124330,124330,124330,124330,124330,124330,124330,0,0,2,10
20150526,124330,124330,124000,124810,124000,124810,124650,480,320,16,16
20150527,124810,124650,,,,124650,124650,0,0,0,16
20150528,124650,124650,,,,124650,124650,0,0,0,16
20150529,124650,124650,124400,124410,124400,124410,124400,-240,-250,6,16
20150601,124410,124400,,,,124400,124400,0,0,0,16
20150602,124400,124400,,,,126750,126750,2350,2350,0,16
20150603,126750,126750,,,,126400,126400,-350,-350,0,16
20150604,126400,126400,,,,124390,124390,-2010,-2010,0,16
20150605,124390,124390,122690,122690,119410,119410,120390,-4980,-4000,40,32
20150608,119410,120390,116500,118000,115620,118000,116700,-2390,-3690,6,30
20150609,118000,116700,,,,117660,117660,960,960,0,30
20150610,117660,117660,,,,117660,117660,0,0,0,30
20150611,117660,117660,,,,117660,117660,0,0,0,30
20150612,117660,117660,,,,117660,117660,0,0,0,30
20150615,117660,117660,,,,117660,117660,0,0,0,30
20150616,117660,117660,,,,117660,117660,0,0,0,30
20150617,117660,117660,,,,117660,117660,0,0,0,30
20150618,117660,117660,,,,117660,117660,0,0,0,30
20150619,117660,117660,,,,117660,117660,0,0,0,30
20150623,117660,117660,,,,117660,117660,0,0,0,30
20150624,117660,117660,,,,117660,117660,0,0,0,30
20150625,117660,117660,,,,117660,117660,0,0,0,30
20150626,117660,117660,,,,117660,117660,0,0,0,30
20150629,117660,117660,,,,116350,116350,-1310,-1310,0,30
20150630,116350,116350,113060,113060,113060,113060,113060,-3290,-3290,2,28
20150701,113060,113060,,,,112020,112020,-1040,-1040,0,28
20150702,112020,112020,,,,113390,113390,1370,1370,0,28
20150703,113390,113390,,,,112020,112020,-1370,-1370,0,28
20150706,112020,112020,114480,114800,112520,113310,114070,1290,2050,30,20
20150707,113310,114070,111000,111000,110000,110520,110270,-3550,-3800,22,24
20150708,110520,110270,105900,109990,105890,105890,107500,-4380,-2770,16,26
20150709,105890,107500,108600,108600,107600,107600,107990,100,490,10,26
20150710,107600,107990,,,,109020,109020,1030,1030,0,26
20150713,109020,109020,,,,109020,109020,0,0,0,26
20150714,109020,109020,,,,109020,109020,0,0,0,26
20150715,109020,109020,,,,109560,109560,540,540,0,26
20150716,109560,109560,,,,109560,109560,0,0,0,26
20150717,109560,109560,,,,110810,110810,1250,1250,0,26
20150720,110810,110810,,,,111650,111650,840,840,0,26
20150721,111650,111650,,,,111650,111650,0,0,0,26
20150722,111650,111650,,,,111650,111650,0,0,0,26
20150723,111650,111650,,,,109650,109650,-2000,-2000,0,26
20150724,109650,109650,,,,109650,109650,0,0,0,26
20150727,109650,109650,,,,109650,109650,0,0,0,26
20150728,109650,109650,,,,109050,109050,-600,-600,0,26
20150729,109050,109050,,,,110930,110930,1880,1880,0,26
20150730,110930,110930,,,,111500,111500,570,570,0,26
20150731,111500,111500,,,,108960,108960,-2540,-2540,0,26
20150803,108960,108960,,,,108080,108080,-880,-880,0,26
20150804,108080,108080,,,,105120,105120,-2960,-2960,0,26
20150805,105120,105120,,,,109320,109320,4200,4200,0,26
20150806,109320,109320,,,,109320,109320,0,0,0,26
20150807,109320,109320,,,,109320,109320,0,0,0,26
20150810,109320,109320,108910,112800,108910,112800,110390,3480,1070,26,20
20150811,112800,110390,,,,112830,112830,2440,2440,0,20
20150812,112830,112830,,,,111850,111850,-980,-980,0,20
20150813,111850,111850,,,,112530,112530,680,680,0,20
20150814,112530,112530,,,,112540,112540,10,10,0,20
20150817,112540,112540,,,,112240,112240,-300,-300,0,20
20150818,112240,112240,,,,112110,112110,-130,-130,0,20
20150819,112110,112110,,,,110750,110750,-1360,-1360,0,20
20150820,110750,110750,,,,111480,111480,730,730,0,20
20150821,111480,111480,,,,111080,111080,-400,-400,0,20
20150824,111080,111080,109440,109440,109440,109440,109440,-1640,-1640,12,20
20150825,109440,109440,,,,107350,107350,-2090,-2090,0,20
20150826,107350,107350,,,,107580,107580,230,230,0,20
20150827,107580,107580,,,,105970,105970,-1610,-1610,0,20
20150828,105970,105970,103000,103000,103000,103000,103000,-2970,-2970,2,18
20150831,103000,103000,,,,102270,102270,-730,-730,0,18
20150901,102270,102270,,,,101930,101930,-340,-340,0,18
20150902,101930,101930,,,,102040,102040,110,110,0,18
20150907,102040,102040,105010,105010,101710,101710,103360,-330,1320,4,16
20150908,101710,103360,,,,103360,103360,0,0,0,16
20150909,103360,103360,,,,103360,103360,0,0,0,16
20150910,103360,103360,,,,102960,102960,-400,-400,0,16
20150911,102960,102960,,,,103590,103590,630,630,0,16
20150914,103590,103590,,,,103570,103570,-20,-20,0,16
20150915,103570,103570,,,,101990,101990,-1580,-1580,0,16
20150916,101990,101990,,,,105030,105030,3040,3040,0,16
20150917,105030,105030,,,,105310,105310,280,280,0,16
20150918,105310,105310,,,,104650,104650,-660,-660,0,16
20150921,104650,104650,,,,103450,103450,-1200,-1200,0,16
20150922,103450,103450,,,,102910,102910,-540,-540,0,16
20150923,102910,102910,,,,101560,101560,-1350,-1350,0,16
20150924,101560,101560,98890,98890,98890,98890,98890,-2670,-2670,2,14
20150925,98890,98890,,,,99400,99400,510,510,0,14
20150928,99400,99400,,,,98080,98080,-1320,-1320,0,14
20150929,98080,98080,,,,97340,97340,-740,-740,0,14
20150930,97340,97340,,,,97850,97850,510,510,0,14
20151008,97850,97850,,,,98610,98610,760,760,0,14
20151009,98610,98610,,,,98740,98740,130,130,0,14
20151012,98740,98740,,,,99380,99380,640,640,0,14
20151013,99380,99380,,,,99350,99350,-30,-30,0,14
20151014,99350,99350,,,,98300,98300,-1050,-1050,0,14
20151015,98300,98300,,,,99510,99510,1210,1210,0,14
20151016,99510,99510,,,,99540,99540,30,30,0,14
20151019,99540,99540,,,,98650,98650,-890,-890,0,14
20151020,98650,98650,,,,98650,98650,0,0,0,14
20151021,98650,98650,,,,99280,99280,630,630,0,14
20151022,99280,99280,,,,98890,98890,-390,-390,0,14
20151023,98890,98890,,,,98740,98740,-150,-150,0,14
20151026,98740,98740,,,,98410,98410,-330,-330,0,14
20151027,98410,98410,,,,97460,97460,-950,-950,0,14
20151028,97460,97460,,,,96450,96450,-1010,-1010,0,14
20151029,96450,96450,,,,95570,95570,-880,-880,0,14
20151030,95570,95570,,,,94050,94050,-1520,-1520,0,14
20151102,94050,94050,,,,94120,94120,70,70,0,14
20151103,94120,94120,,,,94090,94090,-30,-30,0,14
20151104,94090,94090,,,,93600,93600,-490,-490,0,14
20151105,93600,93600,,,,93780,93780,180,180,0,14
20151106,93780,93780,,,,90020,90020,-3760,-3760,0,14
20151109,90020,90020,92600,92600,92600,92600,92600,2580,2580,2,14
20151110,92600,92600,,,,91610,91610,-990,-990,0,14
20151111,91610,91610,,,,91070,91070,-540,-540,0,14
20151112,91070,91070,,,,91460,91460,390,390,0,14
20151113,91460,91460,,,,91150,91150,-310,-310,0,14
20151116,91150,91150,,,,91140,91140,-10,-10,0,14
20151117,91140,91140,,,,89030,89030,-2110,-2110,0,14
20151118,89030,89030,,,,87940,87940,-1090,-1090,0,14
20151119,87940,87940,,,,86100,86100,-1840,-1840,0,14
20151120,86100,86100,,,,84100,84100,-2000,-2000,0,14
20151123,84100,84100,,,,82560,82560,-1540,-1540,0,14
20151124,82560,82560,,,,80460,80460,-2100,-2100,0,14
20151125,80460,80460,83670,83670,83670,83670,83670,3210,3210,12,12
20151126,83670,83670,,,,85220,85220,1550,1550,0,12
20151127,85220,85220,,,,86950,86950,1730,1730,0,12
20151130,86950,86950,,,,86950,86950,0,0,0,12
sn1605,20150518,124520,124520,,,,124560,124560,40,40,0,0
20150519,124560,124560,,,,124380,124380,-180,-180,0,0
20150520,124380,124380,,,,119880,119880,-4500,-4500,0,0
20150521,119880,119880,,,,123270,123270,3390,3390,0,0
20150522,123270,123270,,,,124330,124330,1060,1060,0,0
20150525,124330,124330,,,,124330,124330,0,0,0,0
20150526,124330,124330,126180,128700,126180,128700,127560,4370,3230,22,20
20150527,128700,127560,,,,127560,127560,0,0,0,20
20150528,127560,127560,128390,128600,125000,125110,126960,-2450,-600,28,36
20150529,125110,126960,124000,124000,121880,121880,122610,-5080,-4350,34,36
20150601,121880,122610,,,,122610,122610,0,0,0,36
20150602,122610,122610,123000,123000,123000,123000,123000,390,390,4,38
20150603,123000,123000,120500,120500,120500,120500,120500,-2500,-2500,2,36
20150604,120500,120500,,,,120500,120500,0,0,0,36
20150605,120500,120500,,,,120500,120500,0,0,0,36
20150608,120500,120500,,,,120500,120500,0,0,0,36
20150609,120500,120500,117160,117160,117160,117160,117160,-3340,-3340,8,44
20150610,117160,117160,119000,120000,119000,120000,119500,2840,2340,4,48
20150611,120000,119500,,,,119500,119500,0,0,0,48
20150612,119500,119500,,,,118950,118950,-550,-550,0,48
20150615,118950,118950,,,,118950,118950,0,0,0,48
20150616,118950,118950,117700,117700,115000,115000,116330,-3950,-2620,6,48
20150617,115000,116330,,,,116330,116330,0,0,0,48
20150618,116330,116330,,,,116330,116330,0,0,0,48
20150619,116330,116330,,,,116330,116330,0,0,0,48
20150623,116330,116330,,,,116330,116330,0,0,0,48
20150624,116330,116330,,,,117000,117000,670,670,0,48
20150625,117000,117000,120540,120540,116990,116990,118180,-10,1180,14,56
20150626,116990,118180,,,,117000,117000,-1180,-1180,0,56
20150629,117000,117000,,,,115700,115700,-1300,-1300,0,56
20150630,115700,115700,,,,115700,115700,0,0,0,56
20150701,115700,115700,,,,114640,114640,-1060,-1060,0,56
20150702,114640,114640,114980,114980,114980,114980,114980,340,340,2,56
20150703,114980,114980,,,,114980,114980,0,0,0,56
20150706,114980,114980,115030,115040,113010,113020,114270,-1960,-710,36,52
20150707,113020,114270,,,,113000,113000,-1270,-1270,0,52
20150708,113000,113000,,,,110160,110160,-2840,-2840,0,52
20150709,110160,110160,109180,110920,108310,110920,109310,760,-850,30,42
20150710,110920,109310,109050,113670,109050,113670,111360,4360,2050,4,42
20150713,113670,111360,,,,111360,111360,0,0,0,42
20150714,111360,111360,,,,113070,113070,1710,1710,0,42
20150715,113070,113070,,,,113000,113000,-70,-70,0,42
20150716,113000,113000,,,,113000,113000,0,0,0,42
20150717,113000,113000,,,,113000,113000,0,0,0,42
20150720,113000,113000,,,,113000,113000,0,0,0,42
20150721,113000,113000,,,,113000,113000,0,0,0,42
20150722,113000,113000,,,,113000,113000,0,0,0,42
20150723,113000,113000,,,,110980,110980,-2020,-2020,0,42
20150724,110980,110980,,,,110980,110980,0,0,0,42
20150727,110980,110980,,,,110980,110980,0,0,0,42
20150728,110980,110980,,,,111600,111600,620,620,0,42
20150729,111600,111600,,,,112100,112100,500,500,0,42
20150730,112100,112100,,,,112100,112100,0,0,0,42
20150731,112100,112100,,,,112100,112100,0,0,0,42
20150803,112100,112100,,,,112100,112100,0,0,0,42
20150804,112100,112100,,,,112100,112100,0,0,0,42
20150805,112100,112100,,,,112100,112100,0,0,0,42
20150806,112100,112100,,,,112100,112100,0,0,0,42
20150807,112100,112100,,,,112100,112100,0,0,0,42
20150810,112100,112100,,,,112100,112100,0,0,0,42
20150811,112100,112100,,,,112100,112100,0,0,0,42
20150812,112100,112100,,,,112100,112100,0,0,0,42
20150813,112100,112100,,,,112100,112100,0,0,0,42
20150814,112100,112100,,,,112100,112100,0,0,0,42
20150817,112100,112100,,,,112100,112100,0,0,0,42
20150818,112100,112100,,,,112100,112100,0,0,0,42
20150819,112100,112100,,,,112100,112100,0,0,0,42
20150820,112100,112100,,,,112100,112100,0,0,0,42
20150821,112100,112100,,,,111470,111470,-630,-630,0,42
20150824,111470,111470,,,,109820,109820,-1650,-1650,0,42
20150825,109820,109820,,,,107720,107720,-2100,-2100,0,42
20150826,107720,107720,,,,107720,107720,0,0,0,42
20150827,107720,107720,,,,106100,106100,-1620,-1620,0,42
20150828,106100,106100,105600,105600,105600,105600,105600,-500,-500,2,40
20150831,105600,105600,,,,105600,105600,0,0,0,40
20150901,105600,105600,,,,105600,105600,0,0,0,40
20150902,105600,105600,105990,105990,103990,103990,104520,-1610,-1080,12,44
20150907,103990,104520,,,,104390,104390,-130,-130,0,44
20150908,104390,104390,,,,104390,104390,0,0,0,44
20150909,104390,104390,102950,102950,102950,102950,102950,-1440,-1440,2,44
20150910,102950,102950,,,,103200,103200,250,250,0,44
20150911,103200,103200,105000,105000,104610,104610,104650,1410,1450,36,44
20150914,104610,104650,,,,104650,104650,0,0,0,44
20150915,104650,104650,,,,104650,104650,0,0,0,44
20150916,104650,104650,,,,104650,104650,0,0,0,44
20150917,104650,104650,,,,104650,104650,0,0,0,44
20150918,104650,104650,,,,104650,104650,0,0,0,44
20150921,104650,104650,,,,104650,104650,0,0,0,44
20150922,104650,104650,,,,104100,104100,-550,-550,0,44
20150923,104100,104100,,,,101770,101770,-2330,-2330,0,44
20150924,101770,101770,98970,98970,98880,98880,98950,-2890,-2820,12,50
20150925,98880,98950,,,,99460,99460,510,510,0,50
20150928,99460,99460,,,,99460,99460,0,0,0,50
20150929,99460,99460,,,,99460,99460,0,0,0,50
20150930,99460,99460,,,,99460,99460,0,0,0,50
20151008,99460,99460,,,,100230,100230,770,770,0,50
20151009,100230,100230,,,,100230,100230,0,0,0,50
20151012,100230,100230,102320,102320,102310,102310,102310,2080,2080,10,44
20151013,102310,102310,,,,102280,102280,-30,-30,0,44
20151014,102280,102280,,,,101780,101780,-500,-500,0,44
20151015,101780,101780,,,,101780,101780,0,0,0,44
20151016,101780,101780,,,,101780,101780,0,0,0,44
20151019,101780,101780,,,,101600,101600,-180,-180,0,44
20151020,101600,101600,100500,100500,100500,100500,100500,-1100,-1100,2,46
20151021,100500,100500,,,,100500,100500,0,0,0,46
20151022,100500,100500,100010,100020,100000,100000,100010,-500,-490,10,50
20151023,100000,100010,,,,100010,100010,0,0,0,50
20151026,100010,100010,,,,99490,99490,-520,-520,0,50
20151027,99490,99490,,,,98530,98530,-960,-960,0,50
20151028,98530,98530,,,,97510,97510,-1020,-1020,0,50
20151029,97510,97510,97000,97000,96000,96470,96530,-1040,-980,14,62
20151030,96470,96530,95000,95000,95000,95000,95000,-1530,-1530,2,62
20151102,95000,95000,95000,95000,95000,95000,95000,0,0,2,64
20151103,95000,95000,97380,97380,97380,97380,97380,2380,2380,2,66
20151104,97380,97380,93900,93900,93770,93810,93830,-3570,-3550,10,70
20151105,93810,93830,92970,96500,92970,96500,94730,2670,900,4,70
20151106,96500,94730,,,,94300,94300,-430,-430,0,70
20151109,94300,94300,92090,92790,91500,92790,92020,-1510,-2280,14,82
20151110,92790,92020,,,,92000,92000,-20,-20,0,82
20151111,92000,92000,,,,92000,92000,0,0,0,82
20151112,92000,92000,,,,92000,92000,0,0,0,82
20151113,92000,92000,90360,90700,90360,90410,90490,-1590,-1510,6,82
20151116,90410,90490,,,,90490,90490,0,0,0,82
20151117,90490,90490,90980,90980,90500,90600,90690,110,200,6,84
20151118,90600,90690,89690,91630,87060,87980,88650,-2710,-2040,392,160
20151119,87980,88650,87110,87760,86000,86200,86660,-2450,-1990,120,168
20151120,86200,86660,84310,85770,83410,84820,84560,-1840,-2100,86,210
20151123,84820,84560,85440,85440,81180,81790,82020,-2770,-2540,198,226
20151124,81790,82020,81920,82040,80040,81800,81130,-220,-890,188,234
20151125,81800,81130,81180,83770,80970,83460,82710,2330,1580,112,244
20151126,83460,82710,82810,86010,82660,84100,84950,1390,2240,432,302
20151127,84100,84950,85390,87790,85010,85280,86390,330,1440,310,348
20151130,85280,86390,85400,85560,84400,84710,84750,-1680,-1640,200,384
sn1606,20150616,118950,118950,,,,116330,116330,-2620,-2620,0,0
20150617,116330,116330,,,,115020,115020,-1310,-1310,0,0
20150618,115020,115020,,,,114890,114890,-130,-130,0,0
20150619,114890,114890,,,,116060,116060,1170,1170,0,0
20150623,116060,116060,,,,117180,117180,1120,1120,0,0
20150624,117180,117180,,,,117170,117170,-10,-10,0,0
20150625,117170,117170,,,,118350,118350,1180,1180,0,0
20150626,118350,118350,,,,118510,118510,160,160,0,0
20150629,118510,118510,,,,117190,117190,-1320,-1320,0,0
20150630,117190,117190,,,,113870,113870,-3320,-3320,0,0
20150701,113870,113870,,,,112830,112830,-1040,-1040,0,0
20150702,112830,112830,,,,113160,113160,330,330,0,0
20150703,113160,113160,,,,111790,111790,-1370,-1370,0,0
20150706,111790,111790,,,,111100,111100,-690,-690,0,0
20150707,111100,111100,,,,107400,107400,-3700,-3700,0,0
20150708,107400,107400,,,,107400,107400,0,0,0,0
20150709,107400,107400,,,,106570,106570,-830,-830,0,0
20150710,106570,106570,,,,108560,108560,1990,1990,0,0
20150713,108560,108560,,,,109490,109490,930,930,0,0
20150714,109490,109490,,,,111180,111180,1690,1690,0,0
20150715,111180,111180,,,,111110,111110,-70,-70,0,0
20150716,111110,111110,,,,110820,110820,-290,-290,0,0
20150717,110820,110820,,,,111920,111920,1100,1100,0,0
20150720,111920,111920,,,,114310,114310,2390,2390,0,0
20150721,114310,114310,,,,111960,111960,-2350,-2350,0,0
20150722,111960,111960,,,,113630,113630,1670,1670,0,0
20150723,113630,113630,,,,111600,111600,-2030,-2030,0,0
20150724,111600,111600,,,,115330,115330,3730,3730,0,0
20150727,115330,115330,,,,115700,115700,370,370,0,0
20150728,115700,115700,,,,115060,115060,-640,-640,0,0
20150729,115060,115060,,,,117040,117040,1980,1980,0,0
20150730,117040,117040,,,,115690,115690,-1350,-1350,0,0
20150731,115690,115690,,,,113050,113050,-2640,-2640,0,0
20150803,113050,113050,,,,112130,112130,-920,-920,0,0
20150804,112130,112130,,,,109060,109060,-3070,-3070,0,0
20150805,109060,109060,,,,109100,109100,40,40,0,0
20150806,109100,109100,,,,107200,107200,-1900,-1900,0,0
20150807,107200,107200,,,,105810,105810,-1390,-1390,0,0
20150810,105810,105810,,,,106840,106840,1030,1030,0,0
20150811,106840,106840,,,,109200,109200,2360,2360,0,0
20150812,109200,109200,,,,108250,108250,-950,-950,0,0
20150813,108250,108250,113970,113990,113970,113970,113970,5720,5720,10,6
20150814,113970,113970,,,,113970,113970,0,0,0,6
20150817,113970,113970,,,,113970,113970,0,0,0,6
20150818,113970,113970,,,,113970,113970,0,0,0,6
20150819,113970,113970,,,,113970,113970,0,0,0,6
20150820,113970,113970,,,,113700,113700,-270,-270,0,6
20150821,113700,113700,,,,112580,112580,-1120,-1120,0,6
20150824,112580,112580,,,,110910,110910,-1670,-1670,0,6
20150825,110910,110910,,,,108790,108790,-2120,-2120,0,6
20150826,108790,108790,,,,109030,109030,240,240,0,6
20150827,109030,109030,,,,104660,104660,-4370,-4370,0,6
20150828,104660,104660,102070,102070,102070,102070,102070,-2590,-2590,6,2
20150831,102070,102070,,,,102070,102070,0,0,0,2
20150901,102070,102070,,,,102070,102070,0,0,0,2
20150902,102070,102070,,,,102070,102070,0,0,0,2
20150907,102070,102070,,,,103390,103390,1320,1320,0,2
20150908,103390,103390,,,,103390,103390,0,0,0,2
20150909,103390,103390,,,,101960,101960,-1430,-1430,0,2
20150910,101960,101960,,,,101570,101570,-390,-390,0,2
20150911,101570,101570,,,,103000,103000,1430,1430,0,2
20150914,103000,103000,,,,102980,102980,-20,-20,0,2
20150915,102980,102980,,,,102980,102980,0,0,0,2
20150916,102980,102980,,,,106050,106050,3070,3070,0,2
20150917,106050,106050,,,,106330,106330,280,280,0,2
20150918,106330,106330,,,,105660,105660,-670,-670,0,2
20150921,105660,105660,101430,101430,101430,101430,101430,-4230,-4230,2,2
20150922,101430,101430,,,,101430,101430,0,0,0,2
20150923,101430,101430,,,,101430,101430,0,0,0,2
20150924,101430,101430,,,,101430,101430,0,0,0,2
20150925,101430,101430,,,,101430,101430,0,0,0,2
20150928,101430,101430,,,,101430,101430,0,0,0,2
20150929,101430,101430,,,,101430,101430,0,0,0,2
20150930,101430,101430,,,,101430,101430,0,0,0,2
20151008,101430,101430,97430,102470,97430,102470,99950,1040,-1480,12,2
20151009,102470,99950,,,,100090,100090,140,140,0,2
20151012,100090,100090,,,,100090,100090,0,0,0,2
20151013,100090,100090,,,,100060,100060,-30,-30,0,2
20151014,100060,100060,,,,100060,100060,0,0,0,2
20151015,100060,100060,,,,100060,100060,0,0,0,2
20151016,100060,100060,,,,100090,100090,30,30,0,2
20151019,100090,100090,,,,100090,100090,0,0,0,2
20151020,100090,100090,,,,99000,99000,-1090,-1090,0,2
20151021,99000,99000,,,,99630,99630,630,630,0,2
20151022,99630,99630,,,,99140,99140,-490,-490,0,2
20151023,99140,99140,,,,99140,99140,0,0,0,2
20151026,99140,99140,,,,98800,98800,-340,-340,0,2
20151027,98800,98800,,,,97850,97850,-950,-950,0,2
20151028,97850,97850,,,,97850,97850,0,0,0,2
20151029,97850,97850,97300,97300,97300,97300,97300,-550,-550,2,2
20151030,97300,97300,,,,95750,95750,-1550,-1550,0,2
20151102,95750,95750,,,,95750,95750,0,0,0,2
20151103,95750,95750,98010,98010,98010,98010,98010,2260,2260,4,6
20151104,98010,98010,94090,94090,94090,94090,94090,-3920,-3920,4,6
20151105,94090,94090,93160,97220,93160,97220,94180,3130,90,8,6
20151106,97220,94180,,,,90410,90410,-3770,-3770,0,6
20151109,90410,90410,,,,91010,91010,600,600,0,6
20151110,91010,91010,,,,90040,90040,-970,-970,0,6
20151111,90040,90040,,,,89510,89510,-530,-530,0,6
20151112,89510,89510,,,,89890,89890,380,380,0,6
20151113,89890,89890,,,,88410,88410,-1480,-1480,0,6
20151116,88410,88410,,,,88400,88400,-10,-10,0,6
20151117,88400,88400,,,,88590,88590,190,190,0,6
20151118,88590,88590,,,,86600,86600,-1990,-1990,0,6
20151119,86600,86600,,,,84650,84650,-1950,-1950,0,6
20151120,84650,84650,,,,82600,82600,-2050,-2050,0,6
20151123,82600,82600,,,,80120,80120,-2480,-2480,0,6
20151124,80120,80120,,,,79250,79250,-870,-870,0,6
20151125,79250,79250,,,,82420,82420,3170,3170,0,6
20151126,82420,82420,,,,84650,84650,2230,2230,0,6
20151127,84650,84650,,,,86080,86080,1430,1430,0,6
20151130,86080,86080,,,,84450,84450,-1630,-1630,0,6
sn1607,20150716,111110,111110,,,,110820,110820,-290,-290,0,0
20150717,110820,110820,,,,111920,111920,1100,1100,0,0
20150720,111920,111920,,,,111920,111920,0,0,0,0
20150721,111920,111920,,,,109620,109620,-2300,-2300,0,0
20150722,109620,109620,,,,111250,111250,1630,1630,0,0
20150723,111250,111250,,,,109260,109260,-1990,-1990,0,0
20150724,109260,109260,,,,112920,112920,3660,3660,0,0
20150727,112920,112920,,,,113280,113280,360,360,0,0
20150728,113280,113280,,,,112660,112660,-620,-620,0,0
20150729,112660,112660,,,,114600,114600,1940,1940,0,0
20150730,114600,114600,,,,113280,113280,-1320,-1320,0,0
20150731,113280,113280,,,,110700,110700,-2580,-2580,0,0
20150803,110700,110700,,,,109800,109800,-900,-900,0,0
20150804,109800,109800,,,,106790,106790,-3010,-3010,0,0
20150805,106790,106790,,,,106830,106830,40,40,0,0
20150806,106830,106830,,,,104970,104970,-1860,-1860,0,0
20150807,104970,104970,,,,103610,103610,-1360,-1360,0,0
20150810,103610,103610,,,,104620,104620,1010,1010,0,0
20150811,104620,104620,,,,106930,106930,2310,2310,0,0
20150812,106930,106930,,,,106000,106000,-930,-930,0,0
20150813,106000,106000,,,,111600,111600,5600,5600,0,0
20150814,111600,111600,,,,111610,111610,10,10,0,0
20150817,111610,111610,,,,111310,111310,-300,-300,0,0
20150818,111310,111310,107770,114060,107730,107730,110900,-3580,-410,8,2
20150819,107730,110900,,,,109560,109560,-1340,-1340,0,2
20150820,109560,109560,,,,110280,110280,720,720,0,2
20150821,110280,110280,107240,112740,107240,112740,109990,2460,-290,4,2
20150824,112740,109990,,,,109990,109990,0,0,0,2
20150825,109990,109990,,,,107890,107890,-2100,-2100,0,2
20150826,107890,107890,,,,108120,108120,230,230,0,2
20150827,108120,108120,,,,106500,106500,-1620,-1620,0,2
20150828,106500,106500,106180,106180,106180,106180,106180,-320,-320,2,0
20150831,106180,106180,,,,105420,105420,-760,-760,0,0
20150901,105420,105420,,,,105070,105070,-350,-350,0,0
20150902,105070,105070,,,,104000,104000,-1070,-1070,0,0
20150907,104000,104000,,,,105340,105340,1340,1340,0,0
20150908,105340,105340,109540,109540,102810,102880,105070,-2460,-270,6,2
20150909,102880,105070,,,,105070,105070,0,0,0,2
20150910,105070,105070,101940,106850,101560,106850,104310,1780,-760,20,8
20150911,106850,104310,,,,105770,105770,1460,1460,0,8
20150914,105770,105770,,,,105750,105750,-20,-20,0,8
20150915,105750,105750,,,,104140,104140,-1610,-1610,0,8
20150916,104140,104140,,,,107250,107250,3110,3110,0,8
20150917,107250,107250,,,,107540,107540,290,290,0,8
20150918,107540,107540,103230,103230,103230,103230,103230,-4310,-4310,4,10
20150921,103230,103230,,,,99090,99090,-4140,-4140,0,10
20150922,99090,99090,,,,98570,98570,-520,-520,0,10
20150923,98570,98570,,,,97280,97280,-1290,-1290,0,10
20150924,97280,97280,,,,98790,98790,1510,1510,0,10
20150925,98790,98790,,,,99300,99300,510,510,0,10
20150928,99300,99300,,,,97990,97990,-1310,-1310,0,10
20150929,97990,97990,,,,97250,97250,-740,-740,0,10
20150930,97250,97250,,,,97760,97760,510,510,0,10
20151008,97760,97760,,,,96330,96330,-1430,-1430,0,10
20151009,96330,96330,,,,96460,96460,130,130,0,10
20151012,96460,96460,99680,99680,99680,99680,99680,3220,3220,2,10
20151013,99680,99680,,,,99680,99680,0,0,0,10
20151014,99680,99680,,,,98620,98620,-1060,-1060,0,10
20151015,98620,98620,,,,99840,99840,1220,1220,0,10
20151016,99840,99840,,,,99870,99870,30,30,0,10
20151019,99870,99870,,,,99870,99870,0,0,0,10
20151020,99870,99870,,,,98780,98780,-1090,-1090,0,10
20151021,98780,98780,,,,99410,99410,630,630,0,10
20151022,99410,99410,,,,98920,98920,-490,-490,0,10
20151023,98920,98920,,,,98770,98770,-150,-150,0,10
20151026,98770,98770,,,,98440,98440,-330,-330,0,10
20151027,98440,98440,,,,97490,97490,-950,-950,0,10
20151028,97490,97490,96750,96750,96750,96750,96750,-740,-740,2,8
20151029,96750,96750,,,,96200,96200,-550,-550,0,8
20151030,96200,96200,,,,94670,94670,-1530,-1530,0,8
20151102,94670,94670,,,,94670,94670,0,0,0,8
20151103,94670,94670,,,,96900,96900,2230,2230,0,8
20151104,96900,96900,,,,93020,93020,-3880,-3880,0,8
20151105,93020,93020,,,,93110,93110,90,90,0,8
20151106,93110,93110,,,,89380,89380,-3730,-3730,0,8
20151109,89380,89380,,,,87220,87220,-2160,-2160,0,8
20151110,87220,87220,89410,89410,89410,89410,89410,2190,2190,2,8
20151111,89410,89410,,,,89410,89410,0,0,0,8
20151112,89410,89410,,,,89790,89790,380,380,0,8
20151113,89790,89790,,,,88310,88310,-1480,-1480,0,8
20151116,88310,88310,,,,88300,88300,-10,-10,0,8
20151117,88300,88300,,,,88490,88490,190,190,0,8
20151118,88490,88490,,,,86500,86500,-1990,-1990,0,8
20151119,86500,86500,,,,84560,84560,-1940,-1940,0,8
20151120,84560,84560,,,,82510,82510,-2050,-2050,0,8
20151123,82510,82510,,,,80030,80030,-2480,-2480,0,8
20151124,80030,80030,,,,79160,79160,-870,-870,0,8
20151125,79160,79160,,,,82320,82320,3160,3160,0,8
20151126,82320,82320,,,,84550,84550,2230,2230,0,8
20151127,84550,84550,,,,85980,85980,1430,1430,0,8
20151130,85980,85980,85980,85980,85980,85980,85980,0,0,2,6
sn1608,20150818,111310,111310,,,,110900,110900,-410,-410,0,0
20150819,110900,110900,,,,109560,109560,-1340,-1340,0,0
20150820,109560,109560,,,,110280,110280,720,720,0,0
20150821,110280,110280,,,,109990,109990,-290,-290,0,0
20150824,109990,109990,,,,108360,108360,-1630,-1630,0,0
20150825,108360,108360,,,,106290,106290,-2070,-2070,0,0
20150826,106290,106290,,,,106520,106520,230,230,0,0
20150827,106520,106520,,,,104920,104920,-1600,-1600,0,0
20150828,104920,104920,,,,104600,104600,-320,-320,0,0
20150831,104600,104600,,,,103850,103850,-750,-750,0,0
20150901,103850,103850,,,,103510,103510,-340,-340,0,0
20150902,103510,103510,,,,102450,102450,-1060,-1060,0,0
20150907,102450,102450,,,,103770,103770,1320,1320,0,0
20150908,103770,103770,,,,103770,103770,0,0,0,0
20150909,103770,103770,,,,102330,102330,-1440,-1440,0,0
20150910,102330,102330,,,,101590,101590,-740,-740,0,0
20150911,101590,101590,,,,103020,103020,1430,1430,0,0
20150914,103020,103020,,,,103000,103000,-20,-20,0,0
20150915,103000,103000,,,,101430,101430,-1570,-1570,0,0
20150916,101430,101430,,,,104460,104460,3030,3030,0,0
20150917,104460,104460,,,,104740,104740,280,280,0,0
20150918,104740,104740,,,,100540,100540,-4200,-4200,0,0
20150921,100540,100540,,,,96510,96510,-4030,-4030,0,0
20150922,96510,96510,,,,96000,96000,-510,-510,0,0
20150923,96000,96000,,,,94740,94740,-1260,-1260,0,0
20150924,94740,94740,,,,92110,92110,-2630,-2630,0,0
20150925,92110,92110,,,,92590,92590,480,480,0,0
20150928,92590,92590,,,,91360,91360,-1230,-1230,0,0
20150929,91360,91360,,,,90670,90670,-690,-690,0,0
20150930,90670,90670,,,,91150,91150,480,480,0,0
20151008,91150,91150,,,,89810,89810,-1340,-1340,0,0
20151009,89810,89810,,,,96990,96990,7180,7180,0,0
20151012,96990,96990,,,,98010,98010,1020,1020,0,0
20151013,98010,98010,,,,97980,97980,-30,-30,0,0
20151014,97980,97980,,,,96940,96940,-1040,-1040,0,0
20151015,96940,96940,,,,98130,98130,1190,1190,0,0
20151016,98130,98130,,,,98160,98160,30,30,0,0
20151019,98160,98160,,,,97290,97290,-870,-870,0,0
20151020,97290,97290,,,,96230,96230,-1060,-1060,0,0
20151021,96230,96230,,,,96840,96840,610,610,0,0
20151022,96840,96840,,,,96370,96370,-470,-470,0,0
20151023,96370,96370,,,,96220,96220,-150,-150,0,0
20151026,96220,96220,,,,95890,95890,-330,-330,0,0
20151027,95890,95890,,,,94970,94970,-920,-920,0,0
20151028,94970,94970,,,,94240,94240,-730,-730,0,0
20151029,94240,94240,,,,93710,93710,-530,-530,0,0
20151030,93710,93710,,,,92220,92220,-1490,-1490,0,0
20151102,92220,92220,,,,92220,92220,0,0,0,0
20151103,92220,92220,,,,94390,94390,2170,2170,0,0
20151104,94390,94390,,,,90610,90610,-3780,-3780,0,0
20151105,90610,90610,,,,90690,90690,80,80,0,0
20151106,90690,90690,,,,87060,87060,-3630,-3630,0,0
20151109,87060,87060,,,,84960,84960,-2100,-2100,0,0
20151110,84960,84960,,,,87090,87090,2130,2130,0,0
20151111,87090,87090,,,,86580,86580,-510,-510,0,0
20151112,86580,86580,,,,86950,86950,370,370,0,0
20151113,86950,86950,,,,85520,85520,-1430,-1430,0,0
20151116,85520,85520,,,,85510,85510,-10,-10,0,0
20151117,85510,85510,,,,85700,85700,190,190,0,0
20151118,85700,85700,,,,83770,83770,-1930,-1930,0,0
20151119,83770,83770,,,,81890,81890,-1880,-1880,0,0
20151120,81890,81890,,,,79900,79900,-1990,-1990,0,0
20151123,79900,79900,,,,77500,77500,-2400,-2400,0,0
20151124,77500,77500,,,,76650,76650,-850,-850,0,0
20151125,76650,76650,,,,78140,78140,1490,1490,0,0
20151126,78140,78140,,,,80250,80250,2110,2110,0,0
20151127,80250,80250,,,,81610,81610,1360,1360,0,0
20151130,81610,81610,,,,81610,81610,0,0,0,0
sn1609,20150916,101430,101430,,,,104460,104460,3030,3030,0,0
20150917,104460,104460,,,,104740,104740,280,280,0,0
20150918,104740,104740,101580,101580,101580,101580,101580,-3160,-3160,2,2
20150921,101580,101580,,,,97510,97510,-4070,-4070,0,2
20150922,97510,97510,101410,101410,100500,100500,101180,2990,3670,8,6
20150923,100500,101180,99990,99990,99990,99990,99990,-1190,-1190,2,4
20150924,99990,99990,99510,99510,99510,99510,99510,-480,-480,4,4
20150925,99510,99510,,,,99510,99510,0,0,0,4
20150928,99510,99510,,,,98190,98190,-1320,-1320,0,4
20150929,98190,98190,,,,97450,97450,-740,-740,0,4
20150930,97450,97450,,,,97970,97970,520,520,0,4
20151008,97970,97970,,,,98200,98200,230,230,0,4
20151009,98200,98200,,,,98200,98200,0,0,0,4
20151012,98200,98200,102120,102120,102120,102120,102120,3920,3920,4,0
20151013,102120,102120,,,,102090,102090,-30,-30,0,0
20151014,102090,102090,,,,101010,101010,-1080,-1080,0,0
20151015,101010,101010,,,,102250,102250,1240,1240,0,0
20151016,102250,102250,,,,102280,102280,30,30,0,0
20151019,102280,102280,,,,101370,101370,-910,-910,0,0
20151020,101370,101370,,,,100270,100270,-1100,-1100,0,0
20151021,100270,100270,,,,100910,100910,640,640,0,0
20151022,100910,100910,,,,100420,100420,-490,-490,0,0
20151023,100420,100420,,,,100260,100260,-160,-160,0,0
20151026,100260,100260,,,,99920,99920,-340,-340,0,0
20151027,99920,99920,,,,98960,98960,-960,-960,0,0
20151028,98960,98960,,,,98200,98200,-760,-760,0,0
20151029,98200,98200,,,,97640,97640,-560,-560,0,0
20151030,97640,97640,93740,95790,93740,95790,94420,-1850,-3220,6,4
20151102,95790,94420,97930,97930,93430,96000,95740,1580,1320,10,6
20151103,96000,95740,,,,95740,95740,0,0,0,6
20151104,95740,95740,95740,95740,95740,95740,95740,0,0,4,4
20151105,95740,95740,,,,95830,95830,90,90,0,4
20151106,95830,95830,94020,94020,91990,91990,92540,-3840,-3290,18,18
20151109,91990,92540,,,,90300,90300,-2240,-2240,0,18
20151110,90300,90300,,,,92560,92560,2260,2260,0,18
20151111,92560,92560,,,,91980,91980,-580,-580,0,18
20151112,91980,91980,,,,92370,92370,390,390,0,18
20151113,92370,92370,,,,91840,91840,-530,-530,0,18
20151116,91840,91840,,,,91830,91830,-10,-10,0,18
20151117,91830,91830,,,,92030,92030,200,200,0,18
20151118,92030,92030,,,,89960,89960,-2070,-2070,0,18
20151119,89960,89960,,,,87940,87940,-2020,-2020,0,18
20151120,87940,87940,,,,85810,85810,-2130,-2130,0,18
20151123,85810,85810,,,,83230,83230,-2580,-2580,0,18
20151124,83230,83230,,,,82320,82320,-910,-910,0,18
20151125,82320,82320,,,,83920,83920,1600,1600,0,18
20151126,83920,83920,,,,86190,86190,2270,2270,0,18
20151127,86190,86190,,,,87650,87650,1460,1460,0,18
20151130,87650,87650,,,,87650,87650,0,0,0,18
sn1610,20151016,102250,102250,,,,102280,102280,30,30,0,0
20151019,102280,102280,,,,102280,102280,0,0,0,0
20151020,102280,102280,,,,101170,101170,-1110,-1110,0,0
20151021,101170,101170,,,,101810,101810,640,640,0,0
20151022,101810,101810,,,,101310,101310,-500,-500,0,0
20151023,101310,101310,,,,101150,101150,-160,-160,0,0
20151026,101150,101150,,,,100810,100810,-340,-340,0,0
20151027,100810,100810,,,,99840,99840,-970,-970,0,0
20151028,99840,99840,,,,99080,99080,-760,-760,0,0
20151029,99080,99080,,,,99080,99080,0,0,0,0
20151030,99080,99080,,,,95810,95810,-3270,-3270,0,0
20151102,95810,95810,,,,97150,97150,1340,1340,0,0
20151103,97150,97150,,,,99440,99440,2290,2290,0,0
20151104,99440,99440,,,,99440,99440,0,0,0,0
20151105,99440,99440,94090,94090,94090,94090,94090,-5350,-5350,6,6
20151106,94090,94090,93040,93040,92020,92020,92530,-2070,-1560,4,10
20151109,92020,92530,,,,92530,92530,0,0,0,10
20151110,92530,92530,,,,92530,92530,0,0,0,10
20151111,92530,92530,,,,92530,92530,0,0,0,10
20151112,92530,92530,,,,92530,92530,0,0,0,10
20151113,92530,92530,,,,92530,92530,0,0,0,10
20151116,92530,92530,,,,92530,92530,0,0,0,10
20151117,92530,92530,94600,94600,89460,92500,92130,-30,-400,10,12
20151118,92500,92130,,,,90060,90060,-2070,-2070,0,12
20151119,90060,90060,,,,88040,88040,-2020,-2020,0,12
20151120,88040,88040,,,,88040,88040,0,0,0,12
20151123,88040,88040,,,,84510,84510,-3530,-3530,0,12
20151124,84510,84510,,,,84510,84510,0,0,0,12
20151125,84510,84510,84740,84740,82500,82500,82910,-2010,-1600,22,30
20151126,82500,82910,84500,84500,84500,84500,84500,1590,1590,2,30
20151127,84500,84500,83730,87500,83730,85110,85490,610,990,14,32
20151130,85110,85490,,,,85490,85490,0,0,0,32
sn1611,20151117,92530,92530,,,,92530,92530,0,0,0,0
20151118,92530,92530,,,,90450,90450,-2080,-2080,0,0
20151119,90450,90450,,,,88420,88420,-2030,-2030,0,0
20151120,88420,88420,83830,83830,83830,83830,83830,-4590,-4590,2,2
20151123,83830,83830,,,,81310,81310,-2520,-2520,0,2
20151124,81310,81310,,,,80420,80420,-890,-890,0,2
20151125,80420,80420,,,,78900,78900,-1520,-1520,0,2
20151126,78900,78900,,,,82050,82050,3150,3150,0,2
20151127,82050,82050,,,,83010,83010,960,960,0,2
20151130,83010,83010,,,,83010,83010,0,0,0,2
wr1501,20150105,2853,2853,,,,2853,2853,0,0,0,0
20150106,2853,2853,,,,2853,2853,0,0,0,0
20150107,2853,2853,,,,2853,2853,0,0,0,0
20150108,2853,2853,,,,2853,2853,0,0,0,0
20150109,2853,2853,,,,2853,2853,0,0,0,0
20150112,2853,2853,,,,2853,2853,0,0,0,0
20150113,2853,2853,,,,2853,2853,0,0,0,0
20150114,2853,2853,,,,2853,2853,0,0,0,0
20150115,2853,2853,,,,2853,2853,0,0,0,0
wr1502,20150105,2840,2840,2748,2930,2748,2930,2839,90,-1,4,4
20150106,2930,2839,,,,2850,2850,11,11,0,4
20150107,2850,2850,,,,2850,2850,0,0,0,4
20150108,2850,2850,,,,2850,2850,0,0,0,4
20150109,2850,2850,2757,2757,2757,2757,2757,-93,-93,2,4
20150112,2757,2757,,,,2757,2757,0,0,0,4
20150113,2757,2757,,,,2757,2757,0,0,0,4
20150114,2757,2757,,,,2757,2757,0,0,0,4
20150115,2757,2757,,,,2757,2757,0,0,0,4
20150116,2757,2757,,,,2757,2757,0,0,0,4
20150119,2757,2757,2881,2881,2881,2881,2881,124,124,2,4
20150120,2881,2881,2740,2740,2740,2740,2740,-141,-141,2,6
20150121,2740,2740,,,,2740,2740,0,0,0,6
20150122,2740,2740,,,,2740,2740,0,0,0,6
20150123,2740,2740,2818,2818,2741,2741,2792,1,52,6,2
20150126,2741,2792,,,,2792,2792,0,0,0,2
20150127,2792,2792,,,,2792,2792,0,0,0,2
20150128,2792,2792,,,,2792,2792,0,0,0,2
20150129,2792,2792,,,,2792,2792,0,0,0,2
20150130,2792,2792,,,,2792,2792,0,0,0,2
20150202,2792,2792,2792,2792,2792,2792,2792,0,0,2,0
20150203,2792,2792,,,,2792,2792,0,0,0,0
20150204,2792,2792,,,,2792,2792,0,0,0,0
20150205,2792,2792,,,,2792,2792,0,0,0,0
20150206,2792,2792,,,,2792,2792,0,0,0,0
20150209,2792,2792,,,,2792,2792,0,0,0,0
20150210,2792,2792,,,,2792,2792,0,0,0,0
wr1503,20150105,2659,2659,,,,2658,2658,-1,-1,0,0
20150106,2658,2658,,,,2658,2658,0,0,0,0
20150107,2658,2658,,,,2658,2658,0,0,0,0
20150108,2658,2658,,,,2658,2658,0,0,0,0
20150109,2658,2658,,,,2571,2571,-87,-87,0,0
20150112,2571,2571,,,,2571,2571,0,0,0,0
20150113,2571,2571,,,,2571,2571,0,0,0,0
20150114,2571,2571,,,,2571,2571,0,0,0,0
20150115,2571,2571,,,,2571,2571,0,0,0,0
20150116,2571,2571,,,,2571,2571,0,0,0,0
20150119,2571,2571,,,,2686,2686,115,115,0,0
20150120,2686,2686,,,,2554,2554,-132,-132,0,0
20150121,2554,2554,,,,2554,2554,0,0,0,0
20150122,2554,2554,,,,2554,2554,0,0,0,0
20150123,2554,2554,,,,2602,2602,48,48,0,0
20150126,2602,2602,,,,2602,2602,0,0,0,0
20150127,2602,2602,,,,2602,2602,0,0,0,0
20150128,2602,2602,,,,2602,2602,0,0,0,0
20150129,2602,2602,,,,2602,2602,0,0,0,0
20150130,2602,2602,,,,2602,2602,0,0,0,0
20150202,2602,2602,,,,2602,2602,0,0,0,0
20150203,2602,2602,,,,2602,2602,0,0,0,0
20150204,2602,2602,,,,2602,2602,0,0,0,0
20150205,2602,2602,,,,2602,2602,0,0,0,0
20150206,2602,2602,,,,2602,2602,0,0,0,0
20150209,2602,2602,,,,2602,2602,0,0,0,0
20150210,2602,2602,,,,2602,2602,0,0,0,0
20150211,2602,2602,,,,2602,2602,0,0,0,0
20150212,2602,2602,,,,2602,2602,0,0,0,0
20150213,2602,2602,,,,2602,2602,0,0,0,0
20150216,2602,2602,,,,2602,2602,0,0,0,0
20150217,2602,2602,,,,2602,2602,0,0,0,0
20150225,2602,2602,,,,2602,2602,0,0,0,0
20150226,2602,2602,,,,2602,2602,0,0,0,0
20150227,2602,2602,,,,2602,2602,0,0,0,0
20150302,2602,2602,,,,2602,2602,0,0,0,0
20150303,2602,2602,,,,2602,2602,0,0,0,0
20150304,2602,2602,,,,2602,2602,0,0,0,0
20150305,2602,2602,,,,2602,2602,0,0,0,0
20150306,2602,2602,,,,2602,2602,0,0,0,0
20150309,2602,2602,,,,2602,2602,0,0,0,0
20150310,2602,2602,,,,2602,2602,0,0,0,0
20150311,2602,2602,,,,2602,2602,0,0,0,0
20150312,2602,2602,,,,2602,2602,0,0,0,0
20150313,2602,2602,,,,2602,2602,0,0,0,0
20150316,2602,2602,,,,2602,2602,0,0,0,0
wr1504,20150105,2801,2801,2941,2941,2680,2779,2838,-22,37,14,8
20150106,2779,2838,,,,2838,2838,0,0,0,8
20150107,2838,2838,,,,2838,2838,0,0,0,8
20150108,2838,2838,,,,2838,2838,0,0,0,8
20150109,2838,2838,,,,2838,2838,0,0,0,8
20150112,2838,2838,,,,2838,2838,0,0,0,8
20150113,2838,2838,,,,2838,2838,0,0,0,8
20150114,2838,2838,,,,2838,2838,0,0,0,8
20150115,2838,2838,,,,2838,2838,0,0,0,8
20150116,2838,2838,,,,2838,2838,0,0,0,8
20150119,2838,2838,,,,2965,2965,127,127,0,8
20150120,2965,2965,,,,2819,2819,-146,-146,0,8
20150121,2819,2819,,,,2819,2819,0,0,0,8
20150122,2819,2819,,,,2819,2819,0,0,0,8
20150123,2819,2819,,,,2872,2872,53,53,0,8
20150126,2872,2872,,,,2872,2872,0,0,0,8
20150127,2872,2872,,,,2872,2872,0,0,0,8
20150128,2872,2872,,,,2872,2872,0,0,0,8
20150129,2872,2872,,,,2872,2872,0,0,0,8
20150130,2872,2872,,,,2872,2872,0,0,0,8
20150202,2872,2872,,,,2872,2872,0,0,0,8
20150203,2872,2872,,,,2872,2872,0,0,0,8
20150204,2872,2872,,,,2872,2872,0,0,0,8
20150205,2872,2872,2731,2731,2731,2731,2731,-141,-141,4,12
20150206,2731,2731,,,,2731,2731,0,0,0,12
20150209,2731,2731,,,,2731,2731,0,0,0,12
20150210,2731,2731,,,,2731,2731,0,0,0,12
20150211,2731,2731,,,,2731,2731,0,0,0,12
20150212,2731,2731,,,,2731,2731,0,0,0,12
20150213,2731,2731,2863,2867,2722,2722,2812,-9,81,8,12
20150216,2722,2812,,,,2812,2812,0,0,0,12
20150217,2812,2812,,,,2812,2812,0,0,0,12
20150225,2812,2812,,,,2812,2812,0,0,0,12
20150226,2812,2812,,,,2812,2812,0,0,0,12
20150227,2812,2812,2675,2675,2675,2675,2675,-137,-137,2,10
20150302,2675,2675,2633,2633,2633,2633,2633,-42,-42,2,8
20150303,2633,2633,,,,2642,2642,9,9,0,8
20150304,2642,2642,,,,2666,2666,24,24,0,8
20150305,2666,2666,,,,2666,2666,0,0,0,8
20150306,2666,2666,,,,2666,2666,0,0,0,8
20150309,2666,2666,,,,2666,2666,0,0,0,8
20150310,2666,2666,,,,2666,2666,0,0,0,8
20150311,2666,2666,,,,2666,2666,0,0,0,8
20150312,2666,2666,,,,2666,2666,0,0,0,8
20150313,2666,2666,,,,2666,2666,0,0,0,8
20150316,2666,2666,,,,2666,2666,0,0,0,8
20150317,2666,2666,,,,2666,2666,0,0,0,8
20150318,2666,2666,,,,2666,2666,0,0,0,8
20150319,2666,2666,,,,2666,2666,0,0,0,8
20150320,2666,2666,,,,2666,2666,0,0,0,8
20150323,2666,2666,,,,2666,2666,0,0,0,8
20150324,2666,2666,,,,2699,2699,33,33,0,8
20150325,2699,2699,,,,2699,2699,0,0,0,8
20150326,2699,2699,2809,2809,2593,2790,2714,91,15,8,8
20150327,2790,2714,2580,2580,2580,2580,2580,-134,-134,2,6
20150330,2580,2580,2600,2600,2455,2455,2503,-125,-77,12,18
20150331,2455,2503,2524,2600,2508,2600,2554,97,51,18,0
20150401,2600,2554,,,,2554,2554,0,0,0,0
20150402,2554,2554,,,,2554,2554,0,0,0,0
20150403,2554,2554,,,,2554,2554,0,0,0,0
20150407,2554,2554,,,,2554,2554,0,0,0,0
20150408,2554,2554,,,,2554,2554,0,0,0,0
20150409,2554,2554,,,,2554,2554,0,0,0,0
20150410,2554,2554,,,,2554,2554,0,0,0,0
20150413,2554,2554,,,,2554,2554,0,0,0,0
20150414,2554,2554,,,,2554,2554,0,0,0,0
20150415,2554,2554,,,,2554,2554,0,0,0,0
wr1505,20150105,2759,2759,,,,2795,2795,36,36,0,0
20150106,2795,2795,,,,2795,2795,0,0,0,0
20150107,2795,2795,,,,2795,2795,0,0,0,0
20150108,2795,2795,,,,2795,2795,0,0,0,0
20150109,2795,2795,,,,2795,2795,0,0,0,0
20150112,2795,2795,2857,2857,2694,2694,2775,-101,-20,4,0
20150113,2694,2775,,,,2775,2775,0,0,0,0
20150114,2775,2775,,,,2775,2775,0,0,0,0
20150115,2775,2775,,,,2775,2775,0,0,0,0
20150116,2775,2775,2819,2819,2818,2818,2818,43,43,4,4
20150119,2818,2818,,,,2818,2818,0,0,0,4
20150120,2818,2818,,,,2680,2680,-138,-138,0,4
20150121,2680,2680,,,,2680,2680,0,0,0,4
20150122,2680,2680,,,,2680,2680,0,0,0,4
20150123,2680,2680,,,,2731,2731,51,51,0,4
20150126,2731,2731,,,,2731,2731,0,0,0,4
20150127,2731,2731,2611,2611,2611,2611,2611,-120,-120,2,2
20150128,2611,2611,,,,2611,2611,0,0,0,2
20150129,2611,2611,,,,2611,2611,0,0,0,2
20150130,2611,2611,,,,2611,2611,0,0,0,2
20150202,2611,2611,,,,2611,2611,0,0,0,2
20150203,2611,2611,,,,2611,2611,0,0,0,2
20150204,2611,2611,,,,2611,2611,0,0,0,2
20150205,2611,2611,,,,2482,2482,-129,-129,0,2
20150206,2482,2482,,,,2482,2482,0,0,0,2
20150209,2482,2482,,,,2482,2482,0,0,0,2
20150210,2482,2482,,,,2606,2606,124,124,0,2
20150211,2606,2606,,,,2606,2606,0,0,0,2
20150212,2606,2606,2680,2680,2679,2679,2679,73,73,4,2
20150213,2679,2679,2805,2805,2805,2805,2805,126,126,2,2
20150216,2805,2805,,,,2805,2805,0,0,0,2
20150217,2805,2805,,,,2805,2805,0,0,0,2
20150225,2805,2805,,,,2805,2805,0,0,0,2
20150226,2805,2805,,,,2805,2805,0,0,0,2
20150227,2805,2805,,,,2805,2805,0,0,0,2
20150302,2805,2805,,,,2760,2760,-45,-45,0,2
20150303,2760,2760,,,,2760,2760,0,0,0,2
20150304,2760,2760,,,,2760,2760,0,0,0,2
20150305,2760,2760,,,,2760,2760,0,0,0,2
20150306,2760,2760,,,,2760,2760,0,0,0,2
20150309,2760,2760,,,,2760,2760,0,0,0,2
20150310,2760,2760,,,,2760,2760,0,0,0,2
20150311,2760,2760,,,,2760,2760,0,0,0,2
20150312,2760,2760,,,,2760,2760,0,0,0,2
20150313,2760,2760,,,,2760,2760,0,0,0,2
20150316,2760,2760,,,,2760,2760,0,0,0,2
20150317,2760,2760,,,,2760,2760,0,0,0,2
20150318,2760,2760,,,,2760,2760,0,0,0,2
20150319,2760,2760,,,,2760,2760,0,0,0,2
20150320,2760,2760,,,,2760,2760,0,0,0,2
20150323,2760,2760,,,,2760,2760,0,0,0,2
20150324,2760,2760,,,,2760,2760,0,0,0,2
20150325,2760,2760,,,,2760,2760,0,0,0,2
20150326,2760,2760,,,,2760,2760,0,0,0,2
20150327,2760,2760,,,,2623,2623,-137,-137,0,2
20150330,2623,2623,,,,2545,2545,-78,-78,0,2
20150331,2545,2545,,,,2597,2597,52,52,0,2
20150401,2597,2597,,,,2597,2597,0,0,0,2
20150402,2597,2597,,,,2597,2597,0,0,0,2
20150403,2597,2597,,,,2597,2597,0,0,0,2
20150407,2597,2597,,,,2597,2597,0,0,0,2
20150408,2597,2597,,,,2597,2597,0,0,0,2
20150409,2597,2597,2476,2476,2476,2476,2476,-121,-121,2,4
20150410,2476,2476,,,,2476,2476,0,0,0,4
20150413,2476,2476,,,,2476,2476,0,0,0,4
20150414,2476,2476,,,,2476,2476,0,0,0,4
20150415,2476,2476,2473,2473,2473,2473,2473,-3,-3,2,4
20150416,2473,2473,,,,2473,2473,0,0,0,4
20150417,2473,2473,,,,2473,2473,0,0,0,4
20150420,2473,2473,2596,2596,2596,2596,2596,123,123,2,2
20150421,2596,2596,2479,2479,2479,2479,2479,-117,-117,2,0
20150422,2479,2479,,,,2479,2479,0,0,0,0
20150423,2479,2479,,,,2479,2479,0,0,0,0
20150424,2479,2479,,,,2479,2479,0,0,0,0
20150427,2479,2479,,,,2479,2479,0,0,0,0
20150428,2479,2479,,,,2479,2479,0,0,0,0
20150429,2479,2479,,,,2479,2479,0,0,0,0
20150430,2479,2479,,,,2479,2479,0,0,0,0
20150504,2479,2479,,,,2479,2479,0,0,0,0
20150505,2479,2479,,,,2479,2479,0,0,0,0
20150506,2479,2479,,,,2479,2479,0,0,0,0
20150507,2479,2479,,,,2479,2479,0,0,0,0
20150508,2479,2479,,,,2479,2479,0,0,0,0
20150511,2479,2479,,,,2479,2479,0,0,0,0
20150512,2479,2479,,,,2479,2479,0,0,0,0
20150513,2479,2479,,,,2479,2479,0,0,0,0
20150514,2479,2479,,,,2479,2479,0,0,0,0
20150515,2479,2479,,,,2479,2479,0,0,0,0
wr1506,20150105,2797,2797,,,,2834,2834,37,37,0,0
20150106,2834,2834,,,,2834,2834,0,0,0,0
20150107,2834,2834,,,,2834,2834,0,0,0,0
20150108,2834,2834,,,,2834,2834,0,0,0,0
20150109,2834,2834,,,,2741,2741,-93,-93,0,0
20150112,2741,2741,,,,2721,2721,-20,-20,0,0
20150113,2721,2721,,,,2721,2721,0,0,0,0
20150114,2721,2721,,,,2721,2721,0,0,0,0
20150115,2721,2721,,,,2721,2721,0,0,0,0
20150116,2721,2721,,,,2763,2763,42,42,0,0
20150119,2763,2763,,,,2887,2887,124,124,0,0
20150120,2887,2887,,,,2745,2745,-142,-142,0,0
20150121,2745,2745,,,,2745,2745,0,0,0,0
20150122,2745,2745,,,,2745,2745,0,0,0,0
20150123,2745,2745,,,,2797,2797,52,52,0,0
20150126,2797,2797,,,,2797,2797,0,0,0,0
20150127,2797,2797,,,,2674,2674,-123,-123,0,0
20150128,2674,2674,,,,2674,2674,0,0,0,0
20150129,2674,2674,,,,2674,2674,0,0,0,0
20150130,2674,2674,,,,2674,2674,0,0,0,0
20150202,2674,2674,,,,2674,2674,0,0,0,0
20150203,2674,2674,,,,2674,2674,0,0,0,0
20150204,2674,2674,,,,2674,2674,0,0,0,0
20150205,2674,2674,,,,2542,2542,-132,-132,0,0
20150206,2542,2542,,,,2542,2542,0,0,0,0
20150209,2542,2542,,,,2542,2542,0,0,0,0
20150210,2542,2542,,,,2542,2542,0,0,0,0
20150211,2542,2542,,,,2542,2542,0,0,0,0
20150212,2542,2542,,,,2613,2613,71,71,0,0
20150213,2613,2613,,,,2735,2735,122,122,0,0
20150216,2735,2735,,,,2735,2735,0,0,0,0
20150217,2735,2735,,,,2735,2735,0,0,0,0
20150225,2735,2735,,,,2735,2735,0,0,0,0
20150226,2735,2735,,,,2735,2735,0,0,0,0
20150227,2735,2735,,,,2601,2601,-134,-134,0,0
20150302,2601,2601,,,,2560,2560,-41,-41,0,0
20150303,2560,2560,,,,2560,2560,0,0,0,0
20150304,2560,2560,,,,2560,2560,0,0,0,0
20150305,2560,2560,,,,2560,2560,0,0,0,0
20150306,2560,2560,,,,2560,2560,0,0,0,0
20150309,2560,2560,,,,2560,2560,0,0,0,0
20150310,2560,2560,,,,2560,2560,0,0,0,0
20150311,2560,2560,,,,2560,2560,0,0,0,0
20150312,2560,2560,,,,2560,2560,0,0,0,0
20150313,2560,2560,,,,2560,2560,0,0,0,0
20150316,2560,2560,,,,2560,2560,0,0,0,0
20150317,2560,2560,,,,2560,2560,0,0,0,0
20150318,2560,2560,,,,2560,2560,0,0,0,0
20150319,2560,2560,,,,2560,2560,0,0,0,0
20150320,2560,2560,,,,2560,2560,0,0,0,0
20150323,2560,2560,,,,2560,2560,0,0,0,0
20150324,2560,2560,,,,2560,2560,0,0,0,0
20150325,2560,2560,,,,2560,2560,0,0,0,0
20150326,2560,2560,,,,2574,2574,14,14,0,0
20150327,2574,2574,,,,2446,2446,-128,-128,0,0
20150330,2446,2446,,,,2373,2373,-73,-73,0,0
20150331,2373,2373,,,,2421,2421,48,48,0,0
20150401,2421,2421,,,,2421,2421,0,0,0,0
20150402,2421,2421,,,,2421,2421,0,0,0,0
20150403,2421,2421,,,,2421,2421,0,0,0,0
20150407,2421,2421,,,,2421,2421,0,0,0,0
20150408,2421,2421,,,,2421,2421,0,0,0,0
20150409,2421,2421,,,,2308,2308,-113,-113,0,0
20150410,2308,2308,,,,2308,2308,0,0,0,0
20150413,2308,2308,,,,2308,2308,0,0,0,0
20150414,2308,2308,,,,2308,2308,0,0,0,0
20150415,2308,2308,,,,2305,2305,-3,-3,0,0
20150416,2305,2305,,,,2305,2305,0,0,0,0
20150417,2305,2305,,,,2305,2305,0,0,0,0
20150420,2305,2305,,,,2419,2419,114,114,0,0
20150421,2419,2419,,,,2309,2309,-110,-110,0,0
20150422,2309,2309,,,,2309,2309,0,0,0,0
20150423,2309,2309,,,,2309,2309,0,0,0,0
20150424,2309,2309,,,,2309,2309,0,0,0,0
20150427,2309,2309,,,,2309,2309,0,0,0,0
20150428,2309,2309,,,,2309,2309,0,0,0,0
20150429,2309,2309,,,,2309,2309,0,0,0,0
20150430,2309,2309,,,,2309,2309,0,0,0,0
20150504,2309,2309,,,,2309,2309,0,0,0,0
20150505,2309,2309,,,,2309,2309,0,0,0,0
20150506,2309,2309,,,,2309,2309,0,0,0,0
20150507,2309,2309,,,,2309,2309,0,0,0,0
20150508,2309,2309,,,,2309,2309,0,0,0,0
20150511,2309,2309,,,,2309,2309,0,0,0,0
20150512,2309,2309,,,,2309,2309,0,0,0,0
20150513,2309,2309,,,,2309,2309,0,0,0,0
20150514,2309,2309,,,,2309,2309,0,0,0,0
20150515,2309,2309,,,,2309,2309,0,0,0,0
20150518,2309,2309,,,,2309,2309,0,0,0,0
20150519,2309,2309,,,,2309,2309,0,0,0,0
20150520,2309,2309,,,,2309,2309,0,0,0,0
20150521,2309,2309,,,,2309,2309,0,0,0,0
20150522,2309,2309,,,,2309,2309,0,0,0,0
20150525,2309,2309,,,,2309,2309,0,0,0,0
20150526,2309,2309,,,,2309,2309,0,0,0,0
20150527,2309,2309,,,,2309,2309,0,0,0,0
20150528,2309,2309,,,,2309,2309,0,0,0,0
20150529,2309,2309,,,,2309,2309,0,0,0,0
20150601,2309,2309,,,,2309,2309,0,0,0,0
20150602,2309,2309,,,,2309,2309,0,0,0,0
20150603,2309,2309,,,,2309,2309,0,0,0,0
20150604,2309,2309,,,,2309,2309,0,0,0,0
20150605,2309,2309,,,,2309,2309,0,0,0,0
20150608,2309,2309,,,,2309,2309,0,0,0,0
20150609,2309,2309,,,,2309,2309,0,0,0,0
20150610,2309,2309,,,,2309,2309,0,0,0,0
20150611,2309,2309,,,,2309,2309,0,0,0,0
20150612,2309,2309,,,,2309,2309,0,0,0,0
20150615,2309,2309,,,,2309,2309,0,0,0,0
wr1507,20150105,2960,2960,,,,2999,2999,39,39,0,0
20150106,2999,2999,,,,2999,2999,0,0,0,0
20150107,2999,2999,,,,2999,2999,0,0,0,0
20150108,2999,2999,,,,2999,2999,0,0,0,0
20150109,2999,2999,,,,2901,2901,-98,-98,0,0
20150112,2901,2901,,,,2880,2880,-21,-21,0,0
20150113,2880,2880,,,,2880,2880,0,0,0,0
20150114,2880,2880,,,,2880,2880,0,0,0,0
20150115,2880,2880,,,,2880,2880,0,0,0,0
20150116,2880,2880,,,,2925,2925,45,45,0,0
20150119,2925,2925,,,,3056,3056,131,131,0,0
20150120,3056,3056,,,,2906,2906,-150,-150,0,0
20150121,2906,2906,,,,2906,2906,0,0,0,0
20150122,2906,2906,,,,2906,2906,0,0,0,0
20150123,2906,2906,,,,2961,2961,55,55,0,0
20150126,2961,2961,,,,2961,2961,0,0,0,0
20150127,2961,2961,,,,2830,2830,-131,-131,0,0
20150128,2830,2830,,,,2830,2830,0,0,0,0
20150129,2830,2830,,,,2830,2830,0,0,0,0
20150130,2830,2830,,,,2830,2830,0,0,0,0
20150202,2830,2830,,,,2830,2830,0,0,0,0
20150203,2830,2830,,,,2830,2830,0,0,0,0
20150204,2830,2830,,,,2830,2830,0,0,0,0
20150205,2830,2830,,,,2691,2691,-139,-139,0,0
20150206,2691,2691,,,,2691,2691,0,0,0,0
20150209,2691,2691,,,,2691,2691,0,0,0,0
20150210,2691,2691,,,,2691,2691,0,0,0,0
20150211,2691,2691,,,,2691,2691,0,0,0,0
20150212,2691,2691,,,,2766,2766,75,75,0,0
20150213,2766,2766,,,,2896,2896,130,130,0,0
20150216,2896,2896,,,,2896,2896,0,0,0,0
20150217,2896,2896,,,,2896,2896,0,0,0,0
20150225,2896,2896,,,,2896,2896,0,0,0,0
20150226,2896,2896,,,,2896,2896,0,0,0,0
20150227,2896,2896,,,,2754,2754,-142,-142,0,0
20150302,2754,2754,,,,2710,2710,-44,-44,0,0
20150303,2710,2710,,,,2710,2710,0,0,0,0
20150304,2710,2710,,,,2710,2710,0,0,0,0
20150305,2710,2710,,,,2710,2710,0,0,0,0
20150306,2710,2710,,,,2710,2710,0,0,0,0
20150309,2710,2710,,,,2710,2710,0,0,0,0
20150310,2710,2710,,,,2710,2710,0,0,0,0
20150311,2710,2710,,,,2710,2710,0,0,0,0
20150312,2710,2710,,,,2710,2710,0,0,0,0
20150313,2710,2710,,,,2710,2710,0,0,0,0
20150316,2710,2710,,,,2710,2710,0,0,0,0
20150317,2710,2710,,,,2710,2710,0,0,0,0
20150318,2710,2710,,,,2710,2710,0,0,0,0
20150319,2710,2710,,,,2710,2710,0,0,0,0
20150320,2710,2710,,,,2710,2710,0,0,0,0
20150323,2710,2710,,,,2710,2710,0,0,0,0
20150324,2710,2710,,,,2710,2710,0,0,0,0
20150325,2710,2710,,,,2710,2710,0,0,0,0
20150326,2710,2710,,,,2725,2725,15,15,0,0
20150327,2725,2725,,,,2590,2590,-135,-135,0,0
20150330,2590,2590,,,,2513,2513,-77,-77,0,0
20150331,2513,2513,,,,2564,2564,51,51,0,0
20150401,2564,2564,,,,2564,2564,0,0,0,0
20150402,2564,2564,,,,2564,2564,0,0,0,0
20150403,2564,2564,,,,2564,2564,0,0,0,0
20150407,2564,2564,,,,2564,2564,0,0,0,0
20150408,2564,2564,,,,2564,2564,0,0,0,0
20150409,2564,2564,,,,2444,2444,-120,-120,0,0
20150410,2444,2444,,,,2444,2444,0,0,0,0
20150413,2444,2444,,,,2444,2444,0,0,0,0
20150414,2444,2444,,,,2444,2444,0,0,0,0
20150415,2444,2444,,,,2441,2441,-3,-3,0,0
20150416,2441,2441,,,,2441,2441,0,0,0,0
20150417,2441,2441,2196,2196,2196,2196,2196,-245,-245,2,2
20150420,2196,2196,2299,2299,2299,2299,2299,103,103,2,2
20150421,2299,2299,,,,2195,2195,-104,-104,0,2
20150422,2195,2195,,,,2195,2195,0,0,0,2
20150423,2195,2195,,,,2195,2195,0,0,0,2
20150424,2195,2195,,,,2195,2195,0,0,0,2
20150427,2195,2195,,,,2304,2304,109,109,0,2
20150428,2304,2304,,,,2419,2419,115,115,0,2
20150429,2419,2419,2539,2539,2539,2539,2539,120,120,4,0
20150430,2539,2539,,,,2539,2539,0,0,0,0
20150504,2539,2539,,,,2539,2539,0,0,0,0
20150505,2539,2539,,,,2539,2539,0,0,0,0
20150506,2539,2539,,,,2539,2539,0,0,0,0
20150507,2539,2539,,,,2539,2539,0,0,0,0
20150508,2539,2539,,,,2539,2539,0,0,0,0
20150511,2539,2539,,,,2539,2539,0,0,0,0
20150512,2539,2539,,,,2539,2539,0,0,0,0
20150513,2539,2539,,,,2539,2539,0,0,0,0
20150514,2539,2539,,,,2539,2539,0,0,0,0
20150515,2539,2539,2412,2470,2412,2470,2441,-69,-98,4,0
20150518,2470,2441,,,,2441,2441,0,0,0,0
20150519,2441,2441,,,,2441,2441,0,0,0,0
20150520,2441,2441,,,,2441,2441,0,0,0,0
20150521,2441,2441,,,,2441,2441,0,0,0,0
20150522,2441,2441,,,,2441,2441,0,0,0,0
20150525,2441,2441,,,,2441,2441,0,0,0,0
20150526,2441,2441,,,,2441,2441,0,0,0,0
20150527,2441,2441,,,,2441,2441,0,0,0,0
20150528,2441,2441,,,,2441,2441,0,0,0,0
20150529,2441,2441,,,,2441,2441,0,0,0,0
20150601,2441,2441,,,,2441,2441,0,0,0,0
20150602,2441,2441,,,,2441,2441,0,0,0,0
20150603,2441,2441,,,,2441,2441,0,0,0,0
20150604,2441,2441,,,,2441,2441,0,0,0,0
20150605,2441,2441,,,,2441,2441,0,0,0,0
20150608,2441,2441,,,,2441,2441,0,0,0,0
20150609,2441,2441,,,,2441,2441,0,0,0,0
20150610,2441,2441,,,,2441,2441,0,0,0,0
20150611,2441,2441,,,,2441,2441,0,0,0,0
20150612,2441,2441,,,,2441,2441,0,0,0,0
20150615,2441,2441,,,,2441,2441,0,0,0,0
20150616,2441,2441,,,,2441,2441,0,0,0,0
20150617,2441,2441,,,,2441,2441,0,0,0,0
20150618,2441,2441,,,,2441,2441,0,0,0,0
20150619,2441,2441,,,,2441,2441,0,0,0,0
20150623,2441,2441,,,,2441,2441,0,0,0,0
20150624,2441,2441,,,,2441,2441,0,0,0,0
20150625,2441,2441,,,,2441,2441,0,0,0,0
20150626,2441,2441,,,,2441,2441,0,0,0,0
20150629,2441,2441,,,,2441,2441,0,0,0,0
20150630,2441,2441,,,,2441,2441,0,0,0,0
20150701,2441,2441,,,,2441,2441,0,0,0,0
20150702,2441,2441,,,,2441,2441,0,0,0,0
20150703,2441,2441,,,,2441,2441,0,0,0,0
20150706,2441,2441,,,,2441,2441,0,0,0,0
20150707,2441,2441,,,,2441,2441,0,0,0,0
20150708,2441,2441,,,,2441,2441,0,0,0,0
20150709,2441,2441,,,,2441,2441,0,0,0,0
20150710,2441,2441,,,,2441,2441,0,0,0,0
20150713,2441,2441,,,,2441,2441,0,0,0,0
20150714,2441,2441,,,,2441,2441,0,0,0,0
20150715,2441,2441,,,,2441,2441,0,0,0,0
wr1508,20150105,3065,3065,,,,3105,3105,40,40,0,2
20150106,3105,3105,,,,3105,3105,0,0,0,2
20150107,3105,3105,,,,3105,3105,0,0,0,2
20150108,3105,3105,,,,3105,3105,0,0,0,2
20150109,3105,3105,,,,3003,3003,-102,-102,0,2
20150112,3003,3003,,,,2982,2982,-21,-21,0,2
20150113,2982,2982,,,,2982,2982,0,0,0,2
20150114,2982,2982,,,,2982,2982,0,0,0,2
20150115,2982,2982,,,,2982,2982,0,0,0,2
20150116,2982,2982,,,,3028,3028,46,46,0,2
20150119,3028,3028,,,,3164,3164,136,136,0,2
20150120,3164,3164,,,,3009,3009,-155,-155,0,2
20150121,3009,3009,,,,3009,3009,0,0,0,2
20150122,3009,3009,,,,3009,3009,0,0,0,2
20150123,3009,3009,,,,3066,3066,57,57,0,2
20150126,3066,3066,,,,3066,3066,0,0,0,2
20150127,3066,3066,,,,2931,2931,-135,-135,0,2
20150128,2931,2931,,,,2931,2931,0,0,0,2
20150129,2931,2931,,,,2931,2931,0,0,0,2
20150130,2931,2931,,,,2931,2931,0,0,0,2
20150202,2931,2931,,,,2931,2931,0,0,0,2
20150203,2931,2931,,,,2931,2931,0,0,0,2
20150204,2931,2931,,,,2931,2931,0,0,0,2
20150205,2931,2931,,,,2787,2787,-144,-144,0,2
20150206,2787,2787,,,,2787,2787,0,0,0,2
20150209,2787,2787,,,,2787,2787,0,0,0,2
20150210,2787,2787,,,,2787,2787,0,0,0,2
20150211,2787,2787,,,,2787,2787,0,0,0,2
20150212,2787,2787,,,,2865,2865,78,78,0,2
20150213,2865,2865,,,,2999,2999,134,134,0,2
20150216,2999,2999,,,,2999,2999,0,0,0,2
20150217,2999,2999,,,,2999,2999,0,0,0,2
20150225,2999,2999,,,,2999,2999,0,0,0,2
20150226,2999,2999,,,,2999,2999,0,0,0,2
20150227,2999,2999,,,,2852,2852,-147,-147,0,2
20150302,2852,2852,,,,2807,2807,-45,-45,0,2
20150303,2807,2807,,,,2807,2807,0,0,0,2
20150304,2807,2807,,,,2807,2807,0,0,0,2
20150305,2807,2807,,,,2807,2807,0,0,0,2
20150306,2807,2807,,,,2807,2807,0,0,0,2
20150309,2807,2807,,,,2807,2807,0,0,0,2
20150310,2807,2807,,,,2807,2807,0,0,0,2
20150311,2807,2807,,,,2807,2807,0,0,0,2
20150312,2807,2807,,,,2807,2807,0,0,0,2
20150313,2807,2807,,,,2807,2807,0,0,0,2
20150316,2807,2807,,,,2807,2807,0,0,0,2
20150317,2807,2807,,,,2807,2807,0,0,0,2
20150318,2807,2807,,,,2807,2807,0,0,0,2
20150319,2807,2807,,,,2807,2807,0,0,0,2
20150320,2807,2807,,,,2807,2807,0,0,0,2
20150323,2807,2807,,,,2807,2807,0,0,0,2
20150324,2807,2807,,,,2807,2807,0,0,0,2
20150325,2807,2807,,,,2807,2807,0,0,0,2
20150326,2807,2807,,,,2823,2823,16,16,0,2
20150327,2823,2823,,,,2683,2683,-140,-140,0,2
20150330,2683,2683,,,,2603,2603,-80,-80,0,2
20150331,2603,2603,,,,2656,2656,53,53,0,2
20150401,2656,2656,,,,2656,2656,0,0,0,2
20150402,2656,2656,,,,2656,2656,0,0,0,2
20150403,2656,2656,,,,2656,2656,0,0,0,2
20150407,2656,2656,,,,2656,2656,0,0,0,2
20150408,2656,2656,,,,2656,2656,0,0,0,2
20150409,2656,2656,,,,2532,2532,-124,-124,0,2
20150410,2532,2532,,,,2532,2532,0,0,0,2
20150413,2532,2532,,,,2532,2532,0,0,0,2
20150414,2532,2532,,,,2532,2532,0,0,0,2
20150415,2532,2532,,,,2528,2528,-4,-4,0,2
20150416,2528,2528,,,,2528,2528,0,0,0,2
20150417,2528,2528,,,,2401,2401,-127,-127,0,2
20150420,2401,2401,,,,2513,2513,112,112,0,2
20150421,2513,2513,,,,2399,2399,-114,-114,0,2
20150422,2399,2399,,,,2399,2399,0,0,0,2
20150423,2399,2399,,,,2399,2399,0,0,0,2
20150424,2399,2399,,,,2399,2399,0,0,0,2
20150427,2399,2399,,,,2399,2399,0,0,0,2
20150428,2399,2399,,,,2399,2399,0,0,0,2
20150429,2399,2399,,,,2518,2518,119,119,0,2
20150430,2518,2518,,,,2518,2518,0,0,0,2
20150504,2518,2518,,,,2518,2518,0,0,0,2
20150505,2518,2518,,,,2518,2518,0,0,0,2
20150506,2518,2518,,,,2518,2518,0,0,0,2
20150507,2518,2518,,,,2518,2518,0,0,0,2
20150508,2518,2518,,,,2518,2518,0,0,0,2
20150511,2518,2518,,,,2518,2518,0,0,0,2
20150512,2518,2518,,,,2518,2518,0,0,0,2
20150513,2518,2518,,,,2518,2518,0,0,0,2
20150514,2518,2518,,,,2518,2518,0,0,0,2
20150515,2518,2518,,,,2420,2420,-98,-98,0,2
20150518,2420,2420,,,,2420,2420,0,0,0,2
20150519,2420,2420,,,,2420,2420,0,0,0,2
20150520,2420,2420,,,,2420,2420,0,0,0,2
20150521,2420,2420,,,,2420,2420,0,0,0,2
20150522,2420,2420,,,,2420,2420,0,0,0,2
20150525,2420,2420,,,,2420,2420,0,0,0,2
20150526,2420,2420,,,,2420,2420,0,0,0,2
20150527,2420,2420,,,,2420,2420,0,0,0,2
20150528,2420,2420,,,,2420,2420,0,0,0,2
20150529,2420,2420,,,,2420,2420,0,0,0,2
20150601,2420,2420,,,,2420,2420,0,0,0,2
20150602,2420,2420,,,,2420,2420,0,0,0,2
20150603,2420,2420,,,,2420,2420,0,0,0,2
20150604,2420,2420,,,,2420,2420,0,0,0,2
20150605,2420,2420,,,,2420,2420,0,0,0,2
20150608,2420,2420,,,,2420,2420,0,0,0,2
20150609,2420,2420,,,,2420,2420,0,0,0,2
20150610,2420,2420,,,,2420,2420,0,0,0,2
20150611,2420,2420,,,,2420,2420,0,0,0,2
20150612,2420,2420,,,,2420,2420,0,0,0,2
20150615,2420,2420,,,,2420,2420,0,0,0,2
20150616,2420,2420,,,,2420,2420,0,0,0,2
20150617,2420,2420,,,,2420,2420,0,0,0,2
20150618,2420,2420,,,,2420,2420,0,0,0,2
20150619,2420,2420,,,,2420,2420,0,0,0,2
20150623,2420,2420,,,,2420,2420,0,0,0,2
20150624,2420,2420,,,,2420,2420,0,0,0,2
20150625,2420,2420,,,,2420,2420,0,0,0,2
20150626,2420,2420,,,,2420,2420,0,0,0,2
20150629,2420,2420,,,,2420,2420,0,0,0,2
20150630,2420,2420,,,,2420,2420,0,0,0,2
20150701,2420,2420,,,,2420,2420,0,0,0,2
20150702,2420,2420,2350,2350,2350,2350,2350,-70,-70,2,4
20150703,2350,2350,,,,2350,2350,0,0,0,4
20150706,2350,2350,,,,2350,2350,0,0,0,4
20150707,2350,2350,,,,2350,2350,0,0,0,4
20150708,2350,2350,2240,2240,2240,2240,2240,-110,-110,2,6
20150709,2240,2240,,,,2240,2240,0,0,0,6
20150710,2240,2240,,,,2240,2240,0,0,0,6
20150713,2240,2240,,,,2240,2240,0,0,0,6
20150714,2240,2240,,,,2240,2240,0,0,0,6
20150715,2240,2240,,,,2240,2240,0,0,0,6
20150716,2240,2240,,,,2240,2240,0,0,0,6
20150717,2240,2240,,,,2240,2240,0,0,0,6
20150720,2240,2240,,,,2240,2240,0,0,0,6
20150721,2240,2240,,,,2240,2240,0,0,0,6
20150722,2240,2240,,,,2240,2240,0,0,0,6
20150723,2240,2240,,,,2240,2240,0,0,0,6
20150724,2240,2240,,,,2240,2240,0,0,0,6
20150727,2240,2240,,,,2240,2240,0,0,0,6
20150728,2240,2240,,,,2240,2240,0,0,0,6
20150729,2240,2240,2141,2141,2141,2141,2141,-99,-99,2,4
20150730,2141,2141,2118,2118,2118,2118,2118,-23,-23,2,2
20150731,2118,2118,2178,2178,2178,2178,2178,60,60,2,0
20150803,2178,2178,,,,2178,2178,0,0,0,0
20150804,2178,2178,,,,2178,2178,0,0,0,0
20150805,2178,2178,,,,2178,2178,0,0,0,0
20150806,2178,2178,,,,2178,2178,0,0,0,0
20150807,2178,2178,,,,2178,2178,0,0,0,0
20150810,2178,2178,,,,2178,2178,0,0,0,0
20150811,2178,2178,,,,2178,2178,0,0,0,0
20150812,2178,2178,,,,2178,2178,0,0,0,0
20150813,2178,2178,,,,2178,2178,0,0,0,0
20150814,2178,2178,,,,2178,2178,0,0,0,0
20150817,2178,2178,,,,2178,2178,0,0,0,0
wr1509,20150105,3037,3037,,,,3077,3077,40,40,0,0
20150106,3077,3077,,,,3077,3077,0,0,0,0
20150107,3077,3077,,,,3077,3077,0,0,0,0
20150108,3077,3077,,,,3077,3077,0,0,0,0
20150109,3077,3077,,,,2976,2976,-101,-101,0,0
20150112,2976,2976,,,,2955,2955,-21,-21,0,0
20150113,2955,2955,,,,2955,2955,0,0,0,0
20150114,2955,2955,,,,2955,2955,0,0,0,0
20150115,2955,2955,,,,2955,2955,0,0,0,0
20150116,2955,2955,,,,3001,3001,46,46,0,0
20150119,3001,3001,,,,3135,3135,134,134,0,0
20150120,3135,3135,,,,2981,2981,-154,-154,0,0
20150121,2981,2981,,,,2981,2981,0,0,0,0
20150122,2981,2981,,,,2981,2981,0,0,0,0
20150123,2981,2981,,,,3037,3037,56,56,0,0
20150126,3037,3037,,,,3037,3037,0,0,0,0
20150127,3037,3037,,,,2903,2903,-134,-134,0,0
20150128,2903,2903,,,,2903,2903,0,0,0,0
20150129,2903,2903,,,,2903,2903,0,0,0,0
20150130,2903,2903,,,,2903,2903,0,0,0,0
20150202,2903,2903,,,,2903,2903,0,0,0,0
20150203,2903,2903,,,,2903,2903,0,0,0,0
20150204,2903,2903,,,,2903,2903,0,0,0,0
20150205,2903,2903,,,,2760,2760,-143,-143,0,0
20150206,2760,2760,,,,2760,2760,0,0,0,0
20150209,2760,2760,,,,2760,2760,0,0,0,0
20150210,2760,2760,,,,2760,2760,0,0,0,0
20150211,2760,2760,,,,2760,2760,0,0,0,0
20150212,2760,2760,,,,2837,2837,77,77,0,0
20150213,2837,2837,,,,2970,2970,133,133,0,0
20150216,2970,2970,,,,2970,2970,0,0,0,0
20150217,2970,2970,,,,2970,2970,0,0,0,0
20150225,2970,2970,,,,2970,2970,0,0,0,0
20150226,2970,2970,,,,2970,2970,0,0,0,0
20150227,2970,2970,,,,2825,2825,-145,-145,0,0
20150302,2825,2825,,,,2780,2780,-45,-45,0,0
20150303,2780,2780,2510,2913,2510,2608,2643,-172,-137,12,0
20150304,2608,2643,,,,2643,2643,0,0,0,0
20150305,2643,2643,,,,2643,2643,0,0,0,0
20150306,2643,2643,2511,2775,2511,2775,2643,132,0,4,0
20150309,2775,2643,2536,2775,2536,2760,2665,117,22,46,0
20150310,2760,2665,,,,2665,2665,0,0,0,0
20150311,2665,2665,,,,2665,2665,0,0,0,0
20150312,2665,2665,,,,2665,2665,0,0,0,0
20150313,2665,2665,,,,2665,2665,0,0,0,0
20150316,2665,2665,,,,2665,2665,0,0,0,0
20150317,2665,2665,,,,2665,2665,0,0,0,0
20150318,2665,2665,,,,2665,2665,0,0,0,0
20150319,2665,2665,,,,2665,2665,0,0,0,0
20150320,2665,2665,,,,2665,2665,0,0,0,0
20150323,2665,2665,,,,2665,2665,0,0,0,0
20150324,2665,2665,,,,2665,2665,0,0,0,0
20150325,2665,2665,,,,2665,2665,0,0,0,0
20150326,2665,2665,,,,2680,2680,15,15,0,0
20150327,2680,2680,,,,2680,2680,0,0,0,0
20150330,2680,2680,,,,2600,2600,-80,-80,0,0
20150331,2600,2600,,,,2653,2653,53,53,0,0
20150401,2653,2653,,,,2653,2653,0,0,0,0
20150402,2653,2653,,,,2653,2653,0,0,0,0
20150403,2653,2653,,,,2653,2653,0,0,0,0
20150407,2653,2653,,,,2653,2653,0,0,0,0
20150408,2653,2653,,,,2653,2653,0,0,0,0
20150409,2653,2653,,,,2529,2529,-124,-124,0,0
20150410,2529,2529,,,,2529,2529,0,0,0,0
20150413,2529,2529,,,,2529,2529,0,0,0,0
20150414,2529,2529,,,,2529,2529,0,0,0,0
20150415,2529,2529,,,,2525,2525,-4,-4,0,0
20150416,2525,2525,,,,2525,2525,0,0,0,0
20150417,2525,2525,,,,2398,2398,-127,-127,0,0
20150420,2398,2398,,,,2510,2510,112,112,0,0
20150421,2510,2510,,,,2396,2396,-114,-114,0,0
20150422,2396,2396,,,,2396,2396,0,0,0,0
20150423,2396,2396,,,,2396,2396,0,0,0,0
20150424,2396,2396,,,,2396,2396,0,0,0,0
20150427,2396,2396,,,,2396,2396,0,0,0,0
20150428,2396,2396,,,,2396,2396,0,0,0,0
20150429,2396,2396,,,,2514,2514,118,118,0,0
20150430,2514,2514,,,,2514,2514,0,0,0,0
20150504,2514,2514,,,,2514,2514,0,0,0,0
20150505,2514,2514,,,,2514,2514,0,0,0,0
20150506,2514,2514,,,,2514,2514,0,0,0,0
20150507,2514,2514,,,,2514,2514,0,0,0,0
20150508,2514,2514,,,,2514,2514,0,0,0,0
20150511,2514,2514,,,,2514,2514,0,0,0,0
20150512,2514,2514,,,,2514,2514,0,0,0,0
20150513,2514,2514,,,,2514,2514,0,0,0,0
20150514,2514,2514,,,,2514,2514,0,0,0,0
20150515,2514,2514,,,,2416,2416,-98,-98,0,0
20150518,2416,2416,,,,2416,2416,0,0,0,0
20150519,2416,2416,,,,2416,2416,0,0,0,0
20150520,2416,2416,,,,2416,2416,0,0,0,0
20150521,2416,2416,,,,2416,2416,0,0,0,0
20150522,2416,2416,,,,2416,2416,0,0,0,0
20150525,2416,2416,,,,2416,2416,0,0,0,0
20150526,2416,2416,,,,2416,2416,0,0,0,0
20150527,2416,2416,,,,2416,2416,0,0,0,0
20150528,2416,2416,,,,2416,2416,0,0,0,0
20150529,2416,2416,,,,2416,2416,0,0,0,0
20150601,2416,2416,,,,2416,2416,0,0,0,0
20150602,2416,2416,,,,2416,2416,0,0,0,0
20150603,2416,2416,,,,2416,2416,0,0,0,0
20150604,2416,2416,,,,2416,2416,0,0,0,0
20150605,2416,2416,,,,2416,2416,0,0,0,0
20150608,2416,2416,,,,2416,2416,0,0,0,0
20150609,2416,2416,,,,2416,2416,0,0,0,0
20150610,2416,2416,,,,2416,2416,0,0,0,0
20150611,2416,2416,,,,2416,2416,0,0,0,0
20150612,2416,2416,2300,2536,2300,2536,2497,120,81,14,4
20150615,2536,2497,,,,2588,2588,91,91,0,4
20150616,2588,2588,2626,2715,2527,2626,2612,38,24,18,0
20150617,2626,2612,,,,2612,2612,0,0,0,0
20150618,2612,2612,,,,2612,2612,0,0,0,0
20150619,2612,2612,,,,2612,2612,0,0,0,0
20150623,2612,2612,,,,2612,2612,0,0,0,0
20150624,2612,2612,,,,2612,2612,0,0,0,0
20150625,2612,2612,,,,2612,2612,0,0,0,0
20150626,2612,2612,,,,2612,2612,0,0,0,0
20150629,2612,2612,,,,2612,2612,0,0,0,0
20150630,2612,2612,,,,2612,2612,0,0,0,0
20150701,2612,2612,,,,2612,2612,0,0,0,0
20150702,2612,2612,,,,2536,2536,-76,-76,0,0
20150703,2536,2536,,,,2536,2536,0,0,0,0
20150706,2536,2536,,,,2536,2536,0,0,0,0
20150707,2536,2536,,,,2536,2536,0,0,0,0
20150708,2536,2536,,,,2417,2417,-119,-119,0,0
20150709,2417,2417,,,,2417,2417,0,0,0,0
20150710,2417,2417,,,,2417,2417,0,0,0,0
20150713,2417,2417,,,,2417,2417,0,0,0,0
20150714,2417,2417,,,,2417,2417,0,0,0,0
20150715,2417,2417,,,,2417,2417,0,0,0,0
20150716,2417,2417,,,,2417,2417,0,0,0,0
20150717,2417,2417,,,,2417,2417,0,0,0,0
20150720,2417,2417,,,,2417,2417,0,0,0,0
20150721,2417,2417,,,,2417,2417,0,0,0,0
20150722,2417,2417,,,,2417,2417,0,0,0,0
20150723,2417,2417,,,,2417,2417,0,0,0,0
20150724,2417,2417,,,,2417,2417,0,0,0,0
20150727,2417,2417,2300,2537,2300,2537,2418,120,1,56,0
20150728,2537,2418,,,,2418,2418,0,0,0,0
20150729,2418,2418,,,,2311,2311,-107,-107,0,0
20150730,2311,2311,,,,2286,2286,-25,-25,0,0
20150731,2286,2286,,,,2350,2350,64,64,0,0
20150803,2350,2350,,,,2350,2350,0,0,0,0
20150804,2350,2350,,,,2350,2350,0,0,0,0
20150805,2350,2350,,,,2350,2350,0,0,0,0
20150806,2350,2350,,,,2350,2350,0,0,0,0
20150807,2350,2350,,,,2350,2350,0,0,0,0
20150810,2350,2350,,,,2350,2350,0,0,0,0
20150811,2350,2350,,,,2350,2350,0,0,0,0
20150812,2350,2350,,,,2350,2350,0,0,0,0
20150813,2350,2350,,,,2350,2350,0,0,0,0
20150814,2350,2350,,,,2350,2350,0,0,0,0
20150817,2350,2350,,,,2350,2350,0,0,0,0
20150818,2350,2350,,,,2350,2350,0,0,0,0
20150819,2350,2350,,,,2350,2350,0,0,0,0
20150820,2350,2350,,,,2350,2350,0,0,0,0
20150821,2350,2350,,,,2350,2350,0,0,0,0
20150824,2350,2350,,,,2350,2350,0,0,0,0
20150825,2350,2350,,,,2350,2350,0,0,0,0
20150826,2350,2350,,,,2350,2350,0,0,0,0
20150827,2350,2350,,,,2350,2350,0,0,0,0
20150828,2350,2350,,,,2350,2350,0,0,0,0
20150831,2350,2350,,,,2350,2350,0,0,0,0
20150901,2350,2350,,,,2350,2350,0,0,0,0
20150902,2350,2350,,,,2350,2350,0,0,0,0
20150907,2350,2350,,,,2350,2350,0,0,0,0
20150908,2350,2350,,,,2350,2350,0,0,0,0
20150909,2350,2350,,,,2350,2350,0,0,0,0
20150910,2350,2350,,,,2350,2350,0,0,0,0
20150911,2350,2350,,,,2350,2350,0,0,0,0
20150914,2350,2350,,,,2350,2350,0,0,0,0
20150915,2350,2350,,,,2350,2350,0,0,0,0
wr1510,20150105,3167,3167,,,,3209,3209,42,42,0,0
20150106,3209,3209,,,,3209,3209,0,0,0,0
20150107,3209,3209,,,,3209,3209,0,0,0,0
20150108,3209,3209,,,,3209,3209,0,0,0,0
20150109,3209,3209,,,,3104,3104,-105,-105,0,0
20150112,3104,3104,,,,3082,3082,-22,-22,0,0
20150113,3082,3082,,,,3082,3082,0,0,0,0
20150114,3082,3082,,,,3082,3082,0,0,0,0
20150115,3082,3082,,,,3082,3082,0,0,0,0
20150116,3082,3082,,,,3130,3130,48,48,0,0
20150119,3130,3130,,,,3270,3270,140,140,0,0
20150120,3270,3270,,,,3109,3109,-161,-161,0,0
20150121,3109,3109,,,,3109,3109,0,0,0,0
20150122,3109,3109,,,,3109,3109,0,0,0,0
20150123,3109,3109,,,,3168,3168,59,59,0,0
20150126,3168,3168,,,,3168,3168,0,0,0,0
20150127,3168,3168,,,,3028,3028,-140,-140,0,0
20150128,3028,3028,,,,3028,3028,0,0,0,0
20150129,3028,3028,,,,3028,3028,0,0,0,0
20150130,3028,3028,,,,3028,3028,0,0,0,0
20150202,3028,3028,,,,3028,3028,0,0,0,0
20150203,3028,3028,,,,3028,3028,0,0,0,0
20150204,3028,3028,,,,3028,3028,0,0,0,0
20150205,3028,3028,,,,2879,2879,-149,-149,0,0
20150206,2879,2879,,,,2879,2879,0,0,0,0
20150209,2879,2879,,,,2879,2879,0,0,0,0
20150210,2879,2879,,,,2879,2879,0,0,0,0
20150211,2879,2879,,,,2879,2879,0,0,0,0
20150212,2879,2879,,,,2960,2960,81,81,0,0
20150213,2960,2960,,,,3099,3099,139,139,0,0
20150216,3099,3099,,,,3099,3099,0,0,0,0
20150217,3099,3099,,,,3099,3099,0,0,0,0
20150225,3099,3099,,,,3099,3099,0,0,0,0
20150226,3099,3099,,,,3099,3099,0,0,0,0
20150227,3099,3099,,,,2948,2948,-151,-151,0,0
20150302,2948,2948,2956,2956,2956,2956,2956,8,8,6,6
20150303,2956,2956,,,,2810,2810,-146,-146,0,6
20150304,2810,2810,,,,2810,2810,0,0,0,6
20150305,2810,2810,,,,2810,2810,0,0,0,6
20150306,2810,2810,,,,2810,2810,0,0,0,6
20150309,2810,2810,,,,2834,2834,24,24,0,6
20150310,2834,2834,,,,2834,2834,0,0,0,6
20150311,2834,2834,,,,2834,2834,0,0,0,6
20150312,2834,2834,,,,2834,2834,0,0,0,6
20150313,2834,2834,,,,2834,2834,0,0,0,6
20150316,2834,2834,,,,2834,2834,0,0,0,6
20150317,2834,2834,,,,2834,2834,0,0,0,6
20150318,2834,2834,,,,2834,2834,0,0,0,6
20150319,2834,2834,,,,2834,2834,0,0,0,6
20150320,2834,2834,,,,2834,2834,0,0,0,6
20150323,2834,2834,,,,2834,2834,0,0,0,6
20150324,2834,2834,,,,2834,2834,0,0,0,6
20150325,2834,2834,,,,2834,2834,0,0,0,6
20150326,2834,2834,,,,2850,2850,16,16,0,6
20150327,2850,2850,,,,2709,2709,-141,-141,0,6
20150330,2709,2709,,,,2628,2628,-81,-81,0,6
20150331,2628,2628,,,,2681,2681,53,53,0,6
20150401,2681,2681,,,,2681,2681,0,0,0,6
20150402,2681,2681,2745,2745,2745,2745,2745,64,64,2,8
20150403,2745,2745,2745,2745,2745,2745,2745,0,0,2,10
20150407,2745,2745,,,,2745,2745,0,0,0,10
20150408,2745,2745,,,,2745,2745,0,0,0,10
20150409,2745,2745,,,,2617,2617,-128,-128,0,10
20150410,2617,2617,,,,2617,2617,0,0,0,10
20150413,2617,2617,,,,2617,2617,0,0,0,10
20150414,2617,2617,,,,2617,2617,0,0,0,10
20150415,2617,2617,,,,2613,2613,-4,-4,0,10
20150416,2613,2613,,,,2613,2613,0,0,0,10
20150417,2613,2613,,,,2482,2482,-131,-131,0,10
20150420,2482,2482,2482,2606,2477,2606,2521,124,39,6,8
20150421,2606,2521,2499,2499,2487,2487,2493,-34,-28,4,8
20150422,2487,2493,,,,2493,2493,0,0,0,8
20150423,2493,2493,,,,2493,2493,0,0,0,8
20150424,2493,2493,2610,2610,2610,2610,2610,117,117,2,6
20150427,2610,2610,2740,2740,2740,2740,2740,130,130,6,10
20150428,2740,2740,2549,2795,2549,2790,2658,50,-82,12,10
20150429,2790,2658,,,,2658,2658,0,0,0,10
20150430,2658,2658,2540,2750,2540,2746,2684,88,26,8,8
20150504,2746,2684,2818,2818,2710,2710,2796,26,112,16,18
20150505,2710,2796,,,,2796,2796,0,0,0,18
20150506,2796,2796,2820,2895,2810,2895,2863,99,67,10,22
20150507,2895,2863,2755,2830,2755,2810,2797,-53,-66,18,12
20150508,2810,2797,2775,2844,2700,2844,2759,47,-38,10,12
20150511,2844,2759,2825,2839,2825,2839,2832,80,73,4,12
20150512,2839,2832,2895,2895,2690,2697,2760,-135,-72,6,8
20150513,2697,2760,,,,2760,2760,0,0,0,8
20150514,2760,2760,,,,2760,2760,0,0,0,8
20150515,2760,2760,,,,2653,2653,-107,-107,0,8
20150518,2653,2653,,,,2653,2653,0,0,0,8
20150519,2653,2653,,,,2653,2653,0,0,0,8
20150520,2653,2653,2597,2597,2597,2597,2597,-56,-56,2,8
20150521,2597,2597,,,,2597,2597,0,0,0,8
20150522,2597,2597,,,,2597,2597,0,0,0,8
20150525,2597,2597,,,,2597,2597,0,0,0,8
20150526,2597,2597,,,,2597,2597,0,0,0,8
20150527,2597,2597,,,,2597,2597,0,0,0,8
20150528,2597,2597,,,,2597,2597,0,0,0,8
20150529,2597,2597,,,,2597,2597,0,0,0,8
20150601,2597,2597,,,,2597,2597,0,0,0,8
20150602,2597,2597,,,,2597,2597,0,0,0,8
20150603,2597,2597,,,,2597,2597,0,0,0,8
20150604,2597,2597,,,,2597,2597,0,0,0,8
20150605,2597,2597,,,,2597,2597,0,0,0,8
20150608,2597,2597,,,,2597,2597,0,0,0,8
20150609,2597,2597,,,,2597,2597,0,0,0,8
20150610,2597,2597,,,,2597,2597,0,0,0,8
20150611,2597,2597,,,,2597,2597,0,0,0,8
20150612,2597,2597,,,,2684,2684,87,87,0,8
20150615,2684,2684,,,,2684,2684,0,0,0,8
20150616,2684,2684,,,,2709,2709,25,25,0,8
20150617,2709,2709,,,,2709,2709,0,0,0,8
20150618,2709,2709,,,,2709,2709,0,0,0,8
20150619,2709,2709,,,,2709,2709,0,0,0,8
20150623,2709,2709,,,,2709,2709,0,0,0,8
20150624,2709,2709,,,,2709,2709,0,0,0,8
20150625,2709,2709,,,,2709,2709,0,0,0,8
20150626,2709,2709,,,,2709,2709,0,0,0,8
20150629,2709,2709,,,,2709,2709,0,0,0,8
20150630,2709,2709,2709,2709,2709,2709,2709,0,0,4,10
20150701,2709,2709,,,,2709,2709,0,0,0,10
20150702,2709,2709,,,,2630,2630,-79,-79,0,10
20150703,2630,2630,,,,2630,2630,0,0,0,10
20150706,2630,2630,,,,2630,2630,0,0,0,10
20150707,2630,2630,2498,2498,2498,2498,2498,-132,-132,4,10
20150708,2498,2498,2489,2489,2489,2489,2489,-9,-9,2,10
20150709,2489,2489,,,,2489,2489,0,0,0,10
20150710,2489,2489,,,,2489,2489,0,0,0,10
20150713,2489,2489,,,,2489,2489,0,0,0,10
20150714,2489,2489,,,,2489,2489,0,0,0,10
20150715,2489,2489,,,,2489,2489,0,0,0,10
20150716,2489,2489,,,,2489,2489,0,0,0,10
20150717,2489,2489,,,,2489,2489,0,0,0,10
20150720,2489,2489,,,,2489,2489,0,0,0,10
20150721,2489,2489,2364,2364,2364,2364,2364,-125,-125,2,8
20150722,2364,2364,,,,2364,2364,0,0,0,8
20150723,2364,2364,,,,2364,2364,0,0,0,8
20150724,2364,2364,,,,2364,2364,0,0,0,8
20150727,2364,2364,,,,2365,2365,1,1,0,8
20150728,2365,2365,,,,2365,2365,0,0,0,8
20150729,2365,2365,,,,2260,2260,-105,-105,0,8
20150730,2260,2260,,,,2235,2235,-25,-25,0,8
20150731,2235,2235,,,,2298,2298,63,63,0,8
20150803,2298,2298,,,,2298,2298,0,0,0,8
20150804,2298,2298,,,,2298,2298,0,0,0,8
20150805,2298,2298,,,,2298,2298,0,0,0,8
20150806,2298,2298,,,,2298,2298,0,0,0,8
20150807,2298,2298,,,,2298,2298,0,0,0,8
20150810,2298,2298,,,,2298,2298,0,0,0,8
20150811,2298,2298,,,,2298,2298,0,0,0,8
20150812,2298,2298,,,,2298,2298,0,0,0,8
20150813,2298,2298,,,,2298,2298,0,0,0,8
20150814,2298,2298,,,,2298,2298,0,0,0,8
20150817,2298,2298,,,,2298,2298,0,0,0,8
20150818,2298,2298,,,,2298,2298,0,0,0,8
20150819,2298,2298,,,,2298,2298,0,0,0,8
20150820,2298,2298,,,,2298,2298,0,0,0,8
20150821,2298,2298,,,,2298,2298,0,0,0,8
20150824,2298,2298,,,,2298,2298,0,0,0,8
20150825,2298,2298,2211,2211,2211,2211,2211,-87,-87,6,14
20150826,2211,2211,,,,2211,2211,0,0,0,14
20150827,2211,2211,,,,2211,2211,0,0,0,14
20150828,2211,2211,,,,2211,2211,0,0,0,14
20150831,2211,2211,,,,2211,2211,0,0,0,14
20150901,2211,2211,,,,2211,2211,0,0,0,14
20150902,2211,2211,,,,2211,2211,0,0,0,14
20150907,2211,2211,,,,2211,2211,0,0,0,14
20150908,2211,2211,,,,2211,2211,0,0,0,14
20150909,2211,2211,,,,2211,2211,0,0,0,14
20150910,2211,2211,,,,2211,2211,0,0,0,14
20150911,2211,2211,,,,2211,2211,0,0,0,14
20150914,2211,2211,,,,2211,2211,0,0,0,14
20150915,2211,2211,,,,2211,2211,0,0,0,14
20150916,2211,2211,,,,2211,2211,0,0,0,14
20150917,2211,2211,,,,2211,2211,0,0,0,14
20150918,2211,2211,,,,2211,2211,0,0,0,14
20150921,2211,2211,2211,2211,2211,2211,2211,0,0,2,12
20150922,2211,2211,,,,2211,2211,0,0,0,12
20150923,2211,2211,,,,2211,2211,0,0,0,12
20150924,2211,2211,2211,2211,2211,2211,2211,0,0,2,10
20150925,2211,2211,2150,2150,2150,2150,2150,-61,-61,4,6
20150928,2150,2150,2170,2170,2098,2098,2122,-52,-28,6,0
20150929,2098,2122,,,,2122,2122,0,0,0,0
20150930,2122,2122,,,,2122,2122,0,0,0,0
20151008,2122,2122,,,,2122,2122,0,0,0,0
20151009,2122,2122,,,,2122,2122,0,0,0,0
20151012,2122,2122,,,,2122,2122,0,0,0,0
20151013,2122,2122,,,,2122,2122,0,0,0,0
20151014,2122,2122,,,,2122,2122,0,0,0,0
20151015,2122,2122,,,,2122,2122,0,0,0,0
wr1511,20150105,2795,2795,,,,2795,2795,0,0,0,4
20150106,2795,2795,,,,2795,2795,0,0,0,4
20150107,2795,2795,,,,2795,2795,0,0,0,4
20150108,2795,2795,,,,2799,2799,4,4,0,4
20150109,2799,2799,,,,2799,2799,0,0,0,4
20150112,2799,2799,,,,2779,2779,-20,-20,0,4
20150113,2779,2779,,,,2779,2779,0,0,0,4
20150114,2779,2779,,,,2779,2779,0,0,0,4
20150115,2779,2779,,,,2779,2779,0,0,0,4
20150116,2779,2779,,,,2822,2822,43,43,0,4
20150119,2822,2822,,,,2948,2948,126,126,0,4
20150120,2948,2948,,,,2803,2803,-145,-145,0,4
20150121,2803,2803,,,,2803,2803,0,0,0,4
20150122,2803,2803,,,,2803,2803,0,0,0,4
20150123,2803,2803,,,,2803,2803,0,0,0,4
20150126,2803,2803,,,,2803,2803,0,0,0,4
20150127,2803,2803,,,,2803,2803,0,0,0,4
20150128,2803,2803,,,,2803,2803,0,0,0,4
20150129,2803,2803,,,,2803,2803,0,0,0,4
20150130,2803,2803,,,,2803,2803,0,0,0,4
20150202,2803,2803,,,,2803,2803,0,0,0,4
20150203,2803,2803,,,,2803,2803,0,0,0,4
20150204,2803,2803,,,,2803,2803,0,0,0,4
20150205,2803,2803,,,,2803,2803,0,0,0,4
20150206,2803,2803,,,,2803,2803,0,0,0,4
20150209,2803,2803,,,,2803,2803,0,0,0,4
20150210,2803,2803,,,,2803,2803,0,0,0,4
20150211,2803,2803,,,,2803,2803,0,0,0,4
20150212,2803,2803,,,,2803,2803,0,0,0,4
20150213,2803,2803,2862,2862,2862,2862,2862,59,59,2,6
20150216,2862,2862,,,,2862,2862,0,0,0,6
20150217,2862,2862,,,,2862,2862,0,0,0,6
20150225,2862,2862,,,,2862,2862,0,0,0,6
20150226,2862,2862,,,,2862,2862,0,0,0,6
20150227,2862,2862,,,,2862,2862,0,0,0,6
20150302,2862,2862,,,,2869,2869,7,7,0,6
20150303,2869,2869,,,,2869,2869,0,0,0,6
20150304,2869,2869,,,,2869,2869,0,0,0,6
20150305,2869,2869,,,,2869,2869,0,0,0,6
20150306,2869,2869,,,,2869,2869,0,0,0,6
20150309,2869,2869,,,,2893,2893,24,24,0,6
20150310,2893,2893,,,,2893,2893,0,0,0,6
20150311,2893,2893,,,,2893,2893,0,0,0,6
20150312,2893,2893,,,,2810,2810,-83,-83,0,6
20150313,2810,2810,,,,2810,2810,0,0,0,6
20150316,2810,2810,2810,2810,2810,2810,2810,0,0,2,6
20150317,2810,2810,,,,2804,2804,-6,-6,0,6
20150318,2804,2804,2804,2804,2804,2804,2804,0,0,2,6
20150319,2804,2804,2804,2804,2780,2780,2798,-24,-6,8,6
20150320,2780,2798,2658,2658,2658,2658,2658,-140,-140,2,4
20150323,2658,2658,,,,2658,2658,0,0,0,4
20150324,2658,2658,,,,2658,2658,0,0,0,4
20150325,2658,2658,,,,2658,2658,0,0,0,4
20150326,2658,2658,,,,2673,2673,15,15,0,4
20150327,2673,2673,,,,2541,2541,-132,-132,0,4
20150330,2541,2541,,,,2668,2668,127,127,0,4
20150331,2668,2668,,,,2668,2668,0,0,0,4
20150401,2668,2668,,,,2668,2668,0,0,0,4
20150402,2668,2668,,,,2731,2731,63,63,0,4
20150403,2731,2731,,,,2731,2731,0,0,0,4
20150407,2731,2731,,,,2731,2731,0,0,0,4
20150408,2731,2731,,,,2731,2731,0,0,0,4
20150409,2731,2731,,,,2603,2603,-128,-128,0,4
20150410,2603,2603,,,,2603,2603,0,0,0,4
20150413,2603,2603,,,,2603,2603,0,0,0,4
20150414,2603,2603,,,,2603,2603,0,0,0,4
20150415,2603,2603,,,,2599,2599,-4,-4,0,4
20150416,2599,2599,,,,2599,2599,0,0,0,4
20150417,2599,2599,,,,2599,2599,0,0,0,4
20150420,2599,2599,,,,2599,2599,0,0,0,4
20150421,2599,2599,,,,2599,2599,0,0,0,4
20150422,2599,2599,,,,2599,2599,0,0,0,4
20150423,2599,2599,,,,2599,2599,0,0,0,4
20150424,2599,2599,,,,2720,2720,121,121,0,4
20150427,2720,2720,,,,2720,2720,0,0,0,4
20150428,2720,2720,,,,2638,2638,-82,-82,0,4
20150429,2638,2638,,,,2768,2768,130,130,0,4
20150430,2768,2768,,,,2768,2768,0,0,0,4
20150504,2768,2768,,,,2884,2884,116,116,0,4
20150505,2884,2884,,,,2884,2884,0,0,0,4
20150506,2884,2884,,,,2953,2953,69,69,0,4
20150507,2953,2953,,,,2885,2885,-68,-68,0,4
20150508,2885,2885,,,,2846,2846,-39,-39,0,4
20150511,2846,2846,,,,2921,2921,75,75,0,4
20150512,2921,2921,,,,2847,2847,-74,-74,0,4
20150513,2847,2847,,,,2847,2847,0,0,0,4
20150514,2847,2847,,,,2847,2847,0,0,0,4
20150515,2847,2847,,,,2737,2737,-110,-110,0,4
20150518,2737,2737,,,,2737,2737,0,0,0,4
20150519,2737,2737,,,,2737,2737,0,0,0,4
20150520,2737,2737,,,,2679,2679,-58,-58,0,4
20150521,2679,2679,,,,2679,2679,0,0,0,4
20150522,2679,2679,,,,2679,2679,0,0,0,4
20150525,2679,2679,,,,2679,2679,0,0,0,4
20150526,2679,2679,,,,2679,2679,0,0,0,4
20150527,2679,2679,,,,2679,2679,0,0,0,4
20150528,2679,2679,,,,2679,2679,0,0,0,4
20150529,2679,2679,,,,2679,2679,0,0,0,4
20150601,2679,2679,,,,2679,2679,0,0,0,4
20150602,2679,2679,,,,2679,2679,0,0,0,4
20150603,2679,2679,,,,2679,2679,0,0,0,4
20150604,2679,2679,,,,2679,2679,0,0,0,4
20150605,2679,2679,,,,2679,2679,0,0,0,4
20150608,2679,2679,,,,2679,2679,0,0,0,4
20150609,2679,2679,,,,2679,2679,0,0,0,4
20150610,2679,2679,,,,2679,2679,0,0,0,4
20150611,2679,2679,,,,2679,2679,0,0,0,4
20150612,2679,2679,,,,2768,2768,89,89,0,4
20150615,2768,2768,,,,2768,2768,0,0,0,4
20150616,2768,2768,,,,2794,2794,26,26,0,4
20150617,2794,2794,,,,2794,2794,0,0,0,4
20150618,2794,2794,,,,2794,2794,0,0,0,4
20150619,2794,2794,,,,2794,2794,0,0,0,4
20150623,2794,2794,,,,2794,2794,0,0,0,4
20150624,2794,2794,,,,2794,2794,0,0,0,4
20150625,2794,2794,,,,2794,2794,0,0,0,4
20150626,2794,2794,,,,2794,2794,0,0,0,4
20150629,2794,2794,,,,2794,2794,0,0,0,4
20150630,2794,2794,,,,2794,2794,0,0,0,4
20150701,2794,2794,,,,2794,2794,0,0,0,4
20150702,2794,2794,,,,2713,2713,-81,-81,0,4
20150703,2713,2713,,,,2713,2713,0,0,0,4
20150706,2713,2713,,,,2713,2713,0,0,0,4
20150707,2713,2713,,,,2577,2577,-136,-136,0,4
20150708,2577,2577,,,,2567,2567,-10,-10,0,4
20150709,2567,2567,,,,2567,2567,0,0,0,4
20150710,2567,2567,,,,2567,2567,0,0,0,4
20150713,2567,2567,,,,2567,2567,0,0,0,4
20150714,2567,2567,,,,2567,2567,0,0,0,4
20150715,2567,2567,,,,2567,2567,0,0,0,4
20150716,2567,2567,,,,2567,2567,0,0,0,4
20150717,2567,2567,,,,2567,2567,0,0,0,4
20150720,2567,2567,2690,2690,2438,2438,2560,-129,-7,6,6
20150721,2438,2560,,,,2560,2560,0,0,0,6
20150722,2560,2560,,,,2560,2560,0,0,0,6
20150723,2560,2560,,,,2560,2560,0,0,0,6
20150724,2560,2560,,,,2560,2560,0,0,0,6
20150727,2560,2560,,,,2561,2561,1,1,0,6
20150728,2561,2561,,,,2561,2561,0,0,0,6
20150729,2561,2561,,,,2447,2447,-114,-114,0,6
20150730,2447,2447,,,,2420,2420,-27,-27,0,6
20150731,2420,2420,,,,2488,2488,68,68,0,6
20150803,2488,2488,,,,2488,2488,0,0,0,6
20150804,2488,2488,,,,2488,2488,0,0,0,6
20150805,2488,2488,,,,2488,2488,0,0,0,6
20150806,2488,2488,,,,2488,2488,0,0,0,6
20150807,2488,2488,2488,2488,2488,2488,2488,0,0,2,4
20150810,2488,2488,,,,2488,2488,0,0,0,4
20150811,2488,2488,,,,2488,2488,0,0,0,4
20150812,2488,2488,,,,2488,2488,0,0,0,4
20150813,2488,2488,,,,2488,2488,0,0,0,4
20150814,2488,2488,,,,2488,2488,0,0,0,4
20150817,2488,2488,,,,2488,2488,0,0,0,4
20150818,2488,2488,,,,2488,2488,0,0,0,4
20150819,2488,2488,,,,2488,2488,0,0,0,4
20150820,2488,2488,,,,2488,2488,0,0,0,4
20150821,2488,2488,,,,2488,2488,0,0,0,4
20150824,2488,2488,,,,2488,2488,0,0,0,4
20150825,2488,2488,,,,2393,2393,-95,-95,0,4
20150826,2393,2393,,,,2393,2393,0,0,0,4
20150827,2393,2393,,,,2393,2393,0,0,0,4
20150828,2393,2393,,,,2393,2393,0,0,0,4
20150831,2393,2393,,,,2393,2393,0,0,0,4
20150901,2393,2393,,,,2393,2393,0,0,0,4
20150902,2393,2393,,,,2393,2393,0,0,0,4
20150907,2393,2393,,,,2393,2393,0,0,0,4
20150908,2393,2393,,,,2393,2393,0,0,0,4
20150909,2393,2393,,,,2393,2393,0,0,0,4
20150910,2393,2393,,,,2393,2393,0,0,0,4
20150911,2393,2393,,,,2393,2393,0,0,0,4
20150914,2393,2393,,,,2393,2393,0,0,0,4
20150915,2393,2393,,,,2393,2393,0,0,0,4
20150916,2393,2393,,,,2393,2393,0,0,0,4
20150917,2393,2393,,,,2393,2393,0,0,0,4
20150918,2393,2393,,,,2393,2393,0,0,0,4
20150921,2393,2393,,,,2393,2393,0,0,0,4
20150922,2393,2393,,,,2393,2393,0,0,0,4
20150923,2393,2393,,,,2393,2393,0,0,0,4
20150924,2393,2393,,,,2393,2393,0,0,0,4
20150925,2393,2393,,,,2326,2326,-67,-67,0,4
20150928,2326,2326,,,,2326,2326,0,0,0,4
20150929,2326,2326,,,,2326,2326,0,0,0,4
20150930,2326,2326,2200,2200,2163,2163,2181,-163,-145,4,4
20151008,2163,2181,2098,2098,2098,2098,2098,-83,-83,2,6
20151009,2098,2098,,,,2098,2098,0,0,0,6
20151012,2098,2098,,,,2098,2098,0,0,0,6
20151013,2098,2098,,,,2098,2098,0,0,0,6
20151014,2098,2098,,,,2098,2098,0,0,0,6
20151015,2098,2098,,,,2098,2098,0,0,0,6
20151016,2098,2098,,,,2098,2098,0,0,0,6
20151019,2098,2098,,,,2098,2098,0,0,0,6
20151020,2098,2098,,,,2098,2098,0,0,0,6
20151021,2098,2098,,,,2098,2098,0,0,0,6
20151022,2098,2098,,,,2098,2098,0,0,0,6
20151023,2098,2098,,,,2098,2098,0,0,0,6
20151026,2098,2098,,,,2098,2098,0,0,0,6
20151027,2098,2098,,,,2098,2098,0,0,0,6
20151028,2098,2098,2038,2038,2038,2038,2038,-60,-60,2,4
20151029,2038,2038,2139,2139,2038,2038,2088,0,50,4,0
20151030,2038,2088,,,,2088,2088,0,0,0,0
20151102,2088,2088,,,,2088,2088,0,0,0,0
20151103,2088,2088,,,,2088,2088,0,0,0,0
20151104,2088,2088,,,,2088,2088,0,0,0,0
20151105,2088,2088,,,,2088,2088,0,0,0,0
20151106,2088,2088,,,,2088,2088,0,0,0,0
20151109,2088,2088,,,,2088,2088,0,0,0,0
20151110,2088,2088,,,,2088,2088,0,0,0,0
20151111,2088,2088,,,,2088,2088,0,0,0,0
20151112,2088,2088,,,,2088,2088,0,0,0,0
20151113,2088,2088,,,,2088,2088,0,0,0,0
20151116,2088,2088,,,,2088,2088,0,0,0,0
wr1512,20150105,2851,2851,,,,2888,2888,37,37,0,0
20150106,2888,2888,,,,2888,2888,0,0,0,0
20150107,2888,2888,,,,2888,2888,0,0,0,0
20150108,2888,2888,,,,2888,2888,0,0,0,0
20150109,2888,2888,,,,2793,2793,-95,-95,0,0
20150112,2793,2793,,,,2773,2773,-20,-20,0,0
20150113,2773,2773,,,,2773,2773,0,0,0,0
20150114,2773,2773,,,,2773,2773,0,0,0,0
20150115,2773,2773,,,,2773,2773,0,0,0,0
20150116,2773,2773,,,,2816,2816,43,43,0,0
20150119,2816,2816,,,,2942,2942,126,126,0,0
20150120,2942,2942,,,,2798,2798,-144,-144,0,0
20150121,2798,2798,,,,2798,2798,0,0,0,0
20150122,2798,2798,,,,2798,2798,0,0,0,0
20150123,2798,2798,,,,2851,2851,53,53,0,0
20150126,2851,2851,,,,2851,2851,0,0,0,0
20150127,2851,2851,,,,2725,2725,-126,-126,0,0
20150128,2725,2725,,,,2725,2725,0,0,0,0
20150129,2725,2725,,,,2725,2725,0,0,0,0
20150130,2725,2725,,,,2725,2725,0,0,0,0
20150202,2725,2725,,,,2725,2725,0,0,0,0
20150203,2725,2725,,,,2725,2725,0,0,0,0
20150204,2725,2725,,,,2725,2725,0,0,0,0
20150205,2725,2725,,,,2591,2591,-134,-134,0,0
20150206,2591,2591,,,,2591,2591,0,0,0,0
20150209,2591,2591,,,,2591,2591,0,0,0,0
20150210,2591,2591,,,,2591,2591,0,0,0,0
20150211,2591,2591,,,,2591,2591,0,0,0,0
20150212,2591,2591,,,,2664,2664,73,73,0,0
20150213,2664,2664,,,,2720,2720,56,56,0,0
20150216,2720,2720,,,,2720,2720,0,0,0,0
20150217,2720,2720,,,,2720,2720,0,0,0,0
20150225,2720,2720,,,,2720,2720,0,0,0,0
20150226,2720,2720,,,,2720,2720,0,0,0,0
20150227,2720,2720,,,,2587,2587,-133,-133,0,0
20150302,2587,2587,,,,2594,2594,7,7,0,0
20150303,2594,2594,,,,2466,2466,-128,-128,0,0
20150304,2466,2466,,,,2589,2589,123,123,0,0
20150305,2589,2589,,,,2589,2589,0,0,0,0
20150306,2589,2589,,,,2589,2589,0,0,0,0
20150309,2589,2589,,,,2611,2611,22,22,0,0
20150310,2611,2611,,,,2611,2611,0,0,0,0
20150311,2611,2611,,,,2611,2611,0,0,0,0
20150312,2611,2611,,,,2611,2611,0,0,0,0
20150313,2611,2611,,,,2611,2611,0,0,0,0
20150316,2611,2611,,,,2611,2611,0,0,0,0
20150317,2611,2611,,,,2611,2611,0,0,0,0
20150318,2611,2611,,,,2611,2611,0,0,0,0
20150319,2611,2611,,,,2605,2605,-6,-6,0,0
20150320,2605,2605,,,,2474,2474,-131,-131,0,0
20150323,2474,2474,,,,2474,2474,0,0,0,0
20150324,2474,2474,,,,2474,2474,0,0,0,0
20150325,2474,2474,,,,2474,2474,0,0,0,0
20150326,2474,2474,,,,2488,2488,14,14,0,0
20150327,2488,2488,,,,2365,2365,-123,-123,0,0
20150330,2365,2365,,,,2294,2294,-71,-71,0,0
20150331,2294,2294,,,,2340,2340,46,46,0,0
20150401,2340,2340,,,,2340,2340,0,0,0,0
20150402,2340,2340,,,,2395,2395,55,55,0,0
20150403,2395,2395,,,,2395,2395,0,0,0,0
20150407,2395,2395,,,,2395,2395,0,0,0,0
20150408,2395,2395,,,,2395,2395,0,0,0,0
20150409,2395,2395,,,,2283,2283,-112,-112,0,0
20150410,2283,2283,,,,2283,2283,0,0,0,0
20150413,2283,2283,,,,2283,2283,0,0,0,0
20150414,2283,2283,,,,2283,2283,0,0,0,0
20150415,2283,2283,,,,2280,2280,-3,-3,0,0
20150416,2280,2280,,,,2280,2280,0,0,0,0
20150417,2280,2280,,,,2166,2166,-114,-114,0,0
20150420,2166,2166,,,,2200,2200,34,34,0,0
20150421,2200,2200,,,,2175,2175,-25,-25,0,0
20150422,2175,2175,,,,2175,2175,0,0,0,0
20150423,2175,2175,,,,2283,2283,108,108,0,0
20150424,2283,2283,,,,2390,2390,107,107,0,0
20150427,2390,2390,,,,2509,2509,119,119,0,0
20150428,2509,2509,,,,2433,2433,-76,-76,0,0
20150429,2433,2433,,,,2553,2553,120,120,0,0
20150430,2553,2553,,,,2577,2577,24,24,0,0
20150504,2577,2577,,,,2685,2685,108,108,0,0
20150505,2685,2685,,,,2685,2685,0,0,0,0
20150506,2685,2685,,,,2749,2749,64,64,0,0
20150507,2749,2749,,,,2686,2686,-63,-63,0,0
20150508,2686,2686,,,,2650,2650,-36,-36,0,0
20150511,2650,2650,,,,2720,2720,70,70,0,0
20150512,2720,2720,,,,2651,2651,-69,-69,0,0
20150513,2651,2651,2783,2783,2656,2770,2741,119,90,30,4
20150514,2770,2741,,,,2741,2741,0,0,0,4
20150515,2741,2741,,,,2741,2741,0,0,0,4
20150518,2741,2741,,,,2741,2741,0,0,0,4
20150519,2741,2741,,,,2741,2741,0,0,0,4
20150520,2741,2741,,,,2741,2741,0,0,0,4
20150521,2741,2741,,,,2741,2741,0,0,0,4
20150522,2741,2741,,,,2741,2741,0,0,0,4
20150525,2741,2741,,,,2741,2741,0,0,0,4
20150526,2741,2741,,,,2741,2741,0,0,0,4
20150527,2741,2741,,,,2741,2741,0,0,0,4
20150528,2741,2741,,,,2741,2741,0,0,0,4
20150529,2741,2741,,,,2741,2741,0,0,0,4
20150601,2741,2741,,,,2741,2741,0,0,0,4
20150602,2741,2741,2838,2838,2606,2798,2744,57,3,10,2
20150603,2798,2744,,,,2744,2744,0,0,0,2
20150604,2744,2744,,,,2744,2744,0,0,0,2
20150605,2744,2744,,,,2744,2744,0,0,0,2
20150608,2744,2744,,,,2744,2744,0,0,0,2
20150609,2744,2744,2798,2804,2606,2647,2719,-97,-25,16,0
20150610,2647,2719,,,,2719,2719,0,0,0,0
20150611,2719,2719,,,,2719,2719,0,0,0,0
20150612,2719,2719,,,,2810,2810,91,91,0,0
20150615,2810,2810,,,,2810,2810,0,0,0,0
20150616,2810,2810,2669,2709,2669,2709,2689,-101,-121,24,0
20150617,2709,2689,2795,2795,2627,2627,2737,-62,48,6,4
20150618,2627,2737,,,,2737,2737,0,0,0,4
20150619,2737,2737,,,,2737,2737,0,0,0,4
20150623,2737,2737,2615,2615,2615,2615,2615,-122,-122,2,2
20150624,2615,2615,,,,2615,2615,0,0,0,2
20150625,2615,2615,,,,2615,2615,0,0,0,2
20150626,2615,2615,,,,2615,2615,0,0,0,2
20150629,2615,2615,,,,2615,2615,0,0,0,2
20150630,2615,2615,,,,2615,2615,0,0,0,2
20150701,2615,2615,,,,2615,2615,0,0,0,2
20150702,2615,2615,,,,2539,2539,-76,-76,0,2
20150703,2539,2539,,,,2539,2539,0,0,0,2
20150706,2539,2539,,,,2539,2539,0,0,0,2
20150707,2539,2539,,,,2412,2412,-127,-127,0,2
20150708,2412,2412,,,,2403,2403,-9,-9,0,2
20150709,2403,2403,,,,2403,2403,0,0,0,2
20150710,2403,2403,,,,2403,2403,0,0,0,2
20150713,2403,2403,,,,2403,2403,0,0,0,2
20150714,2403,2403,,,,2403,2403,0,0,0,2
20150715,2403,2403,,,,2403,2403,0,0,0,2
20150716,2403,2403,,,,2403,2403,0,0,0,2
20150717,2403,2403,,,,2403,2403,0,0,0,2
20150720,2403,2403,,,,2396,2396,-7,-7,0,2
20150721,2396,2396,,,,2276,2276,-120,-120,0,2
20150722,2276,2276,,,,2276,2276,0,0,0,2
20150723,2276,2276,,,,2276,2276,0,0,0,2
20150724,2276,2276,,,,2276,2276,0,0,0,2
20150727,2276,2276,,,,2277,2277,1,1,0,2
20150728,2277,2277,,,,2277,2277,0,0,0,2
20150729,2277,2277,,,,2176,2176,-101,-101,0,2
20150730,2176,2176,,,,2152,2152,-24,-24,0,2
20150731,2152,2152,,,,2212,2212,60,60,0,2
20150803,2212,2212,,,,2212,2212,0,0,0,2
20150804,2212,2212,,,,2212,2212,0,0,0,2
20150805,2212,2212,,,,2212,2212,0,0,0,2
20150806,2212,2212,,,,2212,2212,0,0,0,2
20150807,2212,2212,,,,2212,2212,0,0,0,2
20150810,2212,2212,,,,2212,2212,0,0,0,2
20150811,2212,2212,,,,2212,2212,0,0,0,2
20150812,2212,2212,,,,2212,2212,0,0,0,2
20150813,2212,2212,,,,2212,2212,0,0,0,2
20150814,2212,2212,,,,2212,2212,0,0,0,2
20150817,2212,2212,,,,2212,2212,0,0,0,2
20150818,2212,2212,,,,2212,2212,0,0,0,2
20150819,2212,2212,,,,2212,2212,0,0,0,2
20150820,2212,2212,,,,2212,2212,0,0,0,2
20150821,2212,2212,,,,2212,2212,0,0,0,2
20150824,2212,2212,,,,2212,2212,0,0,0,2
20150825,2212,2212,,,,2128,2128,-84,-84,0,2
20150826,2128,2128,,,,2128,2128,0,0,0,2
20150827,2128,2128,,,,2128,2128,0,0,0,2
20150828,2128,2128,,,,2128,2128,0,0,0,2
20150831,2128,2128,,,,2128,2128,0,0,0,2
20150901,2128,2128,,,,2128,2128,0,0,0,2
20150902,2128,2128,,,,2128,2128,0,0,0,2
20150907,2128,2128,,,,2128,2128,0,0,0,2
20150908,2128,2128,,,,2128,2128,0,0,0,2
20150909,2128,2128,,,,2128,2128,0,0,0,2
20150910,2128,2128,,,,2128,2128,0,0,0,2
20150911,2128,2128,2234,2234,2025,2025,2129,-103,1,4,2
20150914,2025,2129,,,,2129,2129,0,0,0,2
20150915,2129,2129,,,,2129,2129,0,0,0,2
20150916,2129,2129,,,,2129,2129,0,0,0,2
20150917,2129,2129,,,,2129,2129,0,0,0,2
20150918,2129,2129,,,,2129,2129,0,0,0,2
20150921,2129,2129,,,,2129,2129,0,0,0,2
20150922,2129,2129,,,,2129,2129,0,0,0,2
20150923,2129,2129,,,,2129,2129,0,0,0,2
20150924,2129,2129,,,,2129,2129,0,0,0,2
20150925,2129,2129,,,,2070,2070,-59,-59,0,2
20150928,2070,2070,,,,2043,2043,-27,-27,0,2
20150929,2043,2043,,,,2043,2043,0,0,0,2
20150930,2043,2043,,,,1916,1916,-127,-127,0,2
20151008,1916,1916,,,,1843,1843,-73,-73,0,2
20151009,1843,1843,,,,1843,1843,0,0,0,2
20151012,1843,1843,1843,1843,1751,1751,1797,-92,-46,4,2
20151013,1751,1797,,,,1797,1797,0,0,0,2
20151014,1797,1797,,,,1797,1797,0,0,0,2
20151015,1797,1797,,,,1797,1797,0,0,0,2
20151016,1797,1797,,,,1797,1797,0,0,0,2
20151019,1797,1797,,,,1797,1797,0,0,0,2
20151020,1797,1797,,,,1797,1797,0,0,0,2
20151021,1797,1797,,,,1797,1797,0,0,0,2
20151022,1797,1797,,,,1797,1797,0,0,0,2
20151023,1797,1797,,,,1797,1797,0,0,0,2
20151026,1797,1797,,,,1797,1797,0,0,0,2
20151027,1797,1797,,,,1797,1797,0,0,0,2
20151028,1797,1797,,,,1745,1745,-52,-52,0,2
20151029,1745,1745,,,,1788,1788,43,43,0,2
20151030,1788,1788,,,,1788,1788,0,0,0,2
20151102,1788,1788,,,,1788,1788,0,0,0,2
20151103,1788,1788,,,,1788,1788,0,0,0,2
20151104,1788,1788,,,,1788,1788,0,0,0,2
20151105,1788,1788,,,,1788,1788,0,0,0,2
20151106,1788,1788,,,,1788,1788,0,0,0,2
20151109,1788,1788,,,,1788,1788,0,0,0,2
20151110,1788,1788,,,,1788,1788,0,0,0,2
20151111,1788,1788,,,,1788,1788,0,0,0,2
20151112,1788,1788,,,,1788,1788,0,0,0,2
20151113,1788,1788,,,,1788,1788,0,0,0,2
20151116,1788,1788,,,,1788,1788,0,0,0,2
20151117,1788,1788,,,,1788,1788,0,0,0,2
20151118,1788,1788,,,,1788,1788,0,0,0,2
20151119,1788,1788,,,,1788,1788,0,0,0,2
20151120,1788,1788,,,,1788,1788,0,0,0,2
20151123,1788,1788,,,,1788,1788,0,0,0,2
20151124,1788,1788,,,,1788,1788,0,0,0,2
20151125,1788,1788,,,,1788,1788,0,0,0,2
20151126,1788,1788,,,,1788,1788,0,0,0,2
20151127,1788,1788,,,,1788,1788,0,0,0,2
20151130,1788,1788,1698,1875,1698,1801,1791,13,3,6,0
wr1601,20150116,2773,2773,,,,2816,2816,43,43,0,0
20150119,2816,2816,,,,2942,2942,126,126,0,0
20150120,2942,2942,,,,2942,2942,0,0,0,0
20150121,2942,2942,,,,2942,2942,0,0,0,0
20150122,2942,2942,,,,2930,2930,-12,-12,0,0
20150123,2930,2930,,,,2900,2900,-30,-30,0,0
20150126,2900,2900,,,,2900,2900,0,0,0,0
20150127,2900,2900,,,,2772,2772,-128,-128,0,0
20150128,2772,2772,,,,2772,2772,0,0,0,0
20150129,2772,2772,,,,2772,2772,0,0,0,0
20150130,2772,2772,,,,2772,2772,0,0,0,0
20150202,2772,2772,,,,2772,2772,0,0,0,0
20150203,2772,2772,,,,2772,2772,0,0,0,0
20150204,2772,2772,,,,2772,2772,0,0,0,0
20150205,2772,2772,,,,2635,2635,-137,-137,0,0
20150206,2635,2635,,,,2635,2635,0,0,0,0
20150209,2635,2635,,,,2635,2635,0,0,0,0
20150210,2635,2635,,,,2635,2635,0,0,0,0
20150211,2635,2635,,,,2635,2635,0,0,0,0
20150212,2635,2635,,,,2709,2709,74,74,0,0
20150213,2709,2709,,,,2766,2766,57,57,0,0
20150216,2766,2766,,,,2766,2766,0,0,0,0
20150217,2766,2766,,,,2766,2766,0,0,0,0
20150225,2766,2766,,,,2766,2766,0,0,0,0
20150226,2766,2766,,,,2766,2766,0,0,0,0
20150227,2766,2766,,,,2631,2631,-135,-135,0,0
20150302,2631,2631,,,,2638,2638,7,7,0,0
20150303,2638,2638,2380,2901,2380,2870,2730,232,92,22,0
20150304,2870,2730,,,,2730,2730,0,0,0,0
20150305,2730,2730,,,,2730,2730,0,0,0,0
20150306,2730,2730,,,,2730,2730,0,0,0,0
20150309,2730,2730,,,,2753,2753,23,23,0,0
20150310,2753,2753,,,,2753,2753,0,0,0,0
20150311,2753,2753,,,,2753,2753,0,0,0,0
20150312,2753,2753,,,,2753,2753,0,0,0,0
20150313,2753,2753,,,,2753,2753,0,0,0,0
20150316,2753,2753,,,,2753,2753,0,0,0,0
20150317,2753,2753,,,,2753,2753,0,0,0,0
20150318,2753,2753,,,,2753,2753,0,0,0,0
20150319,2753,2753,,,,2747,2747,-6,-6,0,0
20150320,2747,2747,,,,2609,2609,-138,-138,0,0
20150323,2609,2609,,,,2609,2609,0,0,0,0
20150324,2609,2609,,,,2609,2609,0,0,0,0
20150325,2609,2609,,,,2609,2609,0,0,0,0
20150326,2609,2609,,,,2623,2623,14,14,0,0
20150327,2623,2623,,,,2493,2493,-130,-130,0,0
20150330,2493,2493,,,,2418,2418,-75,-75,0,0
20150331,2418,2418,,,,2467,2467,49,49,0,0
20150401,2467,2467,,,,2467,2467,0,0,0,0
20150402,2467,2467,,,,2525,2525,58,58,0,0
20150403,2525,2525,,,,2525,2525,0,0,0,0
20150407,2525,2525,,,,2525,2525,0,0,0,0
20150408,2525,2525,,,,2525,2525,0,0,0,0
20150409,2525,2525,,,,2407,2407,-118,-118,0,0
20150410,2407,2407,,,,2407,2407,0,0,0,0
20150413,2407,2407,,,,2407,2407,0,0,0,0
20150414,2407,2407,,,,2407,2407,0,0,0,0
20150415,2407,2407,,,,2404,2404,-3,-3,0,0
20150416,2404,2404,,,,2404,2404,0,0,0,0
20150417,2404,2404,,,,2283,2283,-121,-121,0,0
20150420,2283,2283,,,,2319,2319,36,36,0,0
20150421,2319,2319,,,,2293,2293,-26,-26,0,0
20150422,2293,2293,,,,2293,2293,0,0,0,0
20150423,2293,2293,,,,2293,2293,0,0,0,0
20150424,2293,2293,,,,2400,2400,107,107,0,0
20150427,2400,2400,,,,2519,2519,119,119,0,0
20150428,2519,2519,,,,2443,2443,-76,-76,0,0
20150429,2443,2443,,,,2564,2564,121,121,0,0
20150430,2564,2564,,,,2589,2589,25,25,0,0
20150504,2589,2589,,,,2697,2697,108,108,0,0
20150505,2697,2697,,,,2697,2697,0,0,0,0
20150506,2697,2697,,,,2761,2761,64,64,0,0
20150507,2761,2761,,,,2697,2697,-64,-64,0,0
20150508,2697,2697,,,,2661,2661,-36,-36,0,0
20150511,2661,2661,,,,2731,2731,70,70,0,0
20150512,2731,2731,,,,2662,2662,-69,-69,0,0
20150513,2662,2662,,,,2752,2752,90,90,0,0
20150514,2752,2752,,,,2752,2752,0,0,0,0
20150515,2752,2752,,,,2645,2645,-107,-107,0,0
20150518,2645,2645,,,,2645,2645,0,0,0,0
20150519,2645,2645,,,,2645,2645,0,0,0,0
20150520,2645,2645,,,,2589,2589,-56,-56,0,0
20150521,2589,2589,,,,2589,2589,0,0,0,0
20150522,2589,2589,,,,2589,2589,0,0,0,0
20150525,2589,2589,,,,2589,2589,0,0,0,0
20150526,2589,2589,,,,2589,2589,0,0,0,0
20150527,2589,2589,,,,2589,2589,0,0,0,0
20150528,2589,2589,,,,2589,2589,0,0,0,0
20150529,2589,2589,,,,2589,2589,0,0,0,0
20150601,2589,2589,,,,2589,2589,0,0,0,0
20150602,2589,2589,,,,2591,2591,2,2,0,0
20150603,2591,2591,,,,2591,2591,0,0,0,0
20150604,2591,2591,,,,2591,2591,0,0,0,0
20150605,2591,2591,,,,2591,2591,0,0,0,0
20150608,2591,2591,,,,2591,2591,0,0,0,0
20150609,2591,2591,,,,2567,2567,-24,-24,0,0
20150610,2567,2567,,,,2567,2567,0,0,0,0
20150611,2567,2567,,,,2567,2567,0,0,0,0
20150612,2567,2567,,,,2653,2653,86,86,0,0
20150615,2653,2653,,,,2653,2653,0,0,0,0
20150616,2653,2653,,,,2538,2538,-115,-115,0,0
20150617,2538,2538,,,,2583,2583,45,45,0,0
20150618,2583,2583,,,,2583,2583,0,0,0,0
20150619,2583,2583,,,,2583,2583,0,0,0,0
20150623,2583,2583,,,,2467,2467,-116,-116,0,0
20150624,2467,2467,,,,2467,2467,0,0,0,0
20150625,2467,2467,,,,2467,2467,0,0,0,0
20150626,2467,2467,,,,2467,2467,0,0,0,0
20150629,2467,2467,,,,2467,2467,0,0,0,0
20150630,2467,2467,,,,2467,2467,0,0,0,0
20150701,2467,2467,,,,2467,2467,0,0,0,0
20150702,2467,2467,,,,2395,2395,-72,-72,0,0
20150703,2395,2395,,,,2395,2395,0,0,0,0
20150706,2395,2395,,,,2395,2395,0,0,0,0
20150707,2395,2395,,,,2275,2275,-120,-120,0,0
20150708,2275,2275,,,,2266,2266,-9,-9,0,0
20150709,2266,2266,,,,2266,2266,0,0,0,0
20150710,2266,2266,,,,2266,2266,0,0,0,0
20150713,2266,2266,,,,2266,2266,0,0,0,0
20150714,2266,2266,,,,2266,2266,0,0,0,0
20150715,2266,2266,,,,2266,2266,0,0,0,0
20150716,2266,2266,,,,2266,2266,0,0,0,0
20150717,2266,2266,,,,2266,2266,0,0,0,0
20150720,2266,2266,,,,2259,2259,-7,-7,0,0
20150721,2259,2259,,,,2146,2146,-113,-113,0,0
20150722,2146,2146,,,,2146,2146,0,0,0,0
20150723,2146,2146,,,,2146,2146,0,0,0,0
20150724,2146,2146,,,,2146,2146,0,0,0,0
20150727,2146,2146,,,,2147,2147,1,1,0,0
20150728,2147,2147,,,,2147,2147,0,0,0,0
20150729,2147,2147,,,,2052,2052,-95,-95,0,0
20150730,2052,2052,,,,2029,2029,-23,-23,0,0
20150731,2029,2029,,,,2086,2086,57,57,0,0
20150803,2086,2086,,,,2086,2086,0,0,0,0
20150804,2086,2086,,,,2086,2086,0,0,0,0
20150805,2086,2086,,,,2086,2086,0,0,0,0
20150806,2086,2086,,,,2086,2086,0,0,0,0
20150807,2086,2086,,,,2086,2086,0,0,0,0
20150810,2086,2086,,,,2086,2086,0,0,0,0
20150811,2086,2086,,,,2086,2086,0,0,0,0
20150812,2086,2086,,,,2086,2086,0,0,0,0
20150813,2086,2086,,,,2086,2086,0,0,0,0
20150814,2086,2086,,,,2086,2086,0,0,0,0
20150817,2086,2086,,,,2086,2086,0,0,0,0
20150818,2086,2086,,,,2086,2086,0,0,0,0
20150819,2086,2086,,,,2086,2086,0,0,0,0
20150820,2086,2086,,,,2086,2086,0,0,0,0
20150821,2086,2086,2190,2190,2190,2190,2190,104,104,4,4
20150824,2190,2190,2190,2190,2190,2190,2190,0,0,2,2
20150825,2190,2190,,,,2107,2107,-83,-83,0,2
20150826,2107,2107,,,,2107,2107,0,0,0,2
20150827,2107,2107,,,,2107,2107,0,0,0,2
20150828,2107,2107,,,,2107,2107,0,0,0,2
20150831,2107,2107,,,,2107,2107,0,0,0,2
20150901,2107,2107,,,,2107,2107,0,0,0,2
20150902,2107,2107,,,,2107,2107,0,0,0,2
20150907,2107,2107,,,,2107,2107,0,0,0,2
20150908,2107,2107,,,,2107,2107,0,0,0,2
20150909,2107,2107,,,,2107,2107,0,0,0,2
20150910,2107,2107,,,,2107,2107,0,0,0,2
20150911,2107,2107,,,,2108,2108,1,1,0,2
20150914,2108,2108,,,,2108,2108,0,0,0,2
20150915,2108,2108,,,,2108,2108,0,0,0,2
20150916,2108,2108,,,,2108,2108,0,0,0,2
20150917,2108,2108,,,,2108,2108,0,0,0,2
20150918,2108,2108,,,,2108,2108,0,0,0,2
20150921,2108,2108,,,,2108,2108,0,0,0,2
20150922,2108,2108,,,,2108,2108,0,0,0,2
20150923,2108,2108,,,,2108,2108,0,0,0,2
20150924,2108,2108,,,,2108,2108,0,0,0,2
20150925,2108,2108,,,,2049,2049,-59,-59,0,2
20150928,2049,2049,,,,2022,2022,-27,-27,0,2
20150929,2022,2022,,,,2022,2022,0,0,0,2
20150930,2022,2022,,,,1896,1896,-126,-126,0,2
20151008,1896,1896,,,,1823,1823,-73,-73,0,2
20151009,1823,1823,,,,1823,1823,0,0,0,2
20151012,1823,1823,,,,1777,1777,-46,-46,0,2
20151013,1777,1777,,,,1777,1777,0,0,0,2
20151014,1777,1777,,,,1777,1777,0,0,0,2
20151015,1777,1777,,,,1777,1777,0,0,0,2
20151016,1777,1777,,,,1777,1777,0,0,0,2
20151019,1777,1777,,,,1777,1777,0,0,0,2
20151020,1777,1777,,,,1777,1777,0,0,0,2
20151021,1777,1777,,,,1777,1777,0,0,0,2
20151022,1777,1777,,,,1865,1865,88,88,0,2
20151023,1865,1865,,,,1958,1958,93,93,0,2
20151026,1958,1958,,,,1958,1958,0,0,0,2
20151027,1958,1958,,,,2055,2055,97,97,0,2
20151028,2055,2055,2070,2070,2070,2070,2070,15,15,2,0
20151029,2070,2070,,,,2121,2121,51,51,0,0
20151030,2121,2121,,,,2121,2121,0,0,0,0
20151102,2121,2121,,,,2121,2121,0,0,0,0
20151103,2121,2121,,,,2121,2121,0,0,0,0
20151104,2121,2121,,,,2121,2121,0,0,0,0
20151105,2121,2121,,,,2121,2121,0,0,0,0
20151106,2121,2121,,,,2121,2121,0,0,0,0
20151109,2121,2121,,,,2121,2121,0,0,0,0
20151110,2121,2121,,,,2121,2121,0,0,0,0
20151111,2121,2121,,,,2121,2121,0,0,0,0
20151112,2121,2121,,,,2121,2121,0,0,0,0
20151113,2121,2121,,,,2121,2121,0,0,0,0
20151116,2121,2121,,,,2121,2121,0,0,0,0
20151117,2121,2121,,,,2121,2121,0,0,0,0
20151118,2121,2121,,,,2121,2121,0,0,0,0
20151119,2121,2121,,,,2121,2121,0,0,0,0
20151120,2121,2121,,,,2121,2121,0,0,0,0
20151123,2121,2121,,,,2121,2121,0,0,0,0
20151124,2121,2121,,,,2121,2121,0,0,0,0
20151125,2121,2121,,,,2121,2121,0,0,0,0
20151126,2121,2121,,,,2121,2121,0,0,0,0
20151127,2121,2121,,,,2121,2121,0,0,0,0
20151130,2121,2121,,,,2124,2124,3,3,0,0
wr1602,20150216,2766,2766,,,,2766,2766,0,0,0,0
20150217,2766,2766,,,,2766,2766,0,0,0,0
20150225,2766,2766,,,,2766,2766,0,0,0,0
20150226,2766,2766,,,,2766,2766,0,0,0,0
20150227,2766,2766,,,,2631,2631,-135,-135,0,0
20150302,2631,2631,,,,2638,2638,7,7,0,0
20150303,2638,2638,,,,2730,2730,92,92,0,0
20150304,2730,2730,,,,2730,2730,0,0,0,0
20150305,2730,2730,,,,2730,2730,0,0,0,0
20150306,2730,2730,,,,2730,2730,0,0,0,0
20150309,2730,2730,,,,2730,2730,0,0,0,0
20150310,2730,2730,,,,2730,2730,0,0,0,0
20150311,2730,2730,,,,2730,2730,0,0,0,0
20150312,2730,2730,,,,2730,2730,0,0,0,0
20150313,2730,2730,,,,2730,2730,0,0,0,0
20150316,2730,2730,,,,2730,2730,0,0,0,0
20150317,2730,2730,,,,2730,2730,0,0,0,0
20150318,2730,2730,,,,2730,2730,0,0,0,0
20150319,2730,2730,,,,2724,2724,-6,-6,0,0
20150320,2724,2724,,,,2587,2587,-137,-137,0,0
20150323,2587,2587,,,,2587,2587,0,0,0,0
20150324,2587,2587,,,,2587,2587,0,0,0,0
20150325,2587,2587,,,,2587,2587,0,0,0,0
20150326,2587,2587,,,,2601,2601,14,14,0,0
20150327,2601,2601,,,,2472,2472,-129,-129,0,0
20150330,2472,2472,,,,2398,2398,-74,-74,0,0
20150331,2398,2398,,,,2447,2447,49,49,0,0
20150401,2447,2447,,,,2447,2447,0,0,0,0
20150402,2447,2447,,,,2505,2505,58,58,0,0
20150403,2505,2505,,,,2505,2505,0,0,0,0
20150407,2505,2505,,,,2505,2505,0,0,0,0
20150408,2505,2505,,,,2505,2505,0,0,0,0
20150409,2505,2505,,,,2388,2388,-117,-117,0,0
20150410,2388,2388,,,,2388,2388,0,0,0,0
20150413,2388,2388,,,,2388,2388,0,0,0,0
20150414,2388,2388,,,,2388,2388,0,0,0,0
20150415,2388,2388,,,,2385,2385,-3,-3,0,0
20150416,2385,2385,,,,2385,2385,0,0,0,0
20150417,2385,2385,,,,2146,2146,-239,-239,0,0
20150420,2146,2146,,,,2180,2180,34,34,0,0
20150421,2180,2180,,,,2155,2155,-25,-25,0,0
20150422,2155,2155,,,,2155,2155,0,0,0,0
20150423,2155,2155,,,,2155,2155,0,0,0,0
20150424,2155,2155,,,,2256,2256,101,101,0,0
20150427,2256,2256,,,,2368,2368,112,112,0,0
20150428,2368,2368,,,,2297,2297,-71,-71,0,0
20150429,2297,2297,,,,2410,2410,113,113,0,0
20150430,2410,2410,,,,2433,2433,23,23,0,0
20150504,2433,2433,,,,2535,2535,102,102,0,0
20150505,2535,2535,,,,2535,2535,0,0,0,0
20150506,2535,2535,,,,2595,2595,60,60,0,0
20150507,2595,2595,,,,2535,2535,-60,-60,0,0
20150508,2535,2535,,,,2501,2501,-34,-34,0,0
20150511,2501,2501,,,,2567,2567,66,66,0,0
20150512,2567,2567,2823,2823,2400,2560,2651,-7,84,8,0
20150513,2560,2651,,,,2741,2741,90,90,0,0
20150514,2741,2741,,,,2741,2741,0,0,0,0
20150515,2741,2741,,,,2635,2635,-106,-106,0,0
20150518,2635,2635,,,,2635,2635,0,0,0,0
20150519,2635,2635,,,,2635,2635,0,0,0,0
20150520,2635,2635,,,,2579,2579,-56,-56,0,0
20150521,2579,2579,,,,2579,2579,0,0,0,0
20150522,2579,2579,,,,2579,2579,0,0,0,0
20150525,2579,2579,,,,2579,2579,0,0,0,0
20150526,2579,2579,,,,2579,2579,0,0,0,0
20150527,2579,2579,,,,2579,2579,0,0,0,0
20150528,2579,2579,,,,2579,2579,0,0,0,0
20150529,2579,2579,,,,2579,2579,0,0,0,0
20150601,2579,2579,,,,2579,2579,0,0,0,0
20150602,2579,2579,,,,2581,2581,2,2,0,0
20150603,2581,2581,,,,2581,2581,0,0,0,0
20150604,2581,2581,,,,2581,2581,0,0,0,0
20150605,2581,2581,,,,2581,2581,0,0,0,0
20150608,2581,2581,,,,2581,2581,0,0,0,0
20150609,2581,2581,,,,2558,2558,-23,-23,0,0
20150610,2558,2558,,,,2558,2558,0,0,0,0
20150611,2558,2558,,,,2558,2558,0,0,0,0
20150612,2558,2558,,,,2643,2643,85,85,0,0
20150615,2643,2643,,,,2643,2643,0,0,0,0
20150616,2643,2643,,,,2529,2529,-114,-114,0,0
20150617,2529,2529,,,,2574,2574,45,45,0,0
20150618,2574,2574,,,,2574,2574,0,0,0,0
20150619,2574,2574,,,,2574,2574,0,0,0,0
20150623,2574,2574,,,,2459,2459,-115,-115,0,0
20150624,2459,2459,,,,2459,2459,0,0,0,0
20150625,2459,2459,,,,2459,2459,0,0,0,0
20150626,2459,2459,,,,2459,2459,0,0,0,0
20150629,2459,2459,,,,2459,2459,0,0,0,0
20150630,2459,2459,,,,2459,2459,0,0,0,0
20150701,2459,2459,,,,2459,2459,0,0,0,0
20150702,2459,2459,,,,2387,2387,-72,-72,0,0
20150703,2387,2387,,,,2387,2387,0,0,0,0
20150706,2387,2387,,,,2387,2387,0,0,0,0
20150707,2387,2387,,,,2267,2267,-120,-120,0,0
20150708,2267,2267,,,,2258,2258,-9,-9,0,0
20150709,2258,2258,,,,2258,2258,0,0,0,0
20150710,2258,2258,,,,2258,2258,0,0,0,0
20150713,2258,2258,,,,2258,2258,0,0,0,0
20150714,2258,2258,,,,2258,2258,0,0,0,0
20150715,2258,2258,,,,2258,2258,0,0,0,0
20150716,2258,2258,,,,2258,2258,0,0,0,0
20150717,2258,2258,,,,2258,2258,0,0,0,0
20150720,2258,2258,,,,2251,2251,-7,-7,0,0
20150721,2251,2251,,,,2138,2138,-113,-113,0,0
20150722,2138,2138,,,,2138,2138,0,0,0,0
20150723,2138,2138,,,,2138,2138,0,0,0,0
20150724,2138,2138,,,,2138,2138,0,0,0,0
20150727,2138,2138,,,,2139,2139,1,1,0,0
20150728,2139,2139,,,,2139,2139,0,0,0,0
20150729,2139,2139,,,,2044,2044,-95,-95,0,0
20150730,2044,2044,,,,2022,2022,-22,-22,0,0
20150731,2022,2022,,,,2079,2079,57,57,0,0
20150803,2079,2079,,,,2079,2079,0,0,0,0
20150804,2079,2079,,,,2079,2079,0,0,0,0
20150805,2079,2079,,,,2079,2079,0,0,0,0
20150806,2079,2079,,,,2079,2079,0,0,0,0
20150807,2079,2079,,,,2079,2079,0,0,0,0
20150810,2079,2079,,,,2079,2079,0,0,0,0
20150811,2079,2079,,,,2079,2079,0,0,0,0
20150812,2079,2079,,,,2079,2079,0,0,0,0
20150813,2079,2079,,,,2079,2079,0,0,0,0
20150814,2079,2079,,,,2079,2079,0,0,0,0
20150817,2079,2079,,,,2079,2079,0,0,0,0
20150818,2079,2079,,,,2079,2079,0,0,0,0
20150819,2079,2079,,,,2079,2079,0,0,0,0
20150820,2079,2079,,,,2079,2079,0,0,0,0
20150821,2079,2079,,,,2182,2182,103,103,0,0
20150824,2182,2182,,,,2182,2182,0,0,0,0
20150825,2182,2182,,,,2099,2099,-83,-83,0,0
20150826,2099,2099,,,,2099,2099,0,0,0,0
20150827,2099,2099,,,,2099,2099,0,0,0,0
20150828,2099,2099,,,,2099,2099,0,0,0,0
20150831,2099,2099,,,,2099,2099,0,0,0,0
20150901,2099,2099,,,,2099,2099,0,0,0,0
20150902,2099,2099,,,,2099,2099,0,0,0,0
20150907,2099,2099,,,,2099,2099,0,0,0,0
20150908,2099,2099,,,,2099,2099,0,0,0,0
20150909,2099,2099,,,,2099,2099,0,0,0,0
20150910,2099,2099,,,,2099,2099,0,0,0,0
20150911,2099,2099,,,,2100,2100,1,1,0,0
20150914,2100,2100,,,,2100,2100,0,0,0,0
20150915,2100,2100,,,,2100,2100,0,0,0,0
20150916,2100,2100,,,,2100,2100,0,0,0,0
20150917,2100,2100,,,,2100,2100,0,0,0,0
20150918,2100,2100,,,,2100,2100,0,0,0,0
20150921,2100,2100,,,,2100,2100,0,0,0,0
20150922,2100,2100,,,,2100,2100,0,0,0,0
20150923,2100,2100,,,,2100,2100,0,0,0,0
20150924,2100,2100,,,,2100,2100,0,0,0,0
20150925,2100,2100,,,,2042,2042,-58,-58,0,0
20150928,2042,2042,,,,2015,2015,-27,-27,0,0
20150929,2015,2015,,,,2015,2015,0,0,0,0
20150930,2015,2015,,,,1889,1889,-126,-126,0,0
20151008,1889,1889,,,,1817,1817,-72,-72,0,0
20151009,1817,1817,,,,1817,1817,0,0,0,0
20151012,1817,1817,,,,1771,1771,-46,-46,0,0
20151013,1771,1771,,,,1771,1771,0,0,0,0
20151014,1771,1771,,,,1771,1771,0,0,0,0
20151015,1771,1771,,,,1771,1771,0,0,0,0
20151016,1771,1771,,,,1771,1771,0,0,0,0
20151019,1771,1771,,,,1771,1771,0,0,0,0
20151020,1771,1771,,,,1771,1771,0,0,0,0
20151021,1771,1771,,,,1771,1771,0,0,0,0
20151022,1771,1771,,,,1771,1771,0,0,0,0
20151023,1771,1771,,,,1771,1771,0,0,0,0
20151026,1771,1771,,,,1771,1771,0,0,0,0
20151027,1771,1771,,,,1771,1771,0,0,0,0
20151028,1771,1771,,,,1783,1783,12,12,0,0
20151029,1783,1783,,,,1827,1827,44,44,0,0
20151030,1827,1827,,,,1827,1827,0,0,0,0
20151102,1827,1827,,,,1827,1827,0,0,0,0
20151103,1827,1827,,,,1827,1827,0,0,0,0
20151104,1827,1827,,,,1827,1827,0,0,0,0
20151105,1827,1827,,,,1827,1827,0,0,0,0
20151106,1827,1827,,,,1827,1827,0,0,0,0
20151109,1827,1827,,,,1827,1827,0,0,0,0
20151110,1827,1827,,,,1827,1827,0,0,0,0
20151111,1827,1827,,,,1827,1827,0,0,0,0
20151112,1827,1827,,,,1827,1827,0,0,0,0
20151113,1827,1827,,,,1827,1827,0,0,0,0
20151116,1827,1827,,,,1827,1827,0,0,0,0
20151117,1827,1827,,,,1827,1827,0,0,0,0
20151118,1827,1827,,,,1827,1827,0,0,0,0
20151119,1827,1827,,,,1827,1827,0,0,0,0
20151120,1827,1827,,,,1827,1827,0,0,0,0
20151123,1827,1827,,,,1827,1827,0,0,0,0
20151124,1827,1827,,,,1827,1827,0,0,0,0
20151125,1827,1827,,,,1827,1827,0,0,0,0
20151126,1827,1827,,,,1827,1827,0,0,0,0
20151127,1827,1827,,,,1827,1827,0,0,0,0
20151130,1827,1827,,,,1830,1830,3,3,0,0
wr1603,20150317,2730,2730,,,,2730,2730,0,0,0,0
20150318,2730,2730,,,,2730,2730,0,0,0,0
20150319,2730,2730,,,,2724,2724,-6,-6,0,0
20150320,2724,2724,,,,2587,2587,-137,-137,0,0
20150323,2587,2587,,,,2587,2587,0,0,0,0
20150324,2587,2587,,,,2587,2587,0,0,0,0
20150325,2587,2587,,,,2587,2587,0,0,0,0
20150326,2587,2587,,,,2601,2601,14,14,0,0
20150327,2601,2601,,,,2601,2601,0,0,0,0
20150330,2601,2601,,,,2523,2523,-78,-78,0,0
20150331,2523,2523,,,,2574,2574,51,51,0,0
20150401,2574,2574,,,,2574,2574,0,0,0,0
20150402,2574,2574,,,,2635,2635,61,61,0,0
20150403,2635,2635,,,,2635,2635,0,0,0,0
20150407,2635,2635,,,,2635,2635,0,0,0,0
20150408,2635,2635,,,,2635,2635,0,0,0,0
20150409,2635,2635,,,,2512,2512,-123,-123,0,0
20150410,2512,2512,,,,2512,2512,0,0,0,0
20150413,2512,2512,,,,2512,2512,0,0,0,0
20150414,2512,2512,,,,2512,2512,0,0,0,0
20150415,2512,2512,,,,2512,2512,0,0,0,0
20150416,2512,2512,,,,2512,2512,0,0,0,0
20150417,2512,2512,,,,2260,2260,-252,-252,0,0
20150420,2260,2260,,,,2296,2296,36,36,0,0
20150421,2296,2296,,,,2270,2270,-26,-26,0,0
20150422,2270,2270,,,,2270,2270,0,0,0,0
20150423,2270,2270,,,,2270,2270,0,0,0,0
20150424,2270,2270,,,,2376,2376,106,106,0,0
20150427,2376,2376,,,,2494,2494,118,118,0,0
20150428,2494,2494,,,,2419,2419,-75,-75,0,0
20150429,2419,2419,,,,2539,2539,120,120,0,0
20150430,2539,2539,,,,2563,2563,24,24,0,0
20150504,2563,2563,,,,2670,2670,107,107,0,0
20150505,2670,2670,,,,2670,2670,0,0,0,0
20150506,2670,2670,,,,2733,2733,63,63,0,0
20150507,2733,2733,,,,2670,2670,-63,-63,0,0
20150508,2670,2670,2927,2927,2452,2754,2711,84,41,6,2
20150511,2754,2711,,,,2782,2782,71,71,0,2
20150512,2782,2782,,,,2873,2873,91,91,0,2
20150513,2873,2873,,,,2971,2971,98,98,0,2
20150514,2971,2971,,,,2971,2971,0,0,0,2
20150515,2971,2971,,,,2856,2856,-115,-115,0,2
20150518,2856,2856,,,,2856,2856,0,0,0,2
20150519,2856,2856,,,,2856,2856,0,0,0,2
20150520,2856,2856,,,,2795,2795,-61,-61,0,2
20150521,2795,2795,,,,2795,2795,0,0,0,2
20150522,2795,2795,,,,2795,2795,0,0,0,2
20150525,2795,2795,,,,2795,2795,0,0,0,2
20150526,2795,2795,,,,2795,2795,0,0,0,2
20150527,2795,2795,,,,2795,2795,0,0,0,2
20150528,2795,2795,,,,2795,2795,0,0,0,2
20150529,2795,2795,2795,2795,2795,2795,2795,0,0,2,0
20150601,2795,2795,,,,2795,2795,0,0,0,0
20150602,2795,2795,,,,2798,2798,3,3,0,0
20150603,2798,2798,,,,2798,2798,0,0,0,0
20150604,2798,2798,,,,2798,2798,0,0,0,0
20150605,2798,2798,,,,2798,2798,0,0,0,0
20150608,2798,2798,,,,2798,2798,0,0,0,0
20150609,2798,2798,,,,2773,2773,-25,-25,0,0
20150610,2773,2773,,,,2773,2773,0,0,0,0
20150611,2773,2773,,,,2773,2773,0,0,0,0
20150612,2773,2773,,,,2866,2866,93,93,0,0
20150615,2866,2866,,,,2866,2866,0,0,0,0
20150616,2866,2866,,,,2742,2742,-124,-124,0,0
20150617,2742,2742,,,,2790,2790,48,48,0,0
20150618,2790,2790,,,,2790,2790,0,0,0,0
20150619,2790,2790,,,,2790,2790,0,0,0,0
20150623,2790,2790,,,,2665,2665,-125,-125,0,0
20150624,2665,2665,,,,2665,2665,0,0,0,0
20150625,2665,2665,,,,2665,2665,0,0,0,0
20150626,2665,2665,,,,2665,2665,0,0,0,0
20150629,2665,2665,,,,2665,2665,0,0,0,0
20150630,2665,2665,,,,2665,2665,0,0,0,0
20150701,2665,2665,,,,2665,2665,0,0,0,0
20150702,2665,2665,,,,2587,2587,-78,-78,0,0
20150703,2587,2587,,,,2587,2587,0,0,0,0
20150706,2587,2587,,,,2587,2587,0,0,0,0
20150707,2587,2587,,,,2457,2457,-130,-130,0,0
20150708,2457,2457,,,,2448,2448,-9,-9,0,0
20150709,2448,2448,,,,2448,2448,0,0,0,0
20150710,2448,2448,,,,2448,2448,0,0,0,0
20150713,2448,2448,,,,2448,2448,0,0,0,0
20150714,2448,2448,,,,2448,2448,0,0,0,0
20150715,2448,2448,,,,2448,2448,0,0,0,0
20150716,2448,2448,,,,2448,2448,0,0,0,0
20150717,2448,2448,,,,2448,2448,0,0,0,0
20150720,2448,2448,,,,2441,2441,-7,-7,0,0
20150721,2441,2441,,,,2318,2318,-123,-123,0,0
20150722,2318,2318,,,,2318,2318,0,0,0,0
20150723,2318,2318,,,,2318,2318,0,0,0,0
20150724,2318,2318,,,,2318,2318,0,0,0,0
20150727,2318,2318,,,,2319,2319,1,1,0,0
20150728,2319,2319,,,,2319,2319,0,0,0,0
20150729,2319,2319,,,,2216,2216,-103,-103,0,0
20150730,2216,2216,,,,2192,2192,-24,-24,0,0
20150731,2192,2192,,,,2254,2254,62,62,0,0
20150803,2254,2254,,,,2254,2254,0,0,0,0
20150804,2254,2254,,,,2254,2254,0,0,0,0
20150805,2254,2254,,,,2254,2254,0,0,0,0
20150806,2254,2254,,,,2254,2254,0,0,0,0
20150807,2254,2254,,,,2254,2254,0,0,0,0
20150810,2254,2254,,,,2254,2254,0,0,0,0
20150811,2254,2254,,,,2254,2254,0,0,0,0
20150812,2254,2254,,,,2254,2254,0,0,0,0
20150813,2254,2254,,,,2254,2254,0,0,0,0
20150814,2254,2254,,,,2254,2254,0,0,0,0
20150817,2254,2254,,,,2254,2254,0,0,0,0
20150818,2254,2254,,,,2254,2254,0,0,0,0
20150819,2254,2254,,,,2254,2254,0,0,0,0
20150820,2254,2254,,,,2254,2254,0,0,0,0
20150821,2254,2254,,,,2366,2366,112,112,0,0
20150824,2366,2366,,,,2366,2366,0,0,0,0
20150825,2366,2366,,,,2276,2276,-90,-90,0,0
20150826,2276,2276,,,,2276,2276,0,0,0,0
20150827,2276,2276,,,,2276,2276,0,0,0,0
20150828,2276,2276,,,,2276,2276,0,0,0,0
20150831,2276,2276,,,,2276,2276,0,0,0,0
20150901,2276,2276,,,,2276,2276,0,0,0,0
20150902,2276,2276,,,,2276,2276,0,0,0,0
20150907,2276,2276,,,,2276,2276,0,0,0,0
20150908,2276,2276,,,,2276,2276,0,0,0,0
20150909,2276,2276,,,,2276,2276,0,0,0,0
20150910,2276,2276,,,,2276,2276,0,0,0,0
20150911,2276,2276,,,,2277,2277,1,1,0,0
20150914,2277,2277,,,,2277,2277,0,0,0,0
20150915,2277,2277,,,,2277,2277,0,0,0,0
20150916,2277,2277,,,,2277,2277,0,0,0,0
20150917,2277,2277,,,,2277,2277,0,0,0,0
20150918,2277,2277,,,,2277,2277,0,0,0,0
20150921,2277,2277,,,,2277,2277,0,0,0,0
20150922,2277,2277,,,,2277,2277,0,0,0,0
20150923,2277,2277,,,,2277,2277,0,0,0,0
20150924,2277,2277,,,,2277,2277,0,0,0,0
20150925,2277,2277,,,,2214,2214,-63,-63,0,0
20150928,2214,2214,,,,2185,2185,-29,-29,0,0
20150929,2185,2185,,,,2185,2185,0,0,0,0
20150930,2185,2185,,,,2049,2049,-136,-136,0,0
20151008,2049,2049,,,,1971,1971,-78,-78,0,0
20151009,1971,1971,,,,1971,1971,0,0,0,0
20151012,1971,1971,,,,1921,1921,-50,-50,0,0
20151013,1921,1921,,,,1921,1921,0,0,0,0
20151014,1921,1921,,,,1921,1921,0,0,0,0
20151015,1921,1921,,,,1921,1921,0,0,0,0
20151016,1921,1921,,,,1921,1921,0,0,0,0
20151019,1921,1921,,,,1921,1921,0,0,0,0
20151020,1921,1921,,,,1921,1921,0,0,0,0
20151021,1921,1921,,,,1921,1921,0,0,0,0
20151022,1921,1921,,,,1921,1921,0,0,0,0
20151023,1921,1921,,,,1921,1921,0,0,0,0
20151026,1921,1921,,,,1921,1921,0,0,0,0
20151027,1921,1921,,,,1921,1921,0,0,0,0
20151028,1921,1921,,,,1935,1935,14,14,0,0
20151029,1935,1935,,,,1982,1982,47,47,0,0
20151030,1982,1982,,,,1982,1982,0,0,0,0
20151102,1982,1982,,,,1982,1982,0,0,0,0
20151103,1982,1982,,,,1982,1982,0,0,0,0
20151104,1982,1982,,,,1982,1982,0,0,0,0
20151105,1982,1982,,,,1982,1982,0,0,0,0
20151106,1982,1982,,,,1982,1982,0,0,0,0
20151109,1982,1982,,,,1982,1982,0,0,0,0
20151110,1982,1982,,,,1982,1982,0,0,0,0
20151111,1982,1982,,,,1982,1982,0,0,0,0
20151112,1982,1982,,,,1982,1982,0,0,0,0
20151113,1982,1982,,,,1982,1982,0,0,0,0
20151116,1982,1982,,,,1982,1982,0,0,0,0
20151117,1982,1982,,,,1982,1982,0,0,0,0
20151118,1982,1982,,,,1982,1982,0,0,0,0
20151119,1982,1982,,,,1982,1982,0,0,0,0
20151120,1982,1982,,,,1982,1982,0,0,0,0
20151123,1982,1982,,,,1982,1982,0,0,0,0
20151124,1982,1982,,,,1982,1982,0,0,0,0
20151125,1982,1982,,,,1982,1982,0,0,0,0
20151126,1982,1982,,,,1982,1982,0,0,0,0
20151127,1982,1982,,,,1982,1982,0,0,0,0
20151130,1982,1982,,,,1985,1985,3,3,0,0
wr1604,20150416,2512,2512,,,,2512,2512,0,0,0,0
20150417,2512,2512,,,,2260,2260,-252,-252,0,0
20150420,2260,2260,,,,2296,2296,36,36,0,0
20150421,2296,2296,,,,2270,2270,-26,-26,0,0
20150422,2270,2270,,,,2270,2270,0,0,0,0
20150423,2270,2270,,,,2270,2270,0,0,0,0
20150424,2270,2270,,,,2376,2376,106,106,0,0
20150427,2376,2376,,,,2494,2494,118,118,0,0
20150428,2494,2494,,,,2419,2419,-75,-75,0,0
20150429,2419,2419,,,,2539,2539,120,120,0,0
20150430,2539,2539,,,,2563,2563,24,24,0,0
20150504,2563,2563,,,,2670,2670,107,107,0,0
20150505,2670,2670,,,,2670,2670,0,0,0,0
20150506,2670,2670,,,,2733,2733,63,63,0,0
20150507,2733,2733,,,,2670,2670,-63,-63,0,0
20150508,2670,2670,,,,2711,2711,41,41,0,0
20150511,2711,2711,,,,2782,2782,71,71,0,0
20150512,2782,2782,,,,2873,2873,91,91,0,0
20150513,2873,2873,,,,2971,2971,98,98,0,0
20150514,2971,2971,,,,2971,2971,0,0,0,0
20150515,2971,2971,,,,2856,2856,-115,-115,0,0
20150518,2856,2856,,,,2856,2856,0,0,0,0
20150519,2856,2856,,,,2856,2856,0,0,0,0
20150520,2856,2856,,,,2795,2795,-61,-61,0,0
20150521,2795,2795,,,,2795,2795,0,0,0,0
20150522,2795,2795,,,,2795,2795,0,0,0,0
20150525,2795,2795,,,,2795,2795,0,0,0,0
20150526,2795,2795,,,,2795,2795,0,0,0,0
20150527,2795,2795,,,,2795,2795,0,0,0,0
20150528,2795,2795,,,,2795,2795,0,0,0,0
20150529,2795,2795,,,,2795,2795,0,0,0,0
20150601,2795,2795,,,,2795,2795,0,0,0,0
20150602,2795,2795,,,,2798,2798,3,3,0,0
20150603,2798,2798,,,,2798,2798,0,0,0,0
20150604,2798,2798,,,,2798,2798,0,0,0,0
20150605,2798,2798,,,,2798,2798,0,0,0,0
20150608,2798,2798,,,,2798,2798,0,0,0,0
20150609,2798,2798,,,,2773,2773,-25,-25,0,0
20150610,2773,2773,,,,2773,2773,0,0,0,0
20150611,2773,2773,,,,2773,2773,0,0,0,0
20150612,2773,2773,,,,2866,2866,93,93,0,0
20150615,2866,2866,,,,2866,2866,0,0,0,0
20150616,2866,2866,,,,2742,2742,-124,-124,0,0
20150617,2742,2742,,,,2790,2790,48,48,0,0
20150618,2790,2790,,,,2790,2790,0,0,0,0
20150619,2790,2790,,,,2790,2790,0,0,0,0
20150623,2790,2790,,,,2665,2665,-125,-125,0,0
20150624,2665,2665,,,,2665,2665,0,0,0,0
20150625,2665,2665,,,,2665,2665,0,0,0,0
20150626,2665,2665,,,,2665,2665,0,0,0,0
20150629,2665,2665,,,,2665,2665,0,0,0,0
20150630,2665,2665,,,,2665,2665,0,0,0,0
20150701,2665,2665,,,,2665,2665,0,0,0,0
20150702,2665,2665,,,,2587,2587,-78,-78,0,0
20150703,2587,2587,,,,2587,2587,0,0,0,0
20150706,2587,2587,,,,2587,2587,0,0,0,0
20150707,2587,2587,,,,2457,2457,-130,-130,0,0
20150708,2457,2457,,,,2448,2448,-9,-9,0,0
20150709,2448,2448,,,,2448,2448,0,0,0,0
20150710,2448,2448,,,,2448,2448,0,0,0,0
20150713,2448,2448,,,,2448,2448,0,0,0,0
20150714,2448,2448,,,,2448,2448,0,0,0,0
20150715,2448,2448,,,,2448,2448,0,0,0,0
20150716,2448,2448,,,,2448,2448,0,0,0,0
20150717,2448,2448,,,,2448,2448,0,0,0,0
20150720,2448,2448,,,,2448,2448,0,0,0,0
20150721,2448,2448,,,,2448,2448,0,0,0,0
20150722,2448,2448,,,,2448,2448,0,0,0,0
20150723,2448,2448,,,,2448,2448,0,0,0,0
20150724,2448,2448,,,,2448,2448,0,0,0,0
20150727,2448,2448,,,,2449,2449,1,1,0,0
20150728,2449,2449,,,,2449,2449,0,0,0,0
20150729,2449,2449,,,,2340,2340,-109,-109,0,0
20150730,2340,2340,,,,2314,2314,-26,-26,0,0
20150731,2314,2314,,,,2379,2379,65,65,0,0
20150803,2379,2379,,,,2379,2379,0,0,0,0
20150804,2379,2379,,,,2379,2379,0,0,0,0
20150805,2379,2379,,,,2379,2379,0,0,0,0
20150806,2379,2379,,,,2379,2379,0,0,0,0
20150807,2379,2379,,,,2379,2379,0,0,0,0
20150810,2379,2379,,,,2379,2379,0,0,0,0
20150811,2379,2379,,,,2379,2379,0,0,0,0
20150812,2379,2379,,,,2379,2379,0,0,0,0
20150813,2379,2379,,,,2379,2379,0,0,0,0
20150814,2379,2379,,,,2379,2379,0,0,0,0
20150817,2379,2379,,,,2379,2379,0,0,0,0
20150818,2379,2379,,,,2379,2379,0,0,0,0
20150819,2379,2379,,,,2379,2379,0,0,0,0
20150820,2379,2379,,,,2379,2379,0,0,0,0
20150821,2379,2379,,,,2497,2497,118,118,0,0
20150824,2497,2497,,,,2497,2497,0,0,0,0
20150825,2497,2497,,,,2402,2402,-95,-95,0,0
20150826,2402,2402,,,,2402,2402,0,0,0,0
20150827,2402,2402,,,,2402,2402,0,0,0,0
20150828,2402,2402,,,,2402,2402,0,0,0,0
20150831,2402,2402,,,,2402,2402,0,0,0,0
20150901,2402,2402,,,,2402,2402,0,0,0,0
20150902,2402,2402,,,,2402,2402,0,0,0,0
20150907,2402,2402,,,,2402,2402,0,0,0,0
20150908,2402,2402,,,,2402,2402,0,0,0,0
20150909,2402,2402,,,,2402,2402,0,0,0,0
20150910,2402,2402,,,,2402,2402,0,0,0,0
20150911,2402,2402,,,,2403,2403,1,1,0,0
20150914,2403,2403,,,,2403,2403,0,0,0,0
20150915,2403,2403,,,,2403,2403,0,0,0,0
20150916,2403,2403,,,,2403,2403,0,0,0,0
20150917,2403,2403,,,,2403,2403,0,0,0,0
20150918,2403,2403,,,,2403,2403,0,0,0,0
20150921,2403,2403,,,,2403,2403,0,0,0,0
20150922,2403,2403,,,,2403,2403,0,0,0,0
20150923,2403,2403,,,,2403,2403,0,0,0,0
20150924,2403,2403,,,,2403,2403,0,0,0,0
20150925,2403,2403,,,,2336,2336,-67,-67,0,0
20150928,2336,2336,2336,2336,2336,2336,2336,0,0,16,16
20150929,2336,2336,,,,2336,2336,0,0,0,16
20150930,2336,2336,,,,2190,2190,-146,-146,0,16
20151008,2190,2190,,,,2106,2106,-84,-84,0,16
20151009,2106,2106,,,,2106,2106,0,0,0,16
20151012,2106,2106,,,,2053,2053,-53,-53,0,16
20151013,2053,2053,,,,2053,2053,0,0,0,16
20151014,2053,2053,,,,2053,2053,0,0,0,16
20151015,2053,2053,,,,2053,2053,0,0,0,16
20151016,2053,2053,2053,2053,2053,2053,2053,0,0,14,2
20151019,2053,2053,,,,2053,2053,0,0,0,2
20151020,2053,2053,,,,2053,2053,0,0,0,2
20151021,2053,2053,,,,2053,2053,0,0,0,2
20151022,2053,2053,1951,1951,1951,1951,1951,-102,-102,2,0
20151023,1951,1951,,,,1951,1951,0,0,0,0
20151026,1951,1951,,,,1951,1951,0,0,0,0
20151027,1951,1951,,,,1951,1951,0,0,0,0
20151028,1951,1951,,,,1965,1965,14,14,0,0
20151029,1965,1965,,,,2013,2013,48,48,0,0
20151030,2013,2013,,,,2013,2013,0,0,0,0
20151102,2013,2013,,,,2013,2013,0,0,0,0
20151103,2013,2013,,,,2013,2013,0,0,0,0
20151104,2013,2013,,,,2013,2013,0,0,0,0
20151105,2013,2013,,,,2013,2013,0,0,0,0
20151106,2013,2013,,,,2013,2013,0,0,0,0
20151109,2013,2013,,,,2013,2013,0,0,0,0
20151110,2013,2013,,,,2013,2013,0,0,0,0
20151111,2013,2013,,,,2013,2013,0,0,0,0
20151112,2013,2013,,,,2013,2013,0,0,0,0
20151113,2013,2013,,,,2013,2013,0,0,0,0
20151116,2013,2013,,,,2013,2013,0,0,0,0
20151117,2013,2013,,,,2013,2013,0,0,0,0
20151118,2013,2013,,,,2013,2013,0,0,0,0
20151119,2013,2013,,,,2013,2013,0,0,0,0
20151120,2013,2013,,,,2013,2013,0,0,0,0
20151123,2013,2013,,,,2013,2013,0,0,0,0
20151124,2013,2013,,,,2013,2013,0,0,0,0
20151125,2013,2013,,,,2013,2013,0,0,0,0
20151126,2013,2013,,,,2013,2013,0,0,0,0
20151127,2013,2013,,,,2013,2013,0,0,0,0
20151130,2013,2013,,,,2016,2016,3,3,0,0
wr1605,20150518,2856,2856,,,,2856,2856,0,0,0,0
20150519,2856,2856,,,,2856,2856,0,0,0,0
20150520,2856,2856,,,,2795,2795,-61,-61,0,0
20150521,2795,2795,,,,2795,2795,0,0,0,0
20150522,2795,2795,,,,2795,2795,0,0,0,0
20150525,2795,2795,,,,2795,2795,0,0,0,0
20150526,2795,2795,,,,2795,2795,0,0,0,0
20150527,2795,2795,,,,2795,2795,0,0,0,0
20150528,2795,2795,,,,2795,2795,0,0,0,0
20150529,2795,2795,,,,2795,2795,0,0,0,0
20150601,2795,2795,,,,2795,2795,0,0,0,0
20150602,2795,2795,,,,2798,2798,3,3,0,0
20150603,2798,2798,,,,2798,2798,0,0,0,0
20150604,2798,2798,,,,2798,2798,0,0,0,0
20150605,2798,2798,,,,2798,2798,0,0,0,0
20150608,2798,2798,,,,2798,2798,0,0,0,0
20150609,2798,2798,,,,2773,2773,-25,-25,0,0
20150610,2773,2773,,,,2773,2773,0,0,0,0
20150611,2773,2773,,,,2773,2773,0,0,0,0
20150612,2773,2773,,,,2866,2866,93,93,0,0
20150615,2866,2866,,,,2866,2866,0,0,0,0
20150616,2866,2866,,,,2742,2742,-124,-124,0,0
20150617,2742,2742,,,,2790,2790,48,48,0,0
20150618,2790,2790,,,,2790,2790,0,0,0,0
20150619,2790,2790,,,,2790,2790,0,0,0,0
20150623,2790,2790,,,,2665,2665,-125,-125,0,0
20150624,2665,2665,,,,2665,2665,0,0,0,0
20150625,2665,2665,,,,2665,2665,0,0,0,0
20150626,2665,2665,,,,2665,2665,0,0,0,0
20150629,2665,2665,,,,2665,2665,0,0,0,0
20150630,2665,2665,,,,2665,2665,0,0,0,0
20150701,2665,2665,,,,2665,2665,0,0,0,0
20150702,2665,2665,,,,2587,2587,-78,-78,0,0
20150703,2587,2587,,,,2587,2587,0,0,0,0
20150706,2587,2587,,,,2587,2587,0,0,0,0
20150707,2587,2587,,,,2457,2457,-130,-130,0,0
20150708,2457,2457,,,,2448,2448,-9,-9,0,0
20150709,2448,2448,,,,2448,2448,0,0,0,0
20150710,2448,2448,,,,2448,2448,0,0,0,0
20150713,2448,2448,,,,2448,2448,0,0,0,0
20150714,2448,2448,,,,2448,2448,0,0,0,0
20150715,2448,2448,,,,2448,2448,0,0,0,0
20150716,2448,2448,,,,2448,2448,0,0,0,0
20150717,2448,2448,,,,2448,2448,0,0,0,0
20150720,2448,2448,,,,2441,2441,-7,-7,0,0
20150721,2441,2441,,,,2318,2318,-123,-123,0,0
20150722,2318,2318,,,,2318,2318,0,0,0,0
20150723,2318,2318,,,,2318,2318,0,0,0,0
20150724,2318,2318,,,,2318,2318,0,0,0,0
20150727,2318,2318,,,,2319,2319,1,1,0,0
20150728,2319,2319,,,,2319,2319,0,0,0,0
20150729,2319,2319,,,,2216,2216,-103,-103,0,0
20150730,2216,2216,,,,2192,2192,-24,-24,0,0
20150731,2192,2192,,,,2254,2254,62,62,0,0
20150803,2254,2254,,,,2254,2254,0,0,0,0
20150804,2254,2254,,,,2254,2254,0,0,0,0
20150805,2254,2254,,,,2254,2254,0,0,0,0
20150806,2254,2254,,,,2254,2254,0,0,0,0
20150807,2254,2254,,,,2254,2254,0,0,0,0
20150810,2254,2254,,,,2254,2254,0,0,0,0
20150811,2254,2254,,,,2254,2254,0,0,0,0
20150812,2254,2254,,,,2254,2254,0,0,0,0
20150813,2254,2254,,,,2254,2254,0,0,0,0
20150814,2254,2254,,,,2254,2254,0,0,0,0
20150817,2254,2254,,,,2254,2254,0,0,0,0
20150818,2254,2254,,,,2254,2254,0,0,0,0
20150819,2254,2254,,,,2254,2254,0,0,0,0
20150820,2254,2254,,,,2254,2254,0,0,0,0
20150821,2254,2254,,,,2366,2366,112,112,0,0
20150824,2366,2366,,,,2366,2366,0,0,0,0
20150825,2366,2366,,,,2276,2276,-90,-90,0,0
20150826,2276,2276,,,,2276,2276,0,0,0,0
20150827,2276,2276,,,,2276,2276,0,0,0,0
20150828,2276,2276,,,,2276,2276,0,0,0,0
20150831,2276,2276,,,,2276,2276,0,0,0,0
20150901,2276,2276,,,,2276,2276,0,0,0,0
20150902,2276,2276,,,,2276,2276,0,0,0,0
20150907,2276,2276,,,,2276,2276,0,0,0,0
20150908,2276,2276,,,,2276,2276,0,0,0,0
20150909,2276,2276,,,,2276,2276,0,0,0,0
20150910,2276,2276,,,,2276,2276,0,0,0,0
20150911,2276,2276,,,,2277,2277,1,1,0,0
20150914,2277,2277,,,,2277,2277,0,0,0,0
20150915,2277,2277,,,,2277,2277,0,0,0,0
20150916,2277,2277,,,,2277,2277,0,0,0,0
20150917,2277,2277,,,,2277,2277,0,0,0,0
20150918,2277,2277,,,,2277,2277,0,0,0,0
20150921,2277,2277,,,,2277,2277,0,0,0,0
20150922,2277,2277,,,,2277,2277,0,0,0,0
20150923,2277,2277,,,,2277,2277,0,0,0,0
20150924,2277,2277,,,,2277,2277,0,0,0,0
20150925,2277,2277,,,,2214,2214,-63,-63,0,0
20150928,2214,2214,,,,2214,2214,0,0,0,0
20150929,2214,2214,,,,2214,2214,0,0,0,0
20150930,2214,2214,,,,2076,2076,-138,-138,0,0
20151008,2076,2076,,,,1996,1996,-80,-80,0,0
20151009,1996,1996,,,,1996,1996,0,0,0,0
20151012,1996,1996,,,,1946,1946,-50,-50,0,0
20151013,1946,1946,,,,1946,1946,0,0,0,0
20151014,1946,1946,,,,1946,1946,0,0,0,0
20151015,1946,1946,,,,1946,1946,0,0,0,0
20151016,1946,1946,,,,1946,1946,0,0,0,0
20151019,1946,1946,,,,1946,1946,0,0,0,0
20151020,1946,1946,,,,1946,1946,0,0,0,0
20151021,1946,1946,,,,1946,1946,0,0,0,0
20151022,1946,1946,,,,1849,1849,-97,-97,0,0
20151023,1849,1849,,,,1849,1849,0,0,0,0
20151026,1849,1849,,,,1849,1849,0,0,0,0
20151027,1849,1849,,,,1849,1849,0,0,0,0
20151028,1849,1849,,,,1862,1862,13,13,0,0
20151029,1862,1862,,,,1908,1908,46,46,0,0
20151030,1908,1908,,,,1908,1908,0,0,0,0
20151102,1908,1908,,,,1908,1908,0,0,0,0
20151103,1908,1908,,,,1908,1908,0,0,0,0
20151104,1908,1908,,,,1908,1908,0,0,0,0
20151105,1908,1908,,,,1908,1908,0,0,0,0
20151106,1908,1908,,,,1908,1908,0,0,0,0
20151109,1908,1908,,,,1908,1908,0,0,0,0
20151110,1908,1908,,,,1908,1908,0,0,0,0
20151111,1908,1908,,,,1908,1908,0,0,0,0
20151112,1908,1908,,,,1908,1908,0,0,0,0
20151113,1908,1908,,,,1908,1908,0,0,0,0
20151116,1908,1908,,,,1908,1908,0,0,0,0
20151117,1908,1908,,,,1908,1908,0,0,0,0
20151118,1908,1908,,,,1908,1908,0,0,0,0
20151119,1908,1908,,,,1908,1908,0,0,0,0
20151120,1908,1908,,,,1908,1908,0,0,0,0
20151123,1908,1908,,,,1908,1908,0,0,0,0
20151124,1908,1908,,,,1908,1908,0,0,0,0
20151125,1908,1908,,,,1908,1908,0,0,0,0
20151126,1908,1908,,,,1908,1908,0,0,0,0
20151127,1908,1908,,,,1908,1908,0,0,0,0
20151130,1908,1908,,,,1911,1911,3,3,0,0
wr1606,20150616,2866,2866,,,,2742,2742,-124,-124,0,0
20150617,2742,2742,,,,2790,2790,48,48,0,0
20150618,2790,2790,,,,2790,2790,0,0,0,0
20150619,2790,2790,,,,2790,2790,0,0,0,0
20150623,2790,2790,,,,2665,2665,-125,-125,0,0
20150624,2665,2665,,,,2665,2665,0,0,0,0
20150625,2665,2665,,,,2665,2665,0,0,0,0
20150626,2665,2665,,,,2665,2665,0,0,0,0
20150629,2665,2665,,,,2665,2665,0,0,0,0
20150630,2665,2665,,,,2665,2665,0,0,0,0
20150701,2665,2665,,,,2665,2665,0,0,0,0
20150702,2665,2665,,,,2587,2587,-78,-78,0,0
20150703,2587,2587,,,,2587,2587,0,0,0,0
20150706,2587,2587,,,,2587,2587,0,0,0,0
20150707,2587,2587,,,,2457,2457,-130,-130,0,0
20150708,2457,2457,,,,2448,2448,-9,-9,0,0
20150709,2448,2448,,,,2448,2448,0,0,0,0
20150710,2448,2448,,,,2448,2448,0,0,0,0
20150713,2448,2448,,,,2448,2448,0,0,0,0
20150714,2448,2448,,,,2448,2448,0,0,0,0
20150715,2448,2448,,,,2448,2448,0,0,0,0
20150716,2448,2448,,,,2448,2448,0,0,0,0
20150717,2448,2448,,,,2448,2448,0,0,0,0
20150720,2448,2448,,,,2441,2441,-7,-7,0,0
20150721,2441,2441,,,,2318,2318,-123,-123,0,0
20150722,2318,2318,,,,2318,2318,0,0,0,0
20150723,2318,2318,,,,2318,2318,0,0,0,0
20150724,2318,2318,,,,2318,2318,0,0,0,0
20150727,2318,2318,,,,2319,2319,1,1,0,0
20150728,2319,2319,,,,2319,2319,0,0,0,0
20150729,2319,2319,,,,2216,2216,-103,-103,0,0
20150730,2216,2216,,,,2192,2192,-24,-24,0,0
20150731,2192,2192,,,,2254,2254,62,62,0,0
20150803,2254,2254,,,,2254,2254,0,0,0,0
20150804,2254,2254,,,,2254,2254,0,0,0,0
20150805,2254,2254,,,,2254,2254,0,0,0,0
20150806,2254,2254,,,,2254,2254,0,0,0,0
20150807,2254,2254,,,,2254,2254,0,0,0,0
20150810,2254,2254,,,,2254,2254,0,0,0,0
20150811,2254,2254,,,,2254,2254,0,0,0,0
20150812,2254,2254,,,,2254,2254,0,0,0,0
20150813,2254,2254,,,,2254,2254,0,0,0,0
20150814,2254,2254,,,,2254,2254,0,0,0,0
20150817,2254,2254,,,,2254,2254,0,0,0,0
20150818,2254,2254,,,,2254,2254,0,0,0,0
20150819,2254,2254,,,,2254,2254,0,0,0,0
20150820,2254,2254,,,,2254,2254,0,0,0,0
20150821,2254,2254,,,,2366,2366,112,112,0,0
20150824,2366,2366,,,,2366,2366,0,0,0,0
20150825,2366,2366,,,,2276,2276,-90,-90,0,0
20150826,2276,2276,,,,2276,2276,0,0,0,0
20150827,2276,2276,,,,2276,2276,0,0,0,0
20150828,2276,2276,,,,2276,2276,0,0,0,0
20150831,2276,2276,,,,2276,2276,0,0,0,0
20150901,2276,2276,,,,2276,2276,0,0,0,0
20150902,2276,2276,,,,2276,2276,0,0,0,0
20150907,2276,2276,,,,2276,2276,0,0,0,0
20150908,2276,2276,,,,2276,2276,0,0,0,0
20150909,2276,2276,,,,2276,2276,0,0,0,0
20150910,2276,2276,,,,2276,2276,0,0,0,0
20150911,2276,2276,,,,2277,2277,1,1,0,0
20150914,2277,2277,,,,2277,2277,0,0,0,0
20150915,2277,2277,,,,2277,2277,0,0,0,0
20150916,2277,2277,,,,2277,2277,0,0,0,0
20150917,2277,2277,,,,2277,2277,0,0,0,0
20150918,2277,2277,,,,2277,2277,0,0,0,0
20150921,2277,2277,,,,2277,2277,0,0,0,0
20150922,2277,2277,,,,2277,2277,0,0,0,0
20150923,2277,2277,,,,2277,2277,0,0,0,0
20150924,2277,2277,,,,2277,2277,0,0,0,0
20150925,2277,2277,,,,2214,2214,-63,-63,0,0
20150928,2214,2214,,,,2214,2214,0,0,0,0
20150929,2214,2214,,,,2214,2214,0,0,0,0
20150930,2214,2214,,,,2076,2076,-138,-138,0,0
20151008,2076,2076,,,,1996,1996,-80,-80,0,0
20151009,1996,1996,,,,1996,1996,0,0,0,0
20151012,1996,1996,,,,1946,1946,-50,-50,0,0
20151013,1946,1946,,,,1946,1946,0,0,0,0
20151014,1946,1946,,,,1946,1946,0,0,0,0
20151015,1946,1946,,,,1946,1946,0,0,0,0
20151016,1946,1946,,,,1946,1946,0,0,0,0
20151019,1946,1946,,,,1946,1946,0,0,0,0
20151020,1946,1946,,,,1946,1946,0,0,0,0
20151021,1946,1946,,,,1946,1946,0,0,0,0
20151022,1946,1946,,,,1849,1849,-97,-97,0,0
20151023,1849,1849,,,,1849,1849,0,0,0,0
20151026,1849,1849,,,,1849,1849,0,0,0,0
20151027,1849,1849,,,,1849,1849,0,0,0,0
20151028,1849,1849,,,,1862,1862,13,13,0,0
20151029,1862,1862,,,,1908,1908,46,46,0,0
20151030,1908,1908,,,,1908,1908,0,0,0,0
20151102,1908,1908,,,,1908,1908,0,0,0,0
20151103,1908,1908,,,,1908,1908,0,0,0,0
20151104,1908,1908,,,,1908,1908,0,0,0,0
20151105,1908,1908,,,,1908,1908,0,0,0,0
20151106,1908,1908,,,,1908,1908,0,0,0,0
20151109,1908,1908,,,,1908,1908,0,0,0,0
20151110,1908,1908,,,,1908,1908,0,0,0,0
20151111,1908,1908,,,,1908,1908,0,0,0,0
20151112,1908,1908,,,,1908,1908,0,0,0,0
20151113,1908,1908,,,,1908,1908,0,0,0,0
20151116,1908,1908,,,,1908,1908,0,0,0,0
20151117,1908,1908,,,,1908,1908,0,0,0,0
20151118,1908,1908,,,,1908,1908,0,0,0,0
20151119,1908,1908,,,,1908,1908,0,0,0,0
20151120,1908,1908,,,,1908,1908,0,0,0,0
20151123,1908,1908,,,,1908,1908,0,0,0,0
20151124,1908,1908,,,,1908,1908,0,0,0,0
20151125,1908,1908,,,,1908,1908,0,0,0,0
20151126,1908,1908,,,,1908,1908,0,0,0,0
20151127,1908,1908,,,,1908,1908,0,0,0,0
20151130,1908,1908,,,,1911,1911,3,3,0,0
wr1607,20150716,2448,2448,,,,2448,2448,0,0,0,0
20150717,2448,2448,,,,2448,2448,0,0,0,0
20150720,2448,2448,,,,2441,2441,-7,-7,0,0
20150721,2441,2441,,,,2318,2318,-123,-123,0,0
20150722,2318,2318,,,,2318,2318,0,0,0,0
20150723,2318,2318,,,,2318,2318,0,0,0,0
20150724,2318,2318,,,,2318,2318,0,0,0,0
20150727,2318,2318,,,,2319,2319,1,1,0,0
20150728,2319,2319,,,,2319,2319,0,0,0,0
20150729,2319,2319,,,,2216,2216,-103,-103,0,0
20150730,2216,2216,,,,2192,2192,-24,-24,0,0
20150731,2192,2192,,,,2254,2254,62,62,0,0
20150803,2254,2254,,,,2254,2254,0,0,0,0
20150804,2254,2254,,,,2254,2254,0,0,0,0
20150805,2254,2254,,,,2254,2254,0,0,0,0
20150806,2254,2254,,,,2254,2254,0,0,0,0
20150807,2254,2254,,,,2254,2254,0,0,0,0
20150810,2254,2254,,,,2254,2254,0,0,0,0
20150811,2254,2254,,,,2254,2254,0,0,0,0
20150812,2254,2254,,,,2254,2254,0,0,0,0
20150813,2254,2254,,,,2254,2254,0,0,0,0
20150814,2254,2254,,,,2254,2254,0,0,0,0
20150817,2254,2254,,,,2254,2254,0,0,0,0
20150818,2254,2254,,,,2254,2254,0,0,0,0
20150819,2254,2254,,,,2254,2254,0,0,0,0
20150820,2254,2254,,,,2254,2254,0,0,0,0
20150821,2254,2254,,,,2366,2366,112,112,0,0
20150824,2366,2366,,,,2366,2366,0,0,0,0
20150825,2366,2366,,,,2276,2276,-90,-90,0,0
20150826,2276,2276,,,,2276,2276,0,0,0,0
20150827,2276,2276,,,,2276,2276,0,0,0,0
20150828,2276,2276,,,,2276,2276,0,0,0,0
20150831,2276,2276,,,,2276,2276,0,0,0,0
20150901,2276,2276,,,,2276,2276,0,0,0,0
20150902,2276,2276,,,,2276,2276,0,0,0,0
20150907,2276,2276,,,,2276,2276,0,0,0,0
20150908,2276,2276,,,,2276,2276,0,0,0,0
20150909,2276,2276,,,,2276,2276,0,0,0,0
20150910,2276,2276,,,,2276,2276,0,0,0,0
20150911,2276,2276,,,,2277,2277,1,1,0,0
20150914,2277,2277,,,,2277,2277,0,0,0,0
20150915,2277,2277,,,,2277,2277,0,0,0,0
20150916,2277,2277,,,,2277,2277,0,0,0,0
20150917,2277,2277,,,,2277,2277,0,0,0,0
20150918,2277,2277,,,,2277,2277,0,0,0,0
20150921,2277,2277,,,,2277,2277,0,0,0,0
20150922,2277,2277,,,,2277,2277,0,0,0,0
20150923,2277,2277,,,,2277,2277,0,0,0,0
20150924,2277,2277,,,,2277,2277,0,0,0,0
20150925,2277,2277,,,,2214,2214,-63,-63,0,0
20150928,2214,2214,,,,2214,2214,0,0,0,0
20150929,2214,2214,,,,2214,2214,0,0,0,0
20150930,2214,2214,,,,2076,2076,-138,-138,0,0
20151008,2076,2076,,,,1996,1996,-80,-80,0,0
20151009,1996,1996,,,,1996,1996,0,0,0,0
20151012,1996,1996,,,,1946,1946,-50,-50,0,0
20151013,1946,1946,,,,1946,1946,0,0,0,0
20151014,1946,1946,,,,1946,1946,0,0,0,0
20151015,1946,1946,,,,1946,1946,0,0,0,0
20151016,1946,1946,,,,1946,1946,0,0,0,0
20151019,1946,1946,,,,1946,1946,0,0,0,0
20151020,1946,1946,,,,1946,1946,0,0,0,0
20151021,1946,1946,,,,1946,1946,0,0,0,0
20151022,1946,1946,,,,1849,1849,-97,-97,0,0
20151023,1849,1849,,,,1849,1849,0,0,0,0
20151026,1849,1849,,,,1849,1849,0,0,0,0
20151027,1849,1849,,,,1849,1849,0,0,0,0
20151028,1849,1849,,,,1862,1862,13,13,0,0
20151029,1862,1862,,,,1908,1908,46,46,0,0
20151030,1908,1908,,,,1908,1908,0,0,0,0
20151102,1908,1908,,,,1908,1908,0,0,0,0
20151103,1908,1908,,,,1908,1908,0,0,0,0
20151104,1908,1908,,,,1908,1908,0,0,0,0
20151105,1908,1908,,,,1908,1908,0,0,0,0
20151106,1908,1908,,,,1908,1908,0,0,0,0
20151109,1908,1908,,,,1908,1908,0,0,0,0
20151110,1908,1908,,,,1908,1908,0,0,0,0
20151111,1908,1908,,,,1908,1908,0,0,0,0
20151112,1908,1908,,,,1908,1908,0,0,0,0
20151113,1908,1908,,,,1908,1908,0,0,0,0
20151116,1908,1908,,,,1908,1908,0,0,0,0
20151117,1908,1908,,,,1908,1908,0,0,0,0
20151118,1908,1908,,,,1908,1908,0,0,0,0
20151119,1908,1908,,,,1908,1908,0,0,0,0
20151120,1908,1908,,,,1908,1908,0,0,0,0
20151123,1908,1908,,,,1908,1908,0,0,0,0
20151124,1908,1908,,,,1908,1908,0,0,0,0
20151125,1908,1908,,,,1908,1908,0,0,0,0
20151126,1908,1908,,,,1908,1908,0,0,0,0
20151127,1908,1908,,,,1908,1908,0,0,0,0
20151130,1908,1908,,,,1911,1911,3,3,0,0
wr1608,20150818,2254,2254,,,,2254,2254,0,0,0,0
20150819,2254,2254,,,,2254,2254,0,0,0,0
20150820,2254,2254,,,,2254,2254,0,0,0,0
20150821,2254,2254,,,,2366,2366,112,112,0,0
20150824,2366,2366,,,,2366,2366,0,0,0,0
20150825,2366,2366,,,,2276,2276,-90,-90,0,0
20150826,2276,2276,,,,2276,2276,0,0,0,0
20150827,2276,2276,,,,2276,2276,0,0,0,0
20150828,2276,2276,,,,2276,2276,0,0,0,0
20150831,2276,2276,,,,2276,2276,0,0,0,0
20150901,2276,2276,,,,2276,2276,0,0,0,0
20150902,2276,2276,,,,2276,2276,0,0,0,0
20150907,2276,2276,,,,2276,2276,0,0,0,0
20150908,2276,2276,,,,2276,2276,0,0,0,0
20150909,2276,2276,,,,2276,2276,0,0,0,0
20150910,2276,2276,,,,2276,2276,0,0,0,0
20150911,2276,2276,,,,2277,2277,1,1,0,0
20150914,2277,2277,,,,2277,2277,0,0,0,0
20150915,2277,2277,,,,2277,2277,0,0,0,0
20150916,2277,2277,,,,2277,2277,0,0,0,0
20150917,2277,2277,,,,2277,2277,0,0,0,0
20150918,2277,2277,,,,2277,2277,0,0,0,0
20150921,2277,2277,,,,2277,2277,0,0,0,0
20150922,2277,2277,,,,2277,2277,0,0,0,0
20150923,2277,2277,,,,2277,2277,0,0,0,0
20150924,2277,2277,,,,2277,2277,0,0,0,0
20150925,2277,2277,,,,2214,2214,-63,-63,0,0
20150928,2214,2214,,,,2214,2214,0,0,0,0
20150929,2214,2214,,,,2214,2214,0,0,0,0
20150930,2214,2214,,,,2076,2076,-138,-138,0,0
20151008,2076,2076,,,,1996,1996,-80,-80,0,0
20151009,1996,1996,,,,1996,1996,0,0,0,0
20151012,1996,1996,,,,1946,1946,-50,-50,0,0
20151013,1946,1946,,,,1946,1946,0,0,0,0
20151014,1946,1946,,,,1946,1946,0,0,0,0
20151015,1946,1946,,,,1946,1946,0,0,0,0
20151016,1946,1946,,,,1946,1946,0,0,0,0
20151019,1946,1946,,,,1946,1946,0,0,0,0
20151020,1946,1946,,,,1946,1946,0,0,0,0
20151021,1946,1946,,,,1946,1946,0,0,0,0
20151022,1946,1946,,,,1849,1849,-97,-97,0,0
20151023,1849,1849,,,,1849,1849,0,0,0,0
20151026,1849,1849,,,,1849,1849,0,0,0,0
20151027,1849,1849,,,,1849,1849,0,0,0,0
20151028,1849,1849,,,,1862,1862,13,13,0,0
20151029,1862,1862,,,,1908,1908,46,46,0,0
20151030,1908,1908,,,,1908,1908,0,0,0,0
20151102,1908,1908,,,,1908,1908,0,0,0,0
20151103,1908,1908,,,,1908,1908,0,0,0,0
20151104,1908,1908,,,,1908,1908,0,0,0,0
20151105,1908,1908,,,,1908,1908,0,0,0,0
20151106,1908,1908,,,,1908,1908,0,0,0,0
20151109,1908,1908,,,,1908,1908,0,0,0,0
20151110,1908,1908,,,,1908,1908,0,0,0,0
20151111,1908,1908,,,,1908,1908,0,0,0,0
20151112,1908,1908,,,,1908,1908,0,0,0,0
20151113,1908,1908,,,,1908,1908,0,0,0,0
20151116,1908,1908,,,,1908,1908,0,0,0,0
20151117,1908,1908,,,,1908,1908,0,0,0,0
20151118,1908,1908,,,,1908,1908,0,0,0,0
20151119,1908,1908,,,,1908,1908,0,0,0,0
20151120,1908,1908,,,,1908,1908,0,0,0,0
20151123,1908,1908,,,,1908,1908,0,0,0,0
20151124,1908,1908,,,,1908,1908,0,0,0,0
20151125,1908,1908,,,,1908,1908,0,0,0,0
20151126,1908,1908,,,,1908,1908,0,0,0,0
20151127,1908,1908,,,,1908,1908,0,0,0,0
20151130,1908,1908,,,,1911,1911,3,3,0,0
wr1609,20150916,2277,2277,,,,2277,2277,0,0,0,0
20150917,2277,2277,,,,2277,2277,0,0,0,0
20150918,2277,2277,,,,2277,2277,0,0,0,0
20150921,2277,2277,,,,2277,2277,0,0,0,0
20150922,2277,2277,,,,2277,2277,0,0,0,0
20150923,2277,2277,,,,2277,2277,0,0,0,0
20150924,2277,2277,,,,2277,2277,0,0,0,0
20150925,2277,2277,,,,2214,2214,-63,-63,0,0
20150928,2214,2214,,,,2214,2214,0,0,0,0
20150929,2214,2214,,,,2214,2214,0,0,0,0
20150930,2214,2214,,,,2076,2076,-138,-138,0,0
20151008,2076,2076,,,,1996,1996,-80,-80,0,0
20151009,1996,1996,,,,1996,1996,0,0,0,0
20151012,1996,1996,,,,1946,1946,-50,-50,0,0
20151013,1946,1946,,,,1946,1946,0,0,0,0
20151014,1946,1946,,,,1946,1946,0,0,0,0
20151015,1946,1946,,,,1946,1946,0,0,0,0
20151016,1946,1946,,,,1946,1946,0,0,0,0
20151019,1946,1946,,,,1946,1946,0,0,0,0
20151020,1946,1946,,,,1946,1946,0,0,0,0
20151021,1946,1946,,,,1946,1946,0,0,0,0
20151022,1946,1946,,,,1946,1946,0,0,0,0
20151023,1946,1946,,,,1946,1946,0,0,0,0
20151026,1946,1946,,,,1946,1946,0,0,0,0
20151027,1946,1946,,,,1946,1946,0,0,0,0
20151028,1946,1946,,,,1960,1960,14,14,0,0
20151029,1960,1960,,,,2008,2008,48,48,0,0
20151030,2008,2008,,,,2008,2008,0,0,0,0
20151102,2008,2008,,,,2008,2008,0,0,0,0
20151103,2008,2008,,,,2008,2008,0,0,0,0
20151104,2008,2008,,,,2008,2008,0,0,0,0
20151105,2008,2008,,,,2008,2008,0,0,0,0
20151106,2008,2008,,,,2008,2008,0,0,0,0
20151109,2008,2008,,,,2008,2008,0,0,0,0
20151110,2008,2008,,,,2008,2008,0,0,0,0
20151111,2008,2008,,,,2008,2008,0,0,0,0
20151112,2008,2008,,,,2008,2008,0,0,0,0
20151113,2008,2008,,,,2008,2008,0,0,0,0
20151116,2008,2008,,,,2008,2008,0,0,0,0
20151117,2008,2008,,,,2008,2008,0,0,0,0
20151118,2008,2008,,,,2008,2008,0,0,0,0
20151119,2008,2008,,,,2008,2008,0,0,0,0
20151120,2008,2008,,,,2008,2008,0,0,0,0
20151123,2008,2008,,,,2008,2008,0,0,0,0
20151124,2008,2008,,,,2008,2008,0,0,0,0
20151125,2008,2008,,,,2008,2008,0,0,0,0
20151126,2008,2008,,,,2008,2008,0,0,0,0
20151127,2008,2008,,,,2008,2008,0,0,0,0
20151130,2008,2008,,,,2011,2011,3,3,0,0
wr1610,20151016,1946,1946,,,,1946,1946,0,0,0,0
20151019,1946,1946,,,,1946,1946,0,0,0,0
20151020,1946,1946,,,,1946,1946,0,0,0,0
20151021,1946,1946,1751,2081,1751,2081,1916,135,-30,8,0
20151022,2081,1916,,,,1820,1820,-96,-96,0,0
20151023,1820,1820,,,,1820,1820,0,0,0,0
20151026,1820,1820,,,,1820,1820,0,0,0,0
20151027,1820,1820,,,,1820,1820,0,0,0,0
20151028,1820,1820,,,,1833,1833,13,13,0,0
20151029,1833,1833,,,,1878,1878,45,45,0,0
20151030,1878,1878,,,,1878,1878,0,0,0,0
20151102,1878,1878,,,,1878,1878,0,0,0,0
20151103,1878,1878,,,,1878,1878,0,0,0,0
20151104,1878,1878,,,,1878,1878,0,0,0,0
20151105,1878,1878,,,,1878,1878,0,0,0,0
20151106,1878,1878,,,,1878,1878,0,0,0,0
20151109,1878,1878,,,,1878,1878,0,0,0,0
20151110,1878,1878,,,,1878,1878,0,0,0,0
20151111,1878,1878,,,,1878,1878,0,0,0,0
20151112,1878,1878,,,,1878,1878,0,0,0,0
20151113,1878,1878,,,,1878,1878,0,0,0,0
20151116,1878,1878,,,,1878,1878,0,0,0,0
20151117,1878,1878,,,,1878,1878,0,0,0,0
20151118,1878,1878,,,,1878,1878,0,0,0,0
20151119,1878,1878,,,,1878,1878,0,0,0,0
20151120,1878,1878,,,,1878,1878,0,0,0,0
20151123,1878,1878,,,,1878,1878,0,0,0,0
20151124,1878,1878,,,,1878,1878,0,0,0,0
20151125,1878,1878,,,,1878,1878,0,0,0,0
20151126,1878,1878,,,,1878,1878,0,0,0,0
20151127,1878,1878,,,,1878,1878,0,0,0,0
20151130,1878,1878,,,,1881,1881,3,3,0,0
wr1611,20151117,1878,1878,,,,1878,1878,0,0,0,0
20151118,1878,1878,,,,1878,1878,0,0,0,0
20151119,1878,1878,,,,1878,1878,0,0,0,0
20151120,1878,1878,,,,1878,1878,0,0,0,0
20151123,1878,1878,,,,1878,1878,0,0,0,0
20151124,1878,1878,,,,1878,1878,0,0,0,0
20151125,1878,1878,,,,1878,1878,0,0,0,0
20151126,1878,1878,,,,1878,1878,0,0,0,0
20151127,1878,1878,,,,1878,1878,0,0,0,0
20151130,1878,1878,,,,1881,1881,3,3,0,0
zn1501,20150105,16500,16760,16825,16940,16725,16805,16830,45,70,2092,12050
20150106,16805,16830,16640,16850,16640,16835,16805,5,-25,920,11490
20150107,16835,16805,16800,16820,16745,16775,16765,-30,-40,2460,10020
20150108,16775,16765,16725,16730,16575,16595,16625,-170,-140,5270,6380
20150109,16595,16625,16725,16725,16565,16600,16600,-25,-25,2180,5270
20150112,16600,16600,16620,16635,16535,16550,16585,-50,-15,1510,4150
20150113,16550,16585,16720,16720,16410,16410,16480,-175,-105,630,3560
20150114,16410,16480,16155,16450,15900,16015,15935,-465,-545,2500,1860
20150115,16015,15935,15850,16100,15850,16050,15985,115,50,290,1910
zn1502,20150105,16795,16680,16795,16885,16650,16740,16775,60,95,40060,56452
20150106,16740,16775,16610,16815,16525,16770,16715,-5,-60,35134,54290
20150107,16770,16715,16795,16795,16645,16690,16695,-25,-20,27122,51070
20150108,16690,16695,16640,16670,16500,16520,16555,-175,-140,25578,47092
20150109,16520,16555,16560,16655,16470,16515,16550,-40,-5,14490,44372
20150112,16515,16550,16530,16645,16435,16475,16530,-75,-20,11528,41180
20150113,16475,16530,16380,16460,16320,16320,16395,-210,-135,8996,38760
20150114,16320,16395,16195,16235,15660,15725,15880,-670,-515,38806,29810
20150115,15725,15880,15770,16060,15770,15955,15945,75,65,21586,24582
20150116,15955,15945,15985,16065,15825,15905,15915,-40,-30,7546,23460
20150119,15905,15915,15910,16155,15880,16125,16015,210,100,7720,22346
20150120,16125,16015,16035,16180,16015,16145,16100,130,85,3968,20964
20150121,16145,16100,16210,16300,16160,16250,16235,150,135,12440,14450
20150122,16250,16235,16225,16505,16200,16425,16395,190,160,3912,13822
20150123,16425,16395,16475,16540,16290,16325,16390,-70,-5,4172,12836
20150126,16325,16390,16280,16335,16015,16190,16170,-200,-220,4280,11824
20150127,16190,16170,16215,16540,16215,16390,16425,220,255,3810,10118
20150128,16390,16425,16435,16475,16330,16430,16405,5,-20,3314,9132
20150129,16430,16405,16415,16415,16220,16250,16295,-155,-110,3554,7808
20150130,16250,16295,16190,16360,16130,16220,16190,-75,-105,2110,6836
20150202,16220,16190,16280,16370,16280,16280,16320,90,130,1726,5910
20150203,16280,16320,16305,16400,16200,16285,16285,-35,-35,5980,3110
20150204,16285,16285,16325,16470,16320,16325,16375,40,90,3190,3550
20150205,16325,16375,16310,16310,16260,16260,16275,-115,-100,1330,2950
20150206,16260,16275,16280,16375,16280,16375,16305,100,30,520,3020
20150209,16375,16305,16375,16375,16310,16355,16340,50,35,1220,2020
20150210,16355,16340,16360,16360,16325,16345,16335,5,-5,640,2240
zn1503,20150105,16780,16655,16710,16870,16625,16720,16745,65,90,189904,160518
20150106,16720,16745,16525,16800,16500,16740,16680,-5,-65,239488,163974
20150107,16740,16680,16790,16790,16590,16630,16665,-50,-15,174974,161740
20150108,16630,16665,16560,16610,16420,16465,16515,-200,-150,180220,160806
20150109,16465,16515,16595,16600,16410,16455,16495,-60,-20,203098,158354
20150112,16455,16495,16455,16590,16375,16410,16485,-85,-10,182332,158684
20150113,16410,16485,16310,16395,16250,16255,16325,-230,-160,153358,160330
20150114,16255,16325,16080,16165,15550,15630,15820,-695,-505,573954,186858
20150115,15630,15820,15760,15960,15680,15870,15835,50,15,501186,177374
20150116,15870,15835,15915,15990,15740,15810,15840,-25,5,260234,168820
20150119,15810,15840,15830,16085,15800,16065,15945,225,105,256384,158856
20150120,16065,15945,15980,16100,15920,16035,16000,90,55,166498,162064
20150121,16035,16000,16140,16210,16055,16155,16125,155,125,181386,156518
20150122,16155,16125,16120,16440,16110,16360,16300,235,175,285218,151594
20150123,16360,16300,16385,16460,16200,16235,16315,-65,15,249752,127734
20150126,16235,16315,16170,16245,15915,16115,16095,-200,-220,285936,113610
20150127,16115,16095,16185,16445,16140,16315,16320,220,225,218744,103626
20150128,16315,16320,16350,16390,16245,16380,16325,60,5,167550,95934
20150129,16380,16325,16325,16360,16135,16135,16230,-190,-95,141824,83600
20150130,16135,16230,16070,16185,16055,16095,16110,-135,-120,75288,75548
20150202,16095,16110,16185,16315,16155,16250,16225,140,115,57442,63186
20150203,16250,16225,16295,16370,16205,16295,16280,70,55,39792,54784
20150204,16295,16280,16400,16490,16315,16335,16400,55,120,37748,47186
20150205,16335,16400,16285,16400,16255,16280,16290,-120,-110,20890,44136
20150206,16280,16290,16260,16410,16205,16405,16315,115,25,16304,39908
20150209,16405,16315,16440,16450,16300,16350,16345,35,30,16232,37898
20150210,16350,16345,16370,16410,16320,16350,16345,5,0,7794,36216
20150211,16350,16345,16305,16305,16175,16195,16220,-150,-125,9700,33088
20150212,16195,16220,16200,16250,16135,16250,16180,30,-40,6282,31476
20150213,16250,16180,16295,16370,16255,16370,16320,190,140,8796,28790
20150216,16370,16320,16370,16430,16335,16410,16380,90,60,7156,26808
20150217,16410,16380,16405,16445,16310,16340,16375,-40,-5,4320,25660
20150225,16340,16375,16190,16190,15955,16100,16110,-275,-265,8222,21348
20150226,16100,16110,16100,16160,16060,16125,16095,15,-15,6996,18474
20150227,16125,16095,16280,16280,16050,16095,16100,0,5,7254,14464
20150302,16095,16100,16095,16250,16060,16185,16175,85,75,3444,14900
20150303,16185,16175,16130,16140,16050,16050,16085,-125,-90,3770,12840
20150304,16050,16085,16050,16050,15910,15915,15965,-170,-120,6050,9530
20150305,15915,15965,15920,15935,15850,15855,15900,-110,-65,1800,9120
20150306,15855,15900,15850,15865,15750,15780,15800,-120,-100,5230,6440
20150309,15780,15800,15750,15850,15715,15785,15755,-15,-45,3200,5950
20150310,15785,15755,15740,15825,15740,15750,15785,-5,30,1500,5220
20150311,15750,15785,15665,15750,15665,15720,15710,-65,-75,2490,4740
20150312,15720,15710,15650,15700,15600,15700,15610,-10,-100,1080,4510
20150313,15700,15610,15660,15700,15650,15700,15660,90,50,1370,3780
20150316,15700,15660,15790,15800,15745,15760,15755,100,95,550,3460
zn1504,20150105,16765,16625,16740,16850,16605,16695,16745,70,120,20460,22846
20150106,16695,16745,16500,16775,16480,16710,16670,-35,-75,26452,26310
20150107,16710,16670,16735,16755,16570,16610,16640,-60,-30,22602,27586
20150108,16610,16640,16560,16580,16375,16430,16485,-210,-155,27480,32468
20150109,16430,16485,16575,16575,16385,16410,16465,-75,-20,29212,34366
20150112,16410,16465,16410,16550,16350,16380,16445,-85,-20,35058,39012
20150113,16380,16445,16305,16360,16200,16210,16290,-235,-155,35642,41772
20150114,16210,16290,16020,16125,15500,15605,15785,-685,-505,140272,60944
20150115,15605,15785,15710,15905,15650,15835,15795,50,10,111790,63404
20150116,15835,15795,15865,15980,15705,15775,15805,-20,10,70686,67824
20150119,15775,15805,15805,16050,15770,16045,15920,240,115,90406,72258
20150120,16045,15920,15915,16055,15885,15990,15965,70,45,55132,76834
20150121,15990,15965,16095,16150,16005,16100,16075,135,110,58254,78014
20150122,16100,16075,16050,16400,16050,16330,16265,255,190,110432,100230
20150123,16330,16265,16355,16420,16170,16205,16270,-60,5,108538,101282
20150126,16205,16270,16130,16200,15875,16065,16045,-205,-225,178778,131698
20150127,16065,16045,16150,16395,16110,16275,16285,230,240,170488,144984
20150128,16275,16285,16315,16345,16195,16335,16280,50,-5,139784,152692
20150129,16335,16280,16310,16320,16070,16090,16175,-190,-105,151370,146800
20150130,16090,16175,16020,16135,16000,16020,16050,-155,-125,141942,151148
20150202,16020,16050,16145,16260,16095,16200,16170,150,120,152516,153802
20150203,16200,16170,16200,16325,16145,16280,16245,110,75,133202,147530
20150204,16280,16245,16370,16465,16290,16330,16380,85,135,173136,136934
20150205,16330,16380,16340,16380,16235,16270,16290,-110,-90,120522,134898
20150206,16270,16290,16225,16405,16195,16390,16305,100,15,117942,136548
20150209,16390,16305,16450,16455,16310,16355,16360,50,55,107594,125150
20150210,16355,16360,16380,16430,16325,16355,16370,-5,10,70872,120250
20150211,16355,16370,16300,16310,16160,16200,16220,-170,-150,107614,117132
20150212,16200,16220,16220,16240,16115,16235,16170,15,-50,71702,112322
20150213,16235,16170,16275,16375,16265,16350,16310,180,140,100602,105116
20150216,16350,16310,16375,16440,16330,16405,16380,95,70,54172,98594
20150217,16405,16380,16410,16450,16310,16320,16365,-60,-15,41978,90732
20150225,16320,16365,16050,16145,15995,16080,16070,-285,-295,55162,86460
20150226,16080,16070,16040,16110,15980,16060,16045,-10,-25,53620,80070
20150227,16060,16045,16135,16140,16005,16070,16065,25,20,57366,69872
20150302,16070,16065,16070,16220,16035,16180,16130,115,65,43412,61230
20150303,16180,16130,16105,16130,15980,15985,16055,-145,-75,28944,58708
20150304,15985,16055,15955,16005,15890,15910,15935,-145,-120,18624,56584
20150305,15910,15935,15930,15965,15805,15825,15870,-110,-65,15846,54682
20150306,15825,15870,15830,15905,15730,15745,15790,-125,-80,13780,50752
20150309,15745,15790,15700,15855,15690,15770,15775,-20,-15,12434,48196
20150310,15770,15775,15755,15830,15730,15755,15780,-20,5,13656,44256
20150311,15755,15780,15725,15780,15655,15690,15725,-90,-55,9494,42900
20150312,15690,15725,15715,15755,15595,15720,15660,-5,-65,8736,42272
20150313,15720,15660,15720,15740,15635,15730,15695,70,35,7480,39264
20150316,15730,15695,15695,15850,15650,15850,15765,155,70,5874,38102
20150317,15850,15765,15805,15810,15645,15680,15690,-85,-75,10540,32886
20150318,15680,15690,15600,15695,15590,15605,15660,-85,-30,7296,29010
20150319,15605,15660,15595,15665,15515,15600,15615,-60,-45,6016,26424
20150320,15600,15615,15600,15695,15600,15625,15645,10,30,4920,24716
20150323,15625,15645,15660,15935,15660,15795,15800,150,155,7498,22456
20150324,15795,15800,15885,16000,15800,15880,15870,80,70,11410,17698
20150325,15880,15870,15800,15930,15800,15870,15875,0,5,9728,15286
20150326,15870,15875,15895,15950,15880,15925,15915,50,40,4978,16258
20150327,15925,15915,16000,16010,15840,15890,15915,-25,0,3328,15540
20150330,15890,15915,15930,15955,15890,15905,15925,-10,10,1998,14598
20150331,15905,15925,15955,16015,15895,15905,15970,-20,45,5584,11160
20150401,15905,15970,15830,15925,15830,15895,15870,-75,-100,3490,11440
20150402,15895,15870,15920,15940,15895,15915,15915,45,45,1860,11030
20150403,15915,15915,15980,16080,15960,16060,16025,145,110,2760,10930
20150407,16060,16025,16110,16150,16035,16115,16105,90,80,2020,10140
20150408,16115,16105,16160,16180,16085,16090,16105,-15,0,1960,9970
20150409,16090,16105,16125,16125,16055,16115,16080,10,-25,1580,9640
20150410,16115,16080,16130,16255,16120,16255,16165,175,85,2510,8280
20150413,16255,16165,16300,16400,16300,16360,16320,195,155,1000,7660
20150414,16360,16320,16300,16300,16200,16250,16255,-70,-65,490,7320
20150415,16250,16255,16260,16360,16250,16360,16285,105,30,410,7420
zn1505,20150105,16755,16635,16660,16835,16595,16690,16730,55,95,5528,9542
20150106,16690,16730,16535,16755,16480,16690,16640,-40,-90,4508,10020
20150107,16690,16640,16715,16815,16550,16570,16615,-70,-25,3506,10430
20150108,16570,16615,16535,16550,16330,16405,16435,-210,-180,4926,11142
20150109,16405,16435,16560,16560,16365,16380,16430,-55,-5,3732,11404
20150112,16380,16430,16350,16515,16330,16375,16415,-55,-15,4350,12004
20150113,16375,16415,16250,16340,16180,16190,16270,-225,-145,5486,13918
20150114,16190,16270,16020,16105,15490,15575,15760,-695,-510,20784,19302
20150115,15575,15760,15640,15910,15625,15825,15765,65,5,16656,21534
20150116,15825,15765,15795,15915,15695,15760,15785,-5,20,12004,24656
20150119,15760,15785,15765,16030,15755,16020,15910,235,125,14902,24920
20150120,16020,15910,15920,16040,15870,15960,15950,50,40,12650,25906
20150121,15960,15950,16055,16125,15985,16050,16045,100,95,15192,26498
20150122,16050,16045,16050,16360,16005,16300,16210,255,165,20146,27428
20150123,16300,16210,16350,16375,16145,16190,16230,-20,20,18266,28346
20150126,16190,16230,16130,16165,15850,16045,16000,-185,-230,35556,33530
20150127,16045,16000,16120,16340,16070,16250,16235,250,235,23528,34648
20150128,16250,16235,16250,16310,16155,16300,16235,65,0,23400,37328
20150129,16300,16235,16280,16285,16040,16060,16145,-175,-90,41518,38568
20150130,16060,16145,15995,16090,15965,15995,16015,-150,-130,29816,39204
20150202,15995,16015,16105,16225,15950,16170,16130,155,115,27940,39166
20150203,16170,16130,16170,16290,16115,16280,16215,150,85,27802,42966
20150204,16280,16215,16375,16435,16285,16300,16360,85,145,27294,42914
20150205,16300,16360,16300,16360,16225,16275,16270,-85,-90,29144,49172
20150206,16275,16270,16250,16410,16205,16405,16310,135,40,33858,55730
20150209,16405,16310,16420,16460,16310,16370,16360,60,50,41862,66654
20150210,16370,16360,16400,16445,16335,16370,16380,10,20,30236,70054
20150211,16370,16380,16300,16315,16170,16185,16220,-195,-160,47670,77902
20150212,16185,16220,16210,16240,16115,16230,16175,10,-45,42982,81900
20150213,16230,16175,16285,16375,16260,16340,16310,165,135,43510,82496
20150216,16340,16310,16375,16430,16335,16425,16380,115,70,32574,83730
20150217,16425,16380,16420,16450,16305,16315,16370,-65,-10,42100,85644
20150225,16315,16370,16055,16120,15980,16060,16055,-310,-315,68062,98764
20150226,16060,16055,16010,16075,15950,16025,16020,-30,-35,124446,128128
20150227,16025,16020,16080,16120,15980,16050,16050,30,30,158808,141680
20150302,16050,16050,16075,16210,16000,16145,16100,95,50,159870,147826
20150303,16145,16100,16100,16110,15955,15960,16035,-140,-65,129158,162108
20150304,15960,16035,15920,15985,15860,15875,15915,-160,-120,115424,174168
20150305,15875,15915,15915,15945,15780,15815,15855,-100,-60,102366,177074
20150306,15815,15855,15810,15890,15700,15725,15780,-130,-75,104098,184642
20150309,15725,15780,15735,15845,15670,15740,15745,-40,-35,128336,181084
20150310,15740,15745,15725,15830,15710,15750,15780,5,35,94936,177824
20150311,15750,15780,15700,15780,15640,15695,15715,-85,-65,88516,174432
20150312,15695,15715,15725,15750,15585,15720,15655,5,-60,132136,173778
20150313,15720,15655,15700,15750,15635,15730,15695,75,40,107798,169552
20150316,15730,15695,15695,15840,15650,15815,15755,120,60,124646,164278
20150317,15815,15755,15765,15810,15655,15690,15730,-65,-25,96242,163160
20150318,15690,15730,15650,15710,15600,15615,15660,-115,-70,69740,158680
20150319,15615,15660,15620,15680,15520,15625,15615,-35,-45,102596,152210
20150320,15625,15615,15650,15705,15620,15650,15660,35,45,77164,142590
20150323,15650,15660,15700,15950,15675,15855,15830,195,170,138224,121904
20150324,15855,15830,15910,16040,15845,15910,15930,80,100,112754,103466
20150325,15910,15930,15940,15975,15875,15910,15920,-20,-10,66928,95218
20150326,15910,15920,15915,15995,15915,15955,15960,35,40,47256,86442
20150327,15955,15960,16025,16060,15880,15930,15950,-30,-10,51652,70096
20150330,15930,15950,15935,16000,15920,15965,15955,15,5,28302,64004
20150331,15965,15955,16000,16060,15950,15965,16015,10,60,38424,53760
20150401,15965,16015,15930,15995,15880,15935,15920,-80,-95,20484,49314
20150402,15935,15920,15895,16020,15890,15975,15950,55,30,22478,44532
20150403,15975,15950,16000,16150,15990,16140,16085,190,135,31006,37558
20150407,16140,16085,16125,16200,16080,16180,16145,95,60,16362,32050
20150408,16180,16145,16195,16245,16105,16140,16180,-5,35,18896,28684
20150409,16140,16180,16165,16190,16070,16120,16130,-60,-50,9928,26878
20150410,16120,16130,16190,16325,16155,16320,16220,190,90,22586,21532
20150413,16320,16220,16320,16410,16275,16400,16350,180,130,12290,22080
20150414,16400,16350,16425,16425,16210,16295,16310,-55,-40,8826,19856
20150415,16295,16310,16295,16415,16265,16370,16335,60,25,6764,19650
20150416,16370,16335,16340,16540,16335,16515,16500,180,165,10264,16092
20150417,16515,16500,16570,16700,16485,16575,16590,75,90,5456,15492
20150420,16575,16590,16515,16650,16420,16455,16525,-135,-65,3518,14534
20150421,16455,16525,16400,16505,16330,16395,16385,-130,-140,2618,14548
20150422,16395,16385,16410,16570,16410,16545,16505,160,120,3638,13574
20150423,16545,16505,16580,16630,16405,16540,16515,35,10,2324,12830
20150424,16540,16515,16475,16550,16445,16515,16470,0,-45,1718,12272
20150427,16515,16470,16580,16810,16550,16730,16690,260,220,3296,11960
20150428,16730,16690,16840,17045,16825,16915,16895,225,205,2972,11170
20150429,16915,16895,16945,16955,16740,16805,16875,-90,-20,1556,10888
20150430,16805,16875,16805,17015,16805,16985,16890,110,15,5800,11540
20150504,16985,16890,17030,17135,17030,17125,17100,235,210,1600,11020
20150505,17125,17100,17130,17130,16950,17000,17020,-100,-80,1920,10030
20150506,17000,17020,17260,17350,17190,17235,17245,215,225,4840,11960
20150507,17235,17245,17165,17255,17065,17065,17135,-180,-110,810,11540
20150508,17065,17135,16950,17045,16950,17000,16985,-135,-150,1400,10800
20150511,17000,16985,16900,16950,16835,16945,16895,-40,-90,1750,10620
20150512,16945,16895,16810,16810,16730,16750,16755,-145,-140,1120,10290
20150513,16750,16755,16575,17000,16575,17000,16910,245,155,630,9950
20150514,17000,16910,16800,16870,16800,16870,16825,-40,-85,910,9620
20150515,16870,16825,16780,16850,16720,16770,16780,-55,-45,280,9600
zn1506,20150105,16750,16660,16745,16830,16585,16690,16660,30,0,464,526
20150106,16690,16660,16510,16730,16510,16690,16610,30,-50,372,524
20150107,16690,16610,16680,16700,16560,16580,16625,-30,15,160,494
20150108,16580,16625,16545,16555,16360,16390,16435,-235,-190,128,524
20150109,16390,16435,16590,16590,16360,16410,16450,-25,15,170,610
20150112,16410,16450,16500,16500,16320,16355,16390,-95,-60,208,620
20150113,16355,16390,16310,16310,16165,16165,16255,-225,-135,220,704
20150114,16165,16255,16065,16085,15475,15580,15735,-675,-520,850,1194
20150115,15580,15735,16470,16470,15625,15835,15795,100,60,1150,1734
20150116,15835,15795,15865,15890,15690,15780,15770,-15,-25,2066,2558
20150119,15780,15770,15815,16025,15810,16025,15920,255,150,3032,3788
20150120,16025,15920,15915,16035,15850,15960,15955,40,35,780,3822
20150121,15960,15955,16015,16120,15985,16050,16045,95,90,2044,4696
20150122,16050,16045,15995,16355,15995,16275,16185,230,140,2474,4888
20150123,16275,16185,16315,16350,16125,16155,16235,-30,50,1488,5004
20150126,16155,16235,16120,16150,15840,16000,15945,-235,-290,4234,6236
20150127,16000,15945,16040,16300,16040,16225,16205,280,260,2202,6528
20150128,16225,16205,16235,16280,16130,16280,16205,75,0,766,6534
20150129,16280,16205,16255,16280,16030,16040,16115,-165,-90,3268,8006
20150130,16040,16115,15980,16050,15950,15965,15995,-150,-120,2526,8916
20150202,15965,15995,16095,16185,16035,16125,16100,130,105,4554,8254
20150203,16125,16100,16140,16255,16090,16245,16185,145,85,2334,7930
20150204,16245,16185,16305,16430,16265,16305,16345,120,160,3576,7986
20150205,16305,16345,16305,16335,16200,16255,16245,-90,-100,2508,8604
20150206,16255,16245,16210,16390,16190,16385,16285,140,40,2756,8486
20150209,16385,16285,16405,16435,16295,16365,16355,80,70,3398,9412
20150210,16365,16355,16370,16455,16335,16375,16385,20,30,2666,10048
20150211,16375,16385,16300,16315,16170,16215,16210,-170,-175,4314,11356
20150212,16215,16210,16230,16230,16115,16215,16160,5,-50,4612,13058
20150213,16215,16160,16285,16345,16245,16310,16295,150,135,3592,13600
20150216,16310,16295,16360,16405,16320,16400,16350,105,55,3132,14414
20150217,16400,16350,16415,16420,16275,16300,16320,-50,-30,2808,15040
20150225,16300,16320,16090,16090,15970,16040,16035,-280,-285,8034,16920
20150226,16040,16035,16000,16050,15935,16000,15995,-35,-40,16424,23542
20150227,16000,15995,16065,16100,15970,16035,16035,40,40,27900,36994
20150302,16035,16035,16050,16195,15985,16130,16095,95,60,26858,43972
20150303,16130,16095,16095,16095,15915,15930,16025,-165,-70,28094,52266
20150304,15930,16025,15900,15970,15835,15865,15900,-160,-125,20066,58450
20150305,15865,15900,15920,15930,15775,15800,15840,-100,-60,21138,61598
20150306,15800,15840,15800,15875,15680,15710,15755,-130,-85,29484,67100
20150309,15710,15755,15710,15835,15660,15730,15735,-25,-20,46260,70248
20150310,15730,15735,15730,15820,15695,15745,15775,10,40,34226,72204
20150311,15745,15775,15710,15780,15635,15690,15705,-85,-70,38536,75662
20150312,15690,15705,15710,15740,15575,15720,15645,15,-60,53354,83066
20150313,15720,15645,15700,15750,15630,15740,15695,95,50,54298,92338
20150316,15740,15695,15705,15830,15635,15815,15745,120,50,61624,100928
20150317,15815,15745,15745,15790,15650,15685,15715,-60,-30,59530,107464
20150318,15685,15715,15630,15700,15565,15610,15650,-105,-65,47410,114048
20150319,15610,15650,15610,15675,15520,15625,15615,-25,-35,75076,123040
20150320,15625,15615,15655,15705,15620,15655,15660,40,45,73938,126662
20150323,15655,15660,15705,15945,15680,15840,15830,180,170,111528,123710
20150324,15840,15830,15920,16050,15855,15910,15940,80,110,109732,120758
20150325,15910,15940,15930,15995,15875,15910,15930,-30,-10,85430,122382
20150326,15910,15930,15935,16015,15915,15965,15970,35,40,96702,125250
20150327,15965,15970,16030,16075,15910,15945,15975,-25,5,111646,121658
20150330,15945,15975,15965,16020,15935,15965,15975,-10,0,77676,121958
20150331,15965,15975,16030,16090,15980,15985,16040,10,65,115234,124552
20150401,15985,16040,15975,16025,15910,15975,15955,-65,-85,85624,126500
20150402,15975,15955,15925,16055,15925,16000,15990,45,35,102918,124770
20150403,16000,15990,16050,16195,16030,16160,16125,170,135,149792,133142
20150407,16160,16125,16160,16245,16135,16215,16195,90,70,69500,136226
20150408,16215,16195,16230,16300,16140,16190,16225,-5,30,118158,128234
20150409,16190,16225,16190,16240,16105,16165,16170,-60,-55,83652,124388
20150410,16165,16170,16215,16375,16200,16360,16270,190,100,176474,129970
20150413,16360,16270,16375,16470,16330,16450,16395,180,125,147650,127450
20150414,16450,16395,16475,16480,16255,16330,16365,-65,-30,134046,118176
20150415,16330,16365,16350,16470,16300,16425,16375,60,10,108834,120994
20150416,16425,16375,16400,16590,16380,16560,16535,185,160,149780,118312
20150417,16560,16535,16605,16745,16525,16620,16635,85,100,115488,114506
20150420,16620,16635,16590,16710,16450,16475,16565,-160,-70,100654,104956
20150421,16475,16565,16420,16530,16350,16420,16425,-145,-140,92344,93174
20150422,16420,16425,16440,16590,16420,16555,16525,130,100,68304,91032
20150423,16555,16525,16590,16650,16430,16560,16560,35,35,90140,88068
20150424,16560,16560,16545,16580,16470,16555,16515,-5,-45,65198,84090
20150427,16555,16515,16630,16855,16565,16760,16715,245,200,114048,80298
20150428,16760,16715,16805,17100,16805,16970,16950,255,235,70012,69974
20150429,16970,16950,16870,17025,16730,16835,16895,-115,-55,41286,63702
20150430,16835,16895,16825,17055,16775,16965,16935,70,40,39914,60068
20150504,16965,16935,17150,17200,17020,17170,17130,235,195,26126,54140
20150505,17170,17130,17260,17260,16970,17010,17060,-120,-70,28880,49212
20150506,17010,17060,17150,17405,17105,17305,17295,245,235,39864,45556
20150507,17305,17295,17300,17370,17080,17125,17175,-170,-120,19042,41274
20150508,17125,17175,17190,17235,16985,17055,17070,-120,-105,12860,37596
20150511,17055,17070,17045,17130,16875,17040,16975,-30,-95,14290,32668
20150512,17040,16975,16935,16975,16780,16810,16850,-165,-125,9604,28308
20150513,16810,16850,16930,17095,16890,17090,16985,240,135,6602,27048
20150514,17090,16985,17125,17150,16770,16945,16920,-40,-65,5860,26226
20150515,16945,16920,16880,16935,16795,16860,16850,-60,-70,5970,23786
20150518,16860,16850,16795,16860,16690,16835,16775,-15,-75,4136,22762
20150519,16835,16775,16775,16850,16725,16805,16795,30,20,4322,20890
20150520,16805,16795,16690,16720,16545,16600,16630,-195,-165,7664,18006
20150521,16600,16630,16550,16675,16460,16590,16570,-40,-60,4552,17628
20150522,16590,16570,16500,16640,16500,16595,16590,25,20,2272,16894
20150525,16595,16590,16500,16510,16365,16500,16475,-90,-115,3540,16208
20150526,16500,16475,16540,16635,16490,16490,16570,15,95,3008,15574
20150527,16490,16570,16445,16625,16445,16585,16565,15,-5,2344,14884
20150528,16585,16565,16555,16735,16530,16730,16675,165,110,3678,14050
20150529,16730,16675,16775,16820,16655,16800,16705,125,30,3156,12740
20150601,16800,16705,16635,16645,16565,16570,16585,-135,-120,1990,13360
20150602,16570,16585,16520,16600,16420,16500,16475,-85,-110,2030,13030
20150603,16500,16475,16500,16500,16285,16345,16400,-130,-75,4080,11990
20150604,16345,16400,16345,16415,16290,16350,16340,-50,-60,2500,11240
20150605,16350,16340,16365,16365,16200,16200,16265,-140,-75,2470,9990
20150608,16200,16265,16255,16270,16250,16255,16260,-10,-5,1620,8930
20150609,16255,16260,16280,16320,16280,16300,16305,40,45,470,8520
20150610,16300,16305,16400,16400,16350,16360,16355,55,50,760,7880
20150611,16360,16355,16280,16305,16250,16250,16285,-105,-70,800,7370
20150612,16250,16285,16240,16240,16110,16110,16170,-175,-115,240,7280
20150615,16110,16170,16170,16180,16130,16130,16155,-40,-15,300,7200
zn1507,20150105,16750,16715,16760,16950,16630,16640,16780,-75,65,106,162
20150106,16640,16780,16615,16675,16615,16675,16640,-105,-140,16,168
20150107,16675,16640,16615,16635,16570,16570,16610,-70,-30,26,160
20150108,16570,16610,16550,16550,16350,16435,16465,-175,-145,16,162
20150109,16435,16465,16535,16535,16380,16380,16420,-85,-45,32,154
20150112,16380,16420,16425,16425,16330,16345,16355,-75,-65,34,130
20150113,16345,16355,16245,16305,16160,16165,16205,-190,-150,90,122
20150114,16165,16205,16060,16060,15440,15440,15735,-765,-470,104,172
20150115,15440,15735,15660,15850,15660,15835,15825,100,90,522,640
20150116,15835,15825,15835,15835,15705,15785,15765,-40,-60,34,632
20150119,15785,15765,15880,16000,15880,16000,15940,235,175,6,626
20150120,16000,15940,15935,15980,15935,15960,15960,20,20,16,626
20150121,15960,15960,16020,16095,16005,16030,16055,70,95,146,676
20150122,16030,16055,16090,16320,16070,16295,16135,240,80,318,932
20150123,16295,16135,16215,16260,16120,16140,16180,5,45,46,938
20150126,16140,16180,16110,16110,15815,15960,15920,-220,-260,324,1140
20150127,15960,15920,16200,16300,16150,16180,16220,260,300,294,1274
20150128,16180,16220,16265,16265,16170,16230,16210,10,-10,364,1532
20150129,16230,16210,16140,16140,16070,16070,16105,-140,-105,44,1534
20150130,16070,16105,16020,16030,15945,15960,15990,-145,-115,160,1544
20150202,15960,15990,16045,16150,16045,16140,16105,150,115,426,1884
20150203,16140,16105,16100,16225,16100,16220,16145,115,40,202,1858
20150204,16220,16145,16295,16395,16280,16345,16330,200,185,152,1786
20150205,16345,16330,16260,16305,16215,16245,16235,-85,-95,390,1682
20150206,16245,16235,16235,16345,16230,16345,16270,110,35,70,1662
20150209,16345,16270,16310,16365,16310,16365,16335,95,65,334,1644
20150210,16365,16335,16400,16440,16365,16380,16375,45,40,92,1644
20150211,16380,16375,15555,16290,15555,16200,16205,-175,-170,406,1628
20150212,16200,16205,16220,16225,16115,16220,16170,15,-35,234,1580
20150213,16220,16170,16260,16340,16240,16315,16290,145,120,194,1622
20150216,16315,16290,16390,16390,16305,16355,16350,65,60,386,1812
20150217,16355,16350,16345,16400,16290,16290,16355,-60,5,132,1810
20150225,16290,16355,16055,16095,15975,16040,16030,-315,-325,592,2206
20150226,16040,16030,16000,16045,15935,15990,15985,-40,-45,2038,2576
20150227,15990,15985,16030,16085,15965,16020,16015,35,30,1696,2750
20150302,16020,16015,16020,16190,15970,16145,16145,130,130,9372,9566
20150303,16145,16145,16090,16090,15950,15950,16025,-195,-120,4332,11482
20150304,15950,16025,15950,15965,15840,15850,15895,-175,-130,5290,13434
20150305,15850,15895,15895,15915,15770,15795,15845,-100,-50,3884,13562
20150306,15795,15845,15790,15875,15680,15715,15765,-130,-80,5134,16172
20150309,15715,15765,15710,15825,15660,15730,15755,-35,-10,6928,19084
20150310,15730,15755,15725,15815,15710,15750,15780,-5,25,3662,20172
20150311,15750,15780,15710,15770,15640,15680,15705,-100,-75,10062,18232
20150312,15680,15705,15715,15730,15565,15715,15635,10,-70,10886,23190
20150313,15715,15635,15715,15740,15620,15710,15680,75,45,10046,26300
20150316,15710,15680,15690,15815,15630,15800,15730,120,50,13342,27504
20150317,15800,15730,15730,15775,15650,15675,15715,-55,-15,13294,32558
20150318,15675,15715,15650,15700,15580,15605,15650,-110,-65,7208,33640
20150319,15605,15650,15610,15670,15510,15625,15600,-25,-50,12044,36658
20150320,15625,15600,15655,15690,15615,15640,15650,40,50,13294,40654
20150323,15640,15650,15695,15930,15675,15835,15825,185,175,20110,42960
20150324,15835,15825,15915,16040,15870,15915,15935,90,110,20054,43544
20150325,15915,15935,15930,16000,15880,15945,15935,10,0,18074,44732
20150326,15945,15935,15945,16025,15925,15980,15985,45,50,18786,44350
20150327,15980,15985,16030,16095,15935,15950,15990,-35,5,27270,41686
20150330,15950,15990,15950,16040,15950,15990,15990,0,0,14950,42218
20150331,15990,15990,16025,16100,16005,16015,16060,25,70,21100,44496
20150401,16015,16060,15995,16040,15930,15985,15960,-75,-100,12806,44038
20150402,15985,15960,15940,16065,15930,16030,16005,70,45,16842,44694
20150403,16030,16005,16080,16210,16055,16180,16150,175,145,27208,51224
20150407,16180,16150,16180,16270,16160,16250,16225,100,75,13996,54192
20150408,16250,16225,16270,16325,16165,16210,16240,-15,15,23032,55580
20150409,16210,16240,16225,16255,16130,16190,16190,-50,-50,16124,55820
20150410,16190,16190,16230,16405,16225,16395,16300,205,110,41172,61510
20150413,16395,16300,16385,16500,16365,16490,16430,190,130,41098,66550
20150414,16490,16430,16500,16515,16280,16355,16380,-75,-50,43682,64994
20150415,16355,16380,16375,16505,16325,16455,16405,75,25,58754,80792
20150416,16455,16405,16435,16625,16415,16595,16570,190,165,70404,86440
20150417,16595,16570,16675,16775,16575,16660,16675,90,105,70174,94028
20150420,16660,16675,16620,16745,16480,16500,16590,-175,-85,65654,87012
20150421,16500,16590,16470,16545,16370,16450,16450,-140,-140,62118,89642
20150422,16450,16450,16450,16625,16445,16590,16555,140,105,58326,100088
20150423,16590,16555,16655,16680,16455,16590,16585,35,30,74896,104306
20150424,16590,16585,16570,16615,16505,16595,16550,10,-35,55146,106192
20150427,16595,16550,16670,16905,16610,16810,16765,260,215,155364,133190
20150428,16810,16765,16860,17150,16855,17015,16995,250,230,175154,144450
20150429,17015,16995,17000,17070,16760,16860,16955,-135,-40,140410,141094
20150430,16860,16955,16870,17110,16820,17000,16990,45,35,196162,154842
20150504,17000,16990,17130,17240,17070,17210,17180,220,190,113462,162700
20150505,17210,17180,17210,17250,17015,17070,17110,-110,-70,133992,161892
20150506,17070,17110,17195,17470,17180,17370,17370,260,260,265506,180216
20150507,17370,17370,17350,17440,17140,17185,17255,-185,-115,157446,170142
20150508,17185,17255,17250,17290,17045,17105,17140,-150,-115,165746,154558
20150511,17105,17140,17120,17190,16925,17095,17035,-45,-105,160890,151082
20150512,17095,17035,17000,17025,16820,16870,16905,-165,-130,162110,137510
20150513,16870,16905,17020,17145,16940,17140,17040,235,135,147674,144402
20150514,17140,17040,17150,17450,16890,17000,17010,-40,-30,173986,132072
20150515,17000,17010,16940,16990,16840,16935,16900,-75,-110,121098,117368
20150518,16935,16900,16860,16915,16740,16875,16820,-25,-80,123096,106782
20150519,16875,16820,16835,16910,16770,16865,16835,45,15,85834,105608
20150520,16865,16835,16770,16770,16580,16630,16670,-205,-165,140786,89902
20150521,16630,16670,16600,16715,16485,16620,16580,-50,-90,111624,81704
20150522,16620,16580,16540,16685,16535,16615,16615,35,35,78870,79798
20150525,16615,16615,16480,16550,16400,16520,16495,-95,-120,61340,74664
20150526,16520,16495,16525,16665,16495,16515,16600,20,105,61906,69146
20150527,16515,16600,16455,16640,16450,16605,16570,5,-30,50968,63650
20150528,16605,16570,16535,16780,16515,16770,16685,200,115,67278,59134
20150529,16770,16685,16810,16870,16675,16795,16765,110,80,57520,49940
20150601,16795,16765,16695,16740,16570,16570,16620,-195,-145,37204,42730
20150602,16570,16620,16480,16560,16420,16495,16490,-125,-130,29222,40954
20150603,16495,16490,16500,16610,16265,16315,16435,-175,-55,31744,36746
20150604,16315,16435,16355,16430,16265,16390,16350,-45,-85,16116,33864
20150605,16390,16350,16425,16445,16200,16200,16300,-150,-50,14498,30680
20150608,16200,16300,16210,16315,16210,16260,16270,-40,-30,5624,29266
20150609,16260,16270,16265,16370,16265,16340,16320,70,50,5620,27868
20150610,16340,16320,16395,16450,16365,16400,16390,80,70,5800,25842
20150611,16400,16390,16425,16425,16235,16270,16310,-120,-80,5676,24564
20150612,16270,16310,16270,16295,16100,16145,16190,-165,-120,8804,22944
20150615,16145,16190,16155,16235,16090,16100,16155,-90,-35,7178,21400
20150616,16100,16155,16085,16135,16050,16080,16090,-75,-65,3238,21132
20150617,16080,16090,16095,16100,15880,15880,15995,-210,-95,6454,21200
20150618,15880,15995,15965,15985,15815,15885,15890,-110,-105,3818,20808
20150619,15885,15890,15890,15895,15675,15685,15730,-205,-160,3478,20366
20150623,15685,15730,15640,15700,15575,15585,15635,-145,-95,2490,19054
20150624,15585,15635,15600,15780,15595,15765,15675,130,40,3758,17942
20150625,15765,15675,15765,15780,15615,15625,15665,-50,-10,3486,16452
20150626,15625,15665,15605,15670,15585,15620,15635,-45,-30,4006,14890
20150629,15620,15635,15575,15600,15445,15450,15510,-185,-125,2838,13376
20150630,15450,15510,15465,15585,15275,15330,15370,-180,-140,3836,10932
20150701,15330,15370,15240,15360,15190,15280,15245,-90,-125,2212,10230
20150702,15280,15245,15380,15585,15380,15580,15550,335,305,1180,10160
20150703,15580,15550,15635,15635,15480,15520,15520,-30,-30,970,10120
20150706,15520,15520,15380,15480,15050,15205,15310,-315,-210,1640,9110
20150707,15205,15310,15195,15415,15195,15260,15345,-50,35,2110,8380
20150708,15260,15345,15120,15200,14575,14655,14780,-690,-565,6270,8560
20150709,14655,14780,14845,15390,14845,15250,15200,470,420,1510,8580
20150710,15250,15200,15300,15500,15285,15415,15435,215,235,720,8320
20150713,15415,15435,15315,15325,15270,15310,15300,-125,-135,1050,8180
20150714,15310,15300,15550,15570,15500,15500,15545,200,245,1640,7330
20150715,15500,15545,15630,15685,15620,15675,15660,130,115,340,7330
zn1508,20150105,16725,16640,16720,16830,16620,16730,16730,90,90,34,294
20150106,16730,16730,16555,16695,16555,16685,16640,-45,-90,24,294
20150107,16685,16640,16685,16685,16570,16570,16610,-70,-30,38,290
20150108,16570,16610,16530,16530,16300,16415,16455,-195,-155,86,316
20150109,16415,16455,16495,16500,16365,16445,16420,-10,-35,68,312
20150112,16445,16420,16445,16445,16355,16360,16395,-60,-25,18,316
20150113,16360,16395,16195,16300,16180,16180,16225,-215,-170,132,304
20150114,16180,16225,16105,16105,15510,15580,15780,-645,-445,228,390
20150115,15580,15780,15645,15845,15645,15840,15755,60,-25,88,390
20150116,15840,15755,15820,15845,15670,15730,15745,-25,-10,16,390
20150119,15730,15745,15845,15995,15845,15995,15955,250,210,108,398
20150120,15995,15955,15930,16025,15900,15955,15940,0,-15,24,390
20150121,15955,15940,15970,16060,15970,16030,15995,90,55,68,428
20150122,16030,15995,16010,16300,16010,16245,16130,250,135,94,446
20150123,16245,16130,16305,16330,16210,16235,16280,105,150,54,436
20150126,16235,16280,16100,16100,15900,15975,16000,-305,-280,50,466
20150127,15975,16000,16230,16285,16145,16190,16210,190,210,40,462
20150128,16190,16210,16220,16240,16190,16235,16220,25,10,34,488
20150129,16235,16220,16200,16200,16095,16095,16110,-125,-110,32,498
20150130,16095,16110,16040,16045,15955,15980,16015,-130,-95,352,670
20150202,15980,16015,16055,16110,16055,16110,16075,95,60,22,664
20150203,16110,16075,16090,16230,16090,16220,16190,145,115,16,666
20150204,16220,16190,16315,16350,16255,16305,16315,115,125,210,758
20150205,16305,16315,16250,16310,16210,16235,16245,-80,-70,66,740
20150206,16235,16245,16210,16330,16210,16330,16295,85,50,32,756
20150209,16330,16295,16395,16395,16300,16320,16325,25,30,60,754
20150210,16320,16325,16430,16430,16360,16390,16380,65,55,50,744
20150211,16390,16380,16295,16295,16160,16160,16250,-220,-130,134,714
20150212,16160,16250,16185,16185,16120,16160,16145,-90,-105,8,710
20150213,16160,16145,16235,16330,16235,16295,16300,150,155,58,668
20150216,16295,16300,16360,16385,16310,16350,16350,50,50,32,666
20150217,16350,16350,16355,16400,16300,16300,16355,-50,5,8,664
20150225,16300,16355,16000,16050,15990,16025,16040,-330,-315,108,752
20150226,16025,16040,16010,16055,15940,15990,15995,-50,-45,330,948
20150227,15990,15995,16030,16085,15960,16010,16005,15,10,432,1110
20150302,16010,16005,16030,16170,15980,16130,16095,125,90,266,1224
20150303,16130,16095,16070,16080,15950,15955,16025,-140,-70,200,1310
20150304,15955,16025,15900,15950,15850,15850,15900,-175,-125,414,1520
20150305,15850,15900,15905,15905,15790,15800,15815,-100,-85,140,1548
20150306,15800,15815,15780,15870,15680,15715,15755,-100,-60,228,1622
20150309,15715,15755,15680,15820,15665,15730,15705,-25,-50,190,1712
20150310,15730,15705,15735,15810,15705,15750,15760,45,55,104,1706
20150311,15750,15760,15690,15740,15655,15685,15695,-75,-65,290,1788
20150312,15685,15695,15735,15735,15575,15710,15645,15,-50,598,1946
20150313,15710,15645,15720,15735,15625,15730,15685,85,40,1062,2386
20150316,15730,15685,15685,15805,15635,15800,15755,115,70,1998,3162
20150317,15800,15755,15730,15780,15645,15685,15715,-70,-40,554,3384
20150318,15685,15715,15620,15695,15600,15610,15650,-105,-65,650,3528
20150319,15610,15650,15635,15670,15520,15640,15615,-10,-35,590,3596
20150320,15640,15615,15660,15685,15615,15655,15645,40,30,1568,4520
20150323,15655,15645,15700,15920,15690,15850,15810,205,165,1096,4648
20150324,15850,15810,15930,16025,15885,15930,15945,120,135,3360,5678
20150325,15930,15945,15945,16010,15890,15930,15950,-15,5,952,5714
20150326,15930,15950,15945,16035,15945,15995,15995,45,45,828,5778
20150327,15995,15995,16085,16115,15945,15965,15985,-30,-10,2662,6546
20150330,15965,15985,15990,16050,15975,15985,16000,0,15,1954,7302
20150331,15985,16000,16025,16115,16020,16020,16075,20,75,1936,8140
20150401,16020,16075,15955,16040,15940,15990,15970,-85,-105,1728,8540
20150402,15990,15970,15970,16080,15965,16055,16020,85,50,2252,9074
20150403,16055,16020,16150,16235,16080,16185,16165,165,145,2060,9396
20150407,16185,16165,16225,16285,16205,16265,16250,100,85,1330,9854
20150408,16265,16250,16295,16340,16190,16240,16260,-10,10,2070,10002
20150409,16240,16260,16260,16275,16155,16195,16195,-65,-65,1726,10472
20150410,16195,16195,16260,16420,16245,16420,16315,225,120,6580,13854
20150413,16420,16315,16420,16515,16380,16510,16450,195,135,5866,15876
20150414,16510,16450,16510,16540,16305,16380,16420,-70,-30,3902,16848
20150415,16380,16420,16370,16520,16350,16475,16430,55,10,6178,19692
20150416,16475,16430,16450,16650,16440,16615,16615,185,185,13130,23596
20150417,16615,16615,16690,16800,16610,16685,16700,70,85,11584,28730
20150420,16685,16700,16635,16770,16500,16510,16605,-190,-95,9012,29384
20150421,16510,16605,16475,16550,16385,16450,16460,-155,-145,12170,30946
20150422,16450,16460,16400,16635,16400,16590,16565,130,105,11398,34534
20150423,16590,16565,16715,16715,16470,16605,16610,40,45,12528,36230
20150424,16605,16610,16585,16630,16530,16610,16570,0,-40,8454,37034
20150427,16610,16570,16695,16925,16640,16830,16800,260,230,27178,43702
20150428,16830,16800,16895,17170,16890,17025,17010,225,210,28420,50280
20150429,17025,17010,17005,17085,16630,16885,16975,-125,-35,21664,53024
20150430,16885,16975,16900,17125,16845,17040,17015,65,40,26584,59168
20150504,17040,17015,17100,17260,17100,17235,17210,220,195,22182,63088
20150505,17235,17210,17220,17280,17050,17090,17145,-120,-65,25602,64250
20150506,17090,17145,17205,17500,17205,17390,17405,245,260,51642,76842
20150507,17390,17405,17365,17475,17180,17215,17275,-190,-130,33362,77482
20150508,17215,17275,17285,17320,17085,17135,17170,-140,-105,50398,75840
20150511,17135,17170,17135,17235,16965,17135,17080,-35,-90,50858,81890
20150512,17135,17080,17045,17065,16865,16915,16940,-165,-140,50644,80290
20150513,16915,16940,17080,17190,16985,17180,17085,240,145,60666,87220
20150514,17180,17085,17200,17250,16935,17055,17045,-30,-40,62690,88850
20150515,17055,17045,17000,17050,16895,16985,16950,-60,-95,43612,87392
20150518,16985,16950,16900,16965,16795,16925,16880,-25,-70,49524,89104
20150519,16925,16880,16860,16950,16815,16895,16890,15,10,43344,88942
20150520,16895,16890,16800,16815,16610,16670,16710,-220,-180,73030,85834
20150521,16670,16710,16670,16750,16530,16660,16630,-50,-80,81190,79352
20150522,16660,16630,16580,16740,16570,16665,16655,35,25,57380,79366
20150525,16665,16655,16500,16590,16405,16545,16525,-110,-130,64368,84232
20150526,16545,16525,16555,16700,16520,16525,16630,0,105,73566,89888
20150527,16525,16630,16500,16675,16470,16630,16605,0,-25,93034,107958
20150528,16630,16605,16550,16840,16550,16835,16730,230,125,189616,135750
20150529,16835,16730,16880,16935,16720,16850,16820,120,90,172352,138648
20150601,16850,16820,16740,16795,16610,16615,16675,-205,-145,142398,136834
20150602,16615,16675,16505,16605,16450,16540,16530,-135,-145,135802,140450
20150603,16540,16530,16530,16640,16260,16345,16485,-185,-45,180892,138514
20150604,16345,16485,16400,16460,16285,16405,16385,-80,-100,126954,133752
20150605,16405,16385,16400,16470,16200,16210,16310,-175,-75,138962,130166
20150608,16210,16310,16230,16320,16210,16275,16275,-35,-35,80784,128556
20150609,16275,16275,16285,16375,16275,16330,16330,55,55,84136,127460
20150610,16330,16330,16400,16475,16380,16420,16425,90,95,88160,121318
20150611,16420,16425,16430,16460,16255,16285,16335,-140,-90,94234,123490
20150612,16285,16335,16280,16305,16100,16130,16195,-205,-140,118598,123048
20150615,16130,16195,16165,16255,16085,16090,16170,-105,-25,75954,123108
20150616,16090,16170,16060,16145,16040,16095,16095,-75,-75,60406,121988
20150617,16095,16095,16095,16120,15300,15900,16005,-195,-90,94912,120472
20150618,15900,16005,16000,16005,15820,15885,15885,-120,-120,84770,116940
20150619,15885,15885,15895,15900,15670,15695,15755,-190,-130,112360,110968
20150623,15695,15755,15645,15700,15555,15595,15620,-160,-135,49994,110408
20150624,15595,15620,15600,15795,15580,15790,15685,170,65,63460,105080
20150625,15790,15685,15785,15790,15600,15630,15675,-55,-10,68704,100488
20150626,15630,15675,15610,15670,15575,15615,15625,-60,-50,55804,95572
20150629,15615,15625,15580,15630,15400,15405,15510,-220,-115,61830,83838
20150630,15405,15510,15400,15445,15225,15235,15355,-275,-155,79772,66536
20150701,15235,15355,15240,15345,15140,15220,15235,-135,-120,48614,56512
20150702,15220,15235,15310,15580,15310,15570,15485,335,250,35310,50752
20150703,15570,15485,15480,15645,15425,15510,15530,25,45,29328,48086
20150706,15510,15530,15470,15495,14980,15160,15255,-370,-275,28468,44386
20150707,15160,15255,15210,15425,15125,15230,15280,-25,25,22664,42942
20150708,15230,15280,15110,15235,14515,14560,14795,-720,-485,50526,34206
20150709,14560,14795,14800,15350,14680,15225,15015,430,220,29428,28352
20150710,15225,15015,15330,15480,15185,15320,15335,305,320,12114,27610
20150713,15320,15335,15275,15345,15185,15280,15245,-55,-90,6534,27684
20150714,15280,15245,15480,15630,15425,15490,15540,245,295,9374,26442
20150715,15490,15540,15490,15745,15405,15710,15625,170,85,11114,23758
20150716,15710,15625,15825,15825,15635,15760,15730,135,105,7470,22712
20150717,15760,15730,15680,15730,15625,15700,15680,-30,-50,3430,22344
20150720,15700,15680,15605,15730,15510,15570,15595,-110,-85,3480,21948
20150721,15570,15595,15500,15615,15490,15585,15555,-10,-40,3146,20410
20150722,15585,15555,15575,15590,15180,15235,15385,-320,-170,5124,18236
20150723,15235,15385,15215,15290,15115,15280,15195,-105,-190,4048,17188
20150724,15280,15195,15245,15285,14995,15025,15090,-170,-105,2952,16540
20150727,15025,15090,15030,15065,14770,14790,14880,-300,-210,4372,15596
20150728,14790,14880,14760,14910,14720,14865,14830,-15,-50,2382,14786
20150729,14865,14830,15010,15260,14990,15210,15195,380,365,4508,12290
20150730,15210,15195,15075,15125,14935,14945,15035,-250,-160,1548,11632
20150731,14945,15035,14915,15055,14865,14980,14965,-55,-70,3484,11450
20150803,14980,14965,14920,15020,14300,14300,14850,-665,-115,3350,10830
20150804,14300,14850,14735,14870,14700,14870,14765,20,-85,1110,10500
20150805,14870,14765,14880,14915,14795,14865,14850,100,85,890,10370
20150806,14865,14850,14800,14850,14750,14800,14810,-50,-40,2160,9170
20150807,14800,14810,14730,14760,14645,14645,14690,-165,-120,2590,9680
20150810,14645,14690,14540,14850,14540,14790,14730,100,40,1610,9530
20150811,14790,14730,14930,14975,14885,14930,14940,200,210,920,9180
20150812,14930,14940,14740,15120,14740,15060,14945,120,5,1210,8780
20150813,15060,14945,15175,15180,15005,15180,15125,235,180,930,8440
20150814,15180,15125,15205,15215,15065,15140,15165,15,40,1120,7630
20150817,15140,15165,15050,15050,15000,15010,15030,-155,-135,370,7690
zn1509,20150105,16710,16705,16710,16885,16710,16810,16815,105,110,46,94
20150106,16810,16815,16720,16720,16720,16720,16720,-95,-95,6,96
20150107,16720,16720,16715,16715,16595,16595,16655,-125,-65,6,92
20150108,16595,16655,16530,16530,16445,16450,16485,-205,-170,28,100
20150109,16450,16485,16485,16485,16385,16440,16415,-45,-70,62,120
20150112,16440,16415,16595,16595,16330,16345,16420,-70,5,18,118
20150113,16345,16420,16185,16315,16170,16175,16230,-245,-190,46,124
20150114,16175,16230,16000,16000,15500,15590,15710,-640,-520,148,164
20150115,15590,15710,15640,15815,15640,15815,15730,105,20,26,162
20150116,15815,15730,15770,15770,15770,15770,15770,40,40,4,164
20150119,15770,15770,15865,15970,15865,15970,15920,200,150,18,176
20150120,15970,15920,15960,16025,15925,15985,15965,65,45,10,174
20150121,15985,15965,16000,16105,16000,16050,16060,85,95,32,172
20150122,16050,16060,16035,16375,16035,16310,16175,250,115,20,170
20150123,16310,16175,16280,16280,16280,16280,16280,105,105,2,168
20150126,16280,16280,16135,16135,15900,15900,16005,-380,-275,30,172
20150127,15900,16005,16140,16305,16140,16305,16215,300,210,8,170
20150128,16305,16215,16230,16315,16215,16270,16245,55,30,28,180
20150129,16270,16245,16230,16230,16100,16125,16155,-120,-90,10,180
20150130,16125,16155,16065,16080,16000,16000,16050,-155,-105,22,194
20150202,16000,16050,16150,16150,16080,16140,16105,90,55,16,198
20150203,16140,16105,16140,16250,16140,16210,16205,105,100,26,182
20150204,16210,16205,16295,16385,16270,16340,16325,135,120,36,182
20150205,16340,16325,16220,16335,16220,16220,16250,-105,-75,42,198
20150206,16220,16250,16215,16345,16215,16345,16275,95,25,12,190
20150209,16345,16275,16375,16375,16355,16355,16365,80,90,4,188
20150210,16355,16365,,,,16420,16420,55,55,0,188
20150211,16420,16420,16280,16280,16190,16190,16235,-230,-185,4,188
20150212,16190,16235,16180,16180,16180,16180,16180,-55,-55,4,186
20150213,16180,16180,,,,16335,16335,155,155,0,186
20150216,16335,16335,16385,16385,16365,16365,16375,30,40,22,182
20150217,16365,16375,,,,16380,16380,5,5,0,182
20150225,16380,16380,16050,16050,16050,16050,16050,-330,-330,4,182
20150226,16050,16050,15980,16045,15980,16045,16010,-5,-40,4,182
20150227,16045,16010,16075,16100,15995,16080,16025,70,15,52,212
20150302,16080,16025,16135,16175,16135,16175,16160,150,135,20,210
20150303,16175,16160,16050,16050,15990,15990,16025,-170,-135,20,220
20150304,15990,16025,15880,15925,15875,15915,15900,-110,-125,18,220
20150305,15915,15900,15900,15900,15800,15800,15840,-100,-60,12,230
20150306,15800,15840,15815,15845,15710,15710,15775,-130,-65,16,236
20150309,15710,15775,15725,15725,15725,15725,15725,-50,-50,2,236
20150310,15725,15725,15810,15815,15760,15765,15785,40,60,32,238
20150311,15765,15785,,,,15785,15785,0,0,0,238
20150312,15785,15785,15750,15760,15630,15745,15710,-40,-75,254,364
20150313,15745,15710,15740,15745,15660,15720,15700,10,-10,384,620
20150316,15720,15700,15710,15845,15660,15845,15780,145,80,112,678
20150317,15845,15780,15780,15795,15670,15675,15695,-105,-85,286,744
20150318,15675,15695,15610,15710,15610,15655,15670,-40,-25,348,844
20150319,15655,15670,15645,15695,15525,15625,15620,-45,-50,574,1224
20150320,15625,15620,15650,15710,15640,15660,15670,40,50,74,1258
20150323,15660,15670,15730,15930,15730,15860,15865,190,195,546,1576
20150324,15860,15865,15950,16050,15900,15930,15965,65,100,640,1942
20150325,15930,15965,15920,16000,15920,15945,15970,-20,5,276,2040
20150326,15945,15970,16000,16095,15990,16015,16010,45,40,162,2070
20150327,16015,16010,16105,16130,15965,15980,16015,-30,5,610,2320
20150330,15980,16015,16010,16070,15990,16000,16020,-15,5,538,2590
20150331,16000,16020,16080,16120,16050,16050,16095,30,75,182,2654
20150401,16050,16095,15975,16020,15950,15995,15990,-100,-105,384,2816
20150402,15995,15990,16040,16095,15995,16050,16045,60,55,294,2958
20150403,16050,16045,16075,16245,16075,16205,16195,160,150,242,2994
20150407,16205,16195,16230,16290,16230,16280,16270,85,75,182,3086
20150408,16280,16270,16320,16365,16220,16250,16280,-20,10,264,3124
20150409,16250,16280,16290,16290,16175,16175,16215,-105,-65,268,3310
20150410,16175,16215,16270,16430,16270,16415,16335,200,120,218,3392
20150413,16415,16335,16460,16545,16405,16530,16470,195,135,254,3440
20150414,16530,16470,16550,16565,16330,16385,16420,-85,-50,400,3524
20150415,16385,16420,16430,16550,16390,16505,16475,85,55,464,3728
20150416,16505,16475,16520,16675,16470,16640,16630,165,155,918,3844
20150417,16640,16630,16800,16825,16640,16720,16715,90,85,2536,4520
20150420,16720,16715,16670,16785,16530,16540,16640,-175,-75,1154,4810
20150421,16540,16640,16505,16570,16405,16500,16470,-140,-170,2374,5858
20150422,16500,16470,16490,16650,16490,16620,16585,150,115,1430,6164
20150423,16620,16585,16680,16715,16500,16645,16665,60,80,4154,7118
20150424,16645,16665,16645,16655,16565,16640,16595,-25,-70,2240,8272
20150427,16640,16595,16675,16945,16675,16855,16810,260,215,7752,9196
20150428,16855,16810,16940,17185,16930,17030,17020,220,210,10452,13570
20150429,17030,17020,17050,17125,16810,16895,17010,-125,-10,4950,14388
20150430,16895,17010,16890,17145,16870,17055,17040,45,30,6616,16924
20150504,17055,17040,17100,17365,17100,17255,17230,215,190,5766,18816
20150505,17255,17230,17290,17305,17080,17115,17185,-115,-45,6718,20390
20150506,17115,17185,17305,17530,17240,17425,17445,240,260,15416,24368
20150507,17425,17445,17450,17505,17215,17235,17310,-210,-135,11534,28284
20150508,17235,17310,17310,17355,17115,17170,17205,-140,-105,9324,30122
20150511,17170,17205,17170,17260,17005,17175,17115,-30,-90,14902,31216
20150512,17175,17115,17130,17130,16910,16935,16985,-180,-130,18194,32532
20150513,16935,16985,17100,17225,17025,17225,17120,240,135,11078,34040
20150514,17225,17120,17210,17290,16975,17100,17085,-20,-35,11524,33922
20150515,17100,17085,17045,17090,16935,17020,16995,-65,-90,9162,34458
20150518,17020,16995,16950,16990,16835,16945,16910,-50,-85,11464,37434
20150519,16945,16910,16935,16985,16850,16930,16925,20,15,12148,39428
20150520,16930,16925,16840,16840,16630,16690,16735,-235,-190,17832,40602
20150521,16690,16735,16665,16780,16555,16660,16665,-75,-70,12890,39496
20150522,16660,16665,16600,16760,16595,16690,16680,25,15,13114,40482
20150525,16690,16680,16515,16600,16460,16570,16530,-110,-150,21358,41190
20150526,16570,16530,16595,16710,16535,16535,16650,5,120,18648,44976
20150527,16535,16650,16510,16685,16485,16655,16620,5,-30,15168,46978
20150528,16655,16620,16560,16890,16560,16890,16740,270,120,33038,50382
20150529,16890,16740,16920,16975,16760,16890,16860,150,120,31412,48672
20150601,16890,16860,16820,16825,16640,16645,16695,-215,-165,28842,53010
20150602,16645,16695,16505,16625,16465,16560,16550,-135,-145,31662,59192
20150603,16560,16550,16560,16665,16300,16355,16515,-195,-35,47178,66670
20150604,16355,16515,16405,16495,16320,16440,16415,-75,-100,37780,68082
20150605,16440,16415,16415,16500,16220,16220,16320,-195,-95,47716,64338
20150608,16220,16320,16250,16340,16225,16295,16290,-25,-30,28898,65248
20150609,16295,16290,16300,16390,16300,16350,16345,60,55,24356,67178
20150610,16350,16345,16400,16505,16400,16460,16455,115,110,33778,68730
20150611,16460,16455,16465,16500,16280,16310,16365,-145,-90,35142,70646
20150612,16310,16365,16310,16325,16115,16150,16210,-215,-155,46802,73588
20150615,16150,16210,16160,16260,16095,16110,16190,-100,-20,32872,76154
20150616,16110,16190,16100,16165,16045,16110,16110,-80,-80,32326,79048
20150617,16110,16110,16150,16150,15895,15910,16025,-200,-85,42712,85884
20150618,15910,16025,15970,16000,15840,15905,15910,-120,-115,41736,86032
20150619,15905,15910,15900,15915,15685,15695,15760,-215,-150,52430,89066
20150623,15695,15760,15660,15715,15565,15605,15645,-155,-115,39718,93782
20150624,15605,15645,15595,15820,15595,15815,15715,170,70,51762,99628
20150625,15815,15715,15790,15810,15620,15635,15690,-80,-25,74010,111270
20150626,15635,15690,15625,15680,15575,15625,15630,-65,-60,78198,116970
20150629,15625,15630,15600,15620,15380,15400,15505,-230,-125,104818,124436
20150630,15400,15505,15410,15435,15215,15220,15345,-285,-160,122568,136606
20150701,15220,15345,15235,15340,15125,15230,15230,-115,-115,134916,139512
20150702,15230,15230,15340,15590,15320,15575,15485,345,255,135990,135418
20150703,15575,15485,15550,15655,15425,15520,15540,35,55,131896,140936
20150706,15520,15540,15470,15485,15010,15145,15260,-395,-280,151242,139232
20150707,15145,15260,15205,15420,15120,15215,15265,-45,5,137072,144050
20150708,15215,15265,15200,15200,14500,14560,14760,-705,-505,454494,138530
20150709,14560,14760,14750,15335,14700,15195,15030,435,270,249260,121020
20150710,15195,15030,15280,15475,15165,15290,15315,260,285,180552,128290
20150713,15290,15315,15295,15330,15170,15245,15230,-70,-85,93580,128924
20150714,15245,15230,15445,15595,15410,15470,15520,240,290,137360,125216
20150715,15470,15520,15470,15720,15370,15695,15585,175,65,151268,124648
20150716,15695,15585,15780,15805,15610,15760,15695,175,110,172932,118386
20150717,15760,15695,15695,15715,15610,15665,15665,-30,-30,117464,116676
20150720,15665,15665,15625,15715,15480,15550,15585,-115,-80,132424,111640
20150721,15550,15585,15500,15600,15450,15580,15540,-5,-45,87172,109040
20150722,15580,15540,15550,15575,15150,15205,15390,-335,-150,114706,107918
20150723,15205,15390,15185,15270,15080,15250,15180,-140,-210,110774,103902
20150724,15250,15180,15210,15260,14940,14985,15080,-195,-100,118164,103342
20150727,14985,15080,15000,15020,14715,14750,14865,-330,-215,114228,104618
20150728,14750,14865,14680,14870,14645,14835,14775,-30,-90,79694,98952
20150729,14835,14775,14930,15255,14920,15170,15125,395,350,134190,84314
20150730,15170,15125,15110,15110,14870,14900,15000,-225,-125,72068,79018
20150731,14900,15000,14840,15045,14785,14945,14925,-55,-75,54266,75732
20150803,14945,14925,14920,15100,14605,14640,14800,-285,-125,52986,69870
20150804,14640,14800,14630,14845,14575,14805,14695,5,-105,30348,66866
20150805,14805,14695,14890,14930,14715,14815,14800,120,105,23570,63758
20150806,14815,14800,14775,14785,14655,14705,14705,-95,-95,17476,61472
20150807,14705,14705,14625,14660,14405,14515,14525,-190,-180,33516,58724
20150810,14515,14525,14475,14720,14330,14655,14580,130,55,32310,53866
20150811,14655,14580,14665,14870,14650,14815,14795,235,215,27150,47774
20150812,14815,14795,14655,14990,14560,14920,14760,125,-35,32356,45180
20150813,14920,14760,15025,15175,14790,15085,15055,325,295,25578,41744
20150814,15085,15055,14880,15105,14880,14975,15010,-80,-45,8052,41724
20150817,14975,15010,15095,15095,14915,14985,14995,-25,-15,8906,39660
20150818,14985,14995,14930,15030,14780,14785,14860,-210,-135,6964,38260
20150819,14785,14860,14695,14795,14665,14785,14725,-75,-135,4024,36972
20150820,14785,14725,14760,14905,14755,14840,14835,115,110,4320,35980
20150821,14840,14835,15090,15090,14770,14775,14905,-60,70,5626,35894
20150824,14775,14905,14725,14810,14310,14465,14575,-440,-330,9820,33526
20150825,14465,14575,14370,14635,14350,14525,14520,-50,-55,6028,32562
20150826,14525,14520,14720,14795,14570,14595,14655,75,135,4294,31704
20150827,14595,14655,14510,14650,14440,14600,14565,-55,-90,13194,22216
20150828,14600,14565,14645,14890,14640,14740,14760,175,195,2248,20962
20150831,14740,14760,14870,14955,14795,14840,14845,80,85,3796,18852
20150901,14840,14845,14795,14885,14730,14820,14810,-25,-35,3202,17530
20150902,14820,14810,14790,14900,14790,14900,14830,90,20,3110,15780
20150907,14900,14830,14850,14890,14810,14850,14835,20,5,1630,15130
20150908,14850,14835,14780,14780,14660,14725,14705,-110,-130,1410,14310
20150909,14725,14705,14800,15030,14800,14980,14935,275,230,3390,12790
20150910,14980,14935,14975,14995,14900,14940,14945,5,10,3200,12340
20150911,14940,14945,14880,14950,14870,14950,14895,5,-50,450,12010
20150914,14950,14895,14920,14920,14775,14775,14830,-120,-65,1250,11130
20150915,14775,14830,14530,14600,14350,14445,14510,-385,-320,1590,10110
zn1510,20150105,16710,16630,16890,16890,16640,16755,16730,125,100,22,112
20150106,16755,16730,,,,16730,16730,0,0,0,112
20150107,16730,16730,16695,16695,16630,16630,16660,-100,-70,4,114
20150108,16630,16660,16505,16520,16415,16430,16455,-230,-205,28,120
20150109,16430,16455,16535,16535,16400,16440,16440,-15,-15,34,128
20150112,16440,16440,16410,16410,16400,16400,16405,-40,-35,6,122
20150113,16400,16405,16230,16365,16200,16200,16235,-205,-170,74,168
20150114,16200,16235,16055,16085,15500,15600,15785,-635,-450,496,434
20150115,15600,15785,15675,15865,15635,15855,15770,70,-15,92,430
20150116,15855,15770,15855,15895,15735,15785,15795,15,25,30,418
20150119,15785,15795,15860,16015,15860,15995,15925,200,130,34,414
20150120,15995,15925,16040,16040,15995,16000,16005,75,80,10,406
20150121,16000,16005,16060,16105,16050,16090,16065,85,60,22,400
20150122,16090,16065,16045,16370,16045,16370,16300,305,235,26,376
20150123,16370,16300,16375,16375,16115,16115,16240,-185,-60,18,376
20150126,16115,16240,16080,16095,15900,16030,16020,-210,-220,62,390
20150127,16030,16020,16105,16310,16105,16220,16240,200,220,26,376
20150128,16220,16240,16255,16295,16230,16295,16260,55,20,6,374
20150129,16295,16260,16150,16190,16130,16135,16160,-125,-100,26,378
20150130,16135,16160,16070,16085,15985,15985,16050,-175,-110,24,382
20150202,15985,16050,16200,16200,16200,16200,16200,150,150,24,368
20150203,16200,16200,16165,16215,16165,16215,16195,15,-5,8,366
20150204,16215,16195,16350,16400,16290,16295,16320,100,125,154,358
20150205,16295,16320,16300,16300,16255,16255,16265,-65,-55,8,360
20150206,16255,16265,16230,16350,16230,16350,16295,85,30,32,338
20150209,16350,16295,16350,16355,16350,16355,16350,60,55,12,346
20150210,16355,16350,16350,16370,16350,16370,16360,20,10,20,344
20150211,16370,16360,16270,16270,16260,16260,16265,-100,-95,6,344
20150212,16260,16265,16180,16180,16175,16175,16175,-90,-90,22,344
20150213,16175,16175,16255,16350,16255,16325,16315,150,140,72,348
20150216,16325,16315,16375,16430,16375,16430,16400,115,85,62,368
20150217,16430,16400,16400,16425,16400,16400,16410,0,10,10,360
20150225,16400,16410,16035,16160,16035,16060,16075,-350,-335,22,348
20150226,16060,16075,16055,16055,16000,16050,16040,-25,-35,26,368
20150227,16050,16040,16025,16025,16025,16025,16025,-15,-15,4,366
20150302,16025,16025,16075,16205,16055,16175,16110,150,85,22,362
20150303,16175,16110,16055,16055,16055,16055,16055,-55,-55,10,368
20150304,16055,16055,15915,16020,15890,15940,15935,-115,-120,26,372
20150305,15940,15935,15900,15900,15830,15855,15870,-80,-65,52,406
20150306,15855,15870,15845,15870,15770,15770,15805,-100,-65,48,426
20150309,15770,15805,15765,15765,15730,15730,15740,-75,-65,16,434
20150310,15730,15740,15855,15875,15790,15790,15845,50,105,22,428
20150311,15790,15845,15725,15820,15720,15770,15780,-75,-65,458,702
20150312,15770,15780,15760,15770,15655,15770,15700,-10,-80,82,708
20150313,15770,15700,15770,15770,15685,15760,15735,60,35,58,720
20150316,15760,15735,15695,15850,15680,15820,15795,85,60,52,758
20150317,15820,15795,15755,15755,15700,15740,15720,-55,-75,118,830
20150318,15740,15720,15685,15760,15670,15670,15685,-50,-35,518,1242
20150319,15670,15685,15705,15740,15580,15675,15670,-10,-15,210,1390
20150320,15675,15670,15690,15750,15690,15715,15720,45,50,66,1400
20150323,15715,15720,15875,16005,15830,15940,15910,220,190,520,1420
20150324,15940,15910,16005,16120,15950,16000,16025,90,115,1022,1948
20150325,16000,16025,16010,16035,15985,16010,16010,-15,-15,82,1982
20150326,16010,16010,16055,16100,16035,16100,16075,90,65,36,1992
20150327,16100,16075,16115,16180,16000,16035,16045,-40,-30,166,2108
20150330,16035,16045,16075,16100,16065,16075,16075,30,30,60,2130
20150331,16075,16075,16150,16150,16120,16125,16130,50,55,58,2142
20150401,16125,16130,16010,16060,16010,16035,16030,-95,-100,248,2166
20150402,16035,16030,16115,16120,16080,16080,16095,50,65,30,2162
20150403,16080,16095,16140,16280,16140,16250,16225,155,130,120,2162
20150407,16250,16225,16320,16330,16290,16320,16310,95,85,100,2142
20150408,16320,16310,16350,16385,16285,16285,16340,-25,30,70,2120
20150409,16285,16340,16300,16320,16230,16230,16260,-110,-80,158,2226
20150410,16230,16260,16360,16460,16320,16460,16375,200,115,106,2258
20150413,16460,16375,16515,16570,16480,16570,16515,195,140,48,2246
20150414,16570,16515,16550,16550,16395,16445,16430,-70,-85,88,2256
20150415,16445,16430,16430,16575,16430,16550,16505,120,75,90,2282
20150416,16550,16505,16655,16710,16655,16690,16675,185,170,228,2276
20150417,16690,16675,16840,16840,16680,16745,16795,70,120,382,2226
20150420,16745,16795,16695,16795,16580,16590,16665,-205,-130,146,2250
20150421,16590,16665,16570,16600,16450,16530,16515,-135,-150,504,2300
20150422,16530,16515,16530,16670,16525,16670,16620,155,105,354,2326
20150423,16670,16620,16700,16730,16550,16670,16645,50,25,390,2400
20150424,16670,16645,16640,16690,16600,16690,16630,45,-15,582,2712
20150427,16690,16630,16700,16960,16700,16895,16865,265,235,1152,2876
20150428,16895,16865,16955,17200,16955,17050,17025,185,160,2104,3612
20150429,17050,17025,17055,17100,16905,16940,17040,-85,15,616,3782
20150430,16940,17040,16970,17160,16970,17060,17065,20,25,652,4012
20150504,17060,17065,17160,17310,17145,17280,17250,215,185,772,4072
20150505,17280,17250,17760,17760,16385,17135,17215,-115,-35,684,4290
20150506,17135,17215,17330,17545,17330,17460,17445,245,230,2750,5380
20150507,17460,17445,17430,17510,17250,17265,17320,-180,-125,1288,5616
20150508,17265,17320,17350,17370,17150,17185,17205,-135,-115,1116,5642
20150511,17185,17205,17235,17275,17060,17130,17140,-75,-65,2060,6442
20150512,17130,17140,17070,17110,16935,16965,16990,-175,-150,1148,6774
20150513,16965,16990,17095,17240,17065,17240,17150,250,160,1060,7484
20150514,17240,17150,17300,17300,17015,17120,17150,-30,0,1178,7672
20150515,17120,17150,17065,17115,16970,17040,17015,-110,-135,928,7746
20150518,17040,17015,16970,17010,16870,16970,16950,-45,-65,1862,8708
20150519,16970,16950,16940,16995,16870,16940,16925,-10,-25,720,8956
20150520,16940,16925,16825,16860,16655,16700,16750,-225,-175,2580,9136
20150521,16700,16750,16660,16785,16580,16690,16675,-60,-75,3006,10446
20150522,16690,16675,16630,16750,16630,16700,16695,25,20,1248,10402
20150525,16700,16695,16520,16605,16485,16590,16560,-105,-135,4366,12094
20150526,16590,16560,16575,16725,16545,16560,16665,0,105,2476,13006
20150527,16560,16665,16500,16700,16500,16660,16630,-5,-35,836,13118
20150528,16660,16630,16595,16890,16565,16890,16760,260,130,2812,13342
20150529,16890,16760,16930,17000,16780,16915,16900,155,140,6950,13700
20150601,16915,16900,16815,16850,16665,16675,16710,-225,-190,3344,14508
20150602,16675,16710,16600,16640,16490,16585,16580,-125,-130,5192,15996
20150603,16585,16580,16615,16680,16350,16390,16515,-190,-65,4914,16414
20150604,16390,16515,16415,16515,16340,16455,16425,-60,-90,3070,16416
20150605,16455,16425,16425,16520,16225,16225,16335,-200,-90,6366,16230
20150608,16225,16335,16260,16345,16230,16310,16300,-25,-35,4532,17590
20150609,16310,16300,16330,17115,16300,16370,16390,70,90,4842,19004
20150610,16370,16390,16450,16530,16425,16470,16475,80,85,6918,20126
20150611,16470,16475,16570,16570,16310,16340,16390,-135,-85,6600,21444
20150612,16340,16390,16345,16350,16135,16170,16240,-220,-150,8660,22190
20150615,16170,16240,16195,16280,16120,16140,16220,-100,-20,10056,23480
20150616,16140,16220,16080,16175,16075,16110,16125,-110,-95,3112,23906
20150617,16110,16125,16145,16145,15900,15910,16035,-215,-90,8148,25074
20150618,15910,16035,15945,16010,15850,15915,15920,-120,-115,4822,25462
20150619,15915,15920,15930,15930,15705,15705,15765,-215,-155,10832,25670
20150623,15705,15765,15660,15720,15585,15610,15665,-155,-100,9456,28930
20150624,15610,15665,15610,15830,15605,15825,15725,160,60,10680,30788
20150625,15825,15725,15825,15825,15625,15645,15685,-80,-40,11546,32650
20150626,15645,15685,15620,15685,15585,15630,15630,-55,-55,13118,36252
20150629,15630,15630,15610,15610,15410,15415,15525,-215,-105,20350,40578
20150630,15415,15525,15450,15450,15225,15235,15350,-290,-175,20806,47066
20150701,15235,15350,15235,15350,15140,15240,15250,-110,-100,18496,51058
20150702,15240,15250,15315,15600,15315,15580,15505,330,255,19194,51498
20150703,15580,15505,15580,15660,15435,15520,15550,15,45,17992,53528
20150706,15520,15550,15480,15495,15010,15155,15260,-395,-290,25978,54940
20150707,15155,15260,15220,15435,15135,15225,15275,-35,15,22990,54926
20150708,15225,15275,15200,15200,14510,14555,14780,-720,-495,75466,61466
20150709,14555,14780,14740,15325,14710,15195,15035,415,255,53538,61446
20150710,15195,15035,15310,15465,15165,15305,15315,270,280,35666,64972
20150713,15305,15315,15300,15330,15175,15255,15225,-60,-90,21518,67214
20150714,15255,15225,15480,15595,15410,15455,15515,230,290,37478,65618
20150715,15455,15515,15430,15720,15370,15720,15600,205,85,40696,66084
20150716,15720,15600,15795,15805,15610,15755,15705,155,105,52520,68702
20150717,15755,15705,15670,15715,15620,15670,15665,-35,-40,35048,72106
20150720,15670,15665,15640,15720,15485,15550,15585,-115,-80,42266,74150
20150721,15550,15585,15510,15600,15450,15585,15540,0,-45,23546,74956
20150722,15585,15540,15505,15575,15140,15185,15350,-355,-190,49368,80020
20150723,15185,15350,15195,15250,15070,15230,15165,-120,-185,43414,82450
20150724,15230,15165,15195,15240,14930,14955,15055,-210,-110,69156,95886
20150727,14955,15055,14995,15000,14705,14720,14835,-335,-220,67168,99094
20150728,14720,14835,14680,14835,14630,14790,14750,-45,-85,54538,105978
20150729,14790,14750,14900,15200,14885,15100,15080,350,330,115426,115474
20150730,15100,15080,15030,15050,14815,14850,14945,-230,-135,97684,124958
20150731,14850,14945,14820,14975,14735,14885,14870,-60,-75,98136,128166
20150803,14885,14870,14815,14970,14540,14585,14725,-285,-145,176040,145064
20150804,14585,14725,14580,14780,14510,14735,14630,10,-95,133682,152032
20150805,14735,14630,14810,14870,14645,14735,14735,105,105,104676,155098
20150806,14735,14735,14680,14710,14575,14625,14635,-110,-100,109062,162868
20150807,14625,14635,14550,14580,14265,14410,14420,-225,-215,260896,173404
20150810,14410,14420,14310,14595,14270,14530,14445,110,25,190408,170672
20150811,14530,14445,14540,14755,14530,14680,14670,235,225,233152,162474
20150812,14680,14670,14520,14885,14440,14805,14625,135,-45,321588,155270
20150813,14805,14625,14900,15070,14700,14980,14945,355,320,181970,149464
20150814,14980,14945,14905,14995,14840,14870,14910,-75,-35,109444,150472
20150817,14870,14910,14990,14990,14810,14905,14905,-5,-5,108446,147680
20150818,14905,14905,14850,14935,14680,14690,14790,-215,-115,103848,146850
20150819,14690,14790,14600,14700,14560,14695,14620,-95,-170,95836,144506
20150820,14695,14620,14680,14805,14650,14740,14730,120,110,92484,144220
20150821,14740,14730,14930,14960,14685,14700,14825,-30,95,110240,139596
20150824,14700,14825,14605,14715,14210,14325,14495,-500,-330,170372,132324
20150825,14325,14495,14250,14500,14230,14360,14390,-135,-105,170648,129016
20150826,14360,14390,14555,14660,14405,14445,14500,55,110,103610,127420
20150827,14445,14500,14340,14495,14305,14470,14400,-30,-100,153528,121252
20150828,14470,14400,14560,14790,14505,14700,14645,300,245,135956,103290
20150831,14700,14645,14800,14885,14715,14725,14795,80,150,106028,91794
20150901,14725,14795,14690,14845,14620,14745,14745,-50,-50,51416,83442
20150902,14745,14745,14755,14845,14670,14840,14785,95,40,33270,77922
20150907,14840,14785,14780,14850,14740,14810,14795,25,10,18010,75456
20150908,14810,14795,14755,14790,14580,14680,14660,-115,-135,28428,72604
20150909,14680,14660,14780,15025,14755,14960,14900,300,240,47524,65956
20150910,14960,14900,14995,15000,14830,14925,14900,25,0,20732,63402
20150911,14925,14900,14900,14950,14850,14950,14895,50,-5,22050,58542
20150914,14950,14895,14875,14875,14710,14710,14790,-185,-105,14930,54770
20150915,14710,14790,14625,14635,14410,14420,14505,-370,-285,16304,50064
20150916,14420,14505,14310,14515,14310,14485,14440,-20,-65,11820,47364
20150917,14485,14440,14495,14580,14420,14500,14495,60,55,8878,44984
20150918,14500,14495,14430,14500,14385,14390,14435,-105,-60,7230,42310
20150921,14390,14435,14355,14355,13710,13760,13870,-675,-565,17564,37942
20150922,13760,13870,13810,13825,13560,13620,13655,-250,-215,10648,33680
20150923,13620,13655,13610,13740,13480,13695,13620,40,-35,7478,31620
20150924,13695,13620,13755,14000,13635,13910,13790,290,170,8354,28114
20150925,13910,13790,13845,14045,13740,13800,13865,10,75,7972,24996
20150928,13800,13865,13725,13815,13645,13670,13725,-195,-140,5850,22096
20150929,13670,13725,13600,13685,13530,13620,13595,-105,-130,7310,18278
20150930,13620,13595,13765,14480,13695,14100,13820,505,225,5132,15252
20151008,14100,13820,14440,14440,13830,13830,13905,10,85,3302,13580
20151009,13830,13905,14200,14480,13835,14420,14245,515,340,6250,11790
20151012,14420,14245,14730,14890,14600,14790,14715,545,470,5850,9490
20151013,14790,14715,14720,14720,14550,14690,14620,-25,-95,2370,8230
20151014,14690,14620,14670,14670,14580,14610,14610,-10,-10,870,7590
20151015,14610,14610,14650,14710,14600,14610,14665,0,55,1020,7290
zn1511,20150105,16795,16650,16840,16930,16695,16695,16820,45,170,38,388
20150106,16695,16820,16605,16760,16605,16715,16670,-105,-150,110,424
20150107,16715,16670,16700,16715,16620,16645,16670,-25,0,26,432
20150108,16645,16670,16540,16595,16450,16475,16495,-195,-175,42,432
20150109,16475,16495,16525,16525,16430,16465,16455,-30,-40,42,424
20150112,16465,16455,16505,16505,16405,16405,16430,-50,-25,36,406
20150113,16405,16430,16290,16355,16170,16170,16265,-260,-165,106,426
20150114,16170,16265,16080,16085,15525,15620,15870,-645,-395,220,426
20150115,15620,15870,15700,15910,15650,15845,15810,-25,-60,26,434
20150116,15845,15810,15885,15885,15730,15820,15805,10,-5,38,434
20150119,15820,15805,15855,16105,15855,16030,15970,225,165,60,422
20150120,16030,15970,16030,16030,15980,15995,16000,25,30,22,426
20150121,15995,16000,16065,16090,16055,16090,16060,90,60,10,430
20150122,16090,16060,16065,16385,16065,16385,16230,325,170,22,428
20150123,16385,16230,16400,16400,16220,16235,16285,5,55,6,428
20150126,16235,16285,16235,16235,15925,16050,16105,-235,-180,28,422
20150127,16050,16105,16170,16335,16170,16275,16275,170,170,30,424
20150128,16275,16275,16280,16370,16240,16305,16285,30,10,38,430
20150129,16305,16285,16170,16170,16115,16115,16145,-170,-140,12,430
20150130,16115,16145,16050,16070,16020,16020,16055,-125,-90,34,444
20150202,16020,16055,16135,16220,16115,16170,16150,115,95,16,448
20150203,16170,16150,16160,16260,16155,16260,16180,110,30,8,446
20150204,16260,16180,16275,16450,16275,16315,16350,135,170,26,454
20150205,16315,16350,16235,16280,16235,16265,16250,-85,-100,20,444
20150206,16265,16250,16190,16355,16190,16355,16265,105,15,12,442
20150209,16355,16265,16345,16345,16330,16330,16335,65,70,6,442
20150210,16330,16335,,,,16335,16335,0,0,0,442
20150211,16335,16335,16295,16330,16220,16240,16280,-95,-55,16,450
20150212,16240,16280,16210,16230,16145,16145,16195,-135,-85,8,450
20150213,16145,16195,16330,16430,16330,16385,16375,190,180,8,446
20150216,16385,16375,16395,16405,16390,16390,16395,15,20,8,444
20150217,16390,16395,16340,16350,16340,16350,16345,-45,-50,4,442
20150225,16350,16345,16075,16130,16055,16080,16065,-265,-280,22,450
20150226,16080,16065,16010,16075,16000,16075,16045,10,-20,32,468
20150227,16075,16045,16060,16060,16000,16005,16010,-40,-35,12,470
20150302,16005,16010,16065,16190,16015,16130,16105,120,95,20,466
20150303,16130,16105,16125,16125,16055,16055,16105,-50,0,14,474
20150304,16055,16105,15935,15975,15890,15925,15945,-180,-160,46,504
20150305,15925,15945,15895,15920,15775,15775,15865,-170,-80,26,492
20150306,15775,15865,15810,15895,15750,15750,15785,-115,-80,52,526
20150309,15750,15785,15765,15850,15730,15850,15780,65,-5,18,526
20150310,15850,15780,15835,15835,15835,15835,15835,55,55,2,528
20150311,15835,15835,15740,15815,15730,15760,15780,-75,-55,106,566
20150312,15760,15780,15740,15740,15595,15695,15670,-85,-110,88,612
20150313,15695,15670,15750,15850,15715,15785,15760,115,90,52,630
20150316,15785,15760,15725,15935,15720,15860,15830,100,70,62,636
20150317,15860,15830,15805,15830,15710,15770,15765,-60,-65,52,676
20150318,15770,15765,15670,15780,15670,15745,15720,-20,-45,108,730
20150319,15745,15720,15590,15750,15590,15735,15675,15,-45,350,990
20150320,15735,15675,15725,15770,15725,15755,15745,80,70,18,1002
20150323,15755,15745,15850,15990,15850,15915,15945,170,200,178,1006
20150324,15915,15945,16045,16155,15995,15995,16050,50,105,248,1006
20150325,15995,16050,16060,16100,16025,16045,16055,-5,5,308,1148
20150326,16045,16055,16095,16125,16070,16125,16100,70,45,22,1156
20150327,16125,16100,16185,16200,16045,16055,16130,-45,30,64,1156
20150330,16055,16130,16105,16105,16105,16105,16105,-25,-25,2,1156
20150331,16105,16105,16170,16170,16155,16155,16165,50,60,6,1152
20150401,16155,16165,16070,16085,16070,16085,16075,-80,-90,44,1188
20150402,16085,16075,,,,16115,16115,40,40,0,1188
20150403,16115,16115,16275,16305,16240,16240,16275,125,160,40,1186
20150407,16240,16275,16340,16360,16300,16345,16340,70,65,24,1190
20150408,16345,16340,16400,16440,16335,16335,16395,-5,55,34,1190
20150409,16335,16395,16340,16345,16255,16255,16295,-140,-100,76,1236
20150410,16255,16295,16365,16450,16360,16450,16395,155,100,68,1258
20150413,16450,16395,16500,16590,16485,16565,16515,170,120,68,1294
20150414,16565,16515,16630,16630,16420,16460,16495,-55,-20,76,1340
20150415,16460,16495,16490,16520,16465,16520,16480,25,-15,76,1372
20150416,16520,16480,16600,16725,16585,16685,16635,205,155,214,1466
20150417,16685,16635,16830,16830,16710,16770,16795,135,160,516,1832
20150420,16770,16795,16705,16785,16590,16590,16630,-205,-165,412,1616
20150421,16590,16630,16585,16595,16475,16570,16555,-60,-75,220,1558
20150422,16570,16555,16615,16700,16615,16700,16635,145,80,22,1554
20150423,16700,16635,16745,16780,16580,16705,16710,70,75,98,1584
20150424,16705,16710,16645,16685,16640,16640,16660,-70,-50,86,1638
20150427,16640,16660,16795,17000,16780,16995,16870,335,210,208,1720
20150428,16995,16870,17080,17200,17000,17015,17060,145,190,358,1892
20150429,17015,17060,17075,17090,16925,16925,17045,-135,-15,36,1888
20150430,16925,17045,17035,17145,17015,17100,17090,55,45,266,2034
20150504,17100,17090,17195,17325,17195,17315,17295,225,205,304,2038
20150505,17315,17295,17305,17305,17150,17185,17230,-110,-65,164,2106
20150506,17185,17230,17280,17555,17280,17470,17480,240,250,812,2528
20150507,17470,17480,17455,17515,17270,17295,17335,-185,-145,1070,2960
20150508,17295,17335,17355,17380,17180,17220,17295,-115,-40,150,3042
20150511,17220,17295,17280,17285,17085,17215,17155,-80,-140,110,3062
20150512,17215,17155,17090,17090,16965,16985,17005,-170,-150,442,3056
20150513,16985,17005,17120,17240,17095,17225,17150,220,145,92,3090
20150514,17225,17150,17255,17260,17015,17150,17130,0,-20,226,3074
20150515,17150,17130,17110,17120,16990,17060,17000,-70,-130,1074,3954
20150518,17060,17000,16990,17005,16890,16995,16960,-5,-40,266,3916
20150519,16995,16960,16920,17020,16920,16975,16950,15,-10,68,3862
20150520,16975,16950,16875,16880,16635,16710,16765,-240,-185,426,3748
20150521,16710,16765,16660,16760,16610,16705,16670,-60,-95,414,3790
20150522,16705,16670,16745,16770,16675,16745,16725,75,55,272,3914
20150525,16745,16725,16505,16630,16505,16595,16555,-130,-170,282,3948
20150526,16595,16555,16630,16715,16620,16645,16680,90,125,186,4072
20150527,16645,16680,16575,16705,16575,16670,16650,-10,-30,116,4018
20150528,16670,16650,16615,16920,16615,16920,16805,270,155,1884,5354
20150529,16920,16805,16975,17015,16860,16940,16930,135,125,346,5272
20150601,16940,16930,16880,16880,16715,16720,16760,-210,-170,122,5300
20150602,16720,16760,16700,16700,16525,16620,16620,-140,-140,894,5508
20150603,16620,16620,16650,16705,16380,16420,16515,-200,-105,588,5618
20150604,16420,16515,16480,16530,16370,16510,16460,-5,-55,706,5176
20150605,16510,16460,16460,16460,16250,16250,16345,-210,-115,1052,5324
20150608,16250,16345,16300,16375,16280,16330,16330,-15,-15,218,5358
20150609,16330,16330,16340,16410,16340,16400,16380,70,50,168,5392
20150610,16400,16380,16485,16540,16470,16500,16500,120,120,2314,6856
20150611,16500,16500,16515,16520,16350,16350,16385,-150,-115,774,6910
20150612,16350,16385,16355,16360,16180,16200,16250,-185,-135,1108,7140
20150615,16200,16250,16215,16290,16150,16160,16200,-90,-50,1626,7238
20150616,16160,16200,16130,16195,16110,16165,16170,-35,-30,316,7234
20150617,16165,16170,16165,16165,15925,15930,16030,-240,-140,1044,7454
20150618,15930,16030,15985,15995,15885,15950,15935,-80,-95,352,7408
20150619,15950,15935,15960,15960,15740,15740,15785,-195,-150,2658,7090
20150623,15740,15785,15700,15735,15600,15625,15645,-160,-140,1844,6980
20150624,15625,15645,15630,15835,15620,15825,15730,180,85,756,7060
20150625,15825,15730,15825,15825,15645,15645,15720,-85,-10,480,7144
20150626,15645,15720,15620,15695,15600,15650,15665,-70,-55,648,7354
20150629,15650,15665,15565,15605,15425,15430,15515,-235,-150,1112,7566
20150630,15430,15515,15430,15440,15240,15260,15370,-255,-145,3268,8848
20150701,15260,15370,15240,15355,15155,15250,15245,-120,-125,3086,9732
20150702,15250,15245,15375,15615,15375,15590,15535,345,290,1264,9950
20150703,15590,15535,15560,15665,15445,15530,15575,-5,40,2750,10744
20150706,15530,15575,15500,15500,15020,15165,15265,-410,-310,5178,11754
20150707,15165,15265,15250,15440,15160,15230,15325,-35,60,2280,12214
20150708,15230,15325,15160,15175,14555,14555,14780,-770,-545,9948,12784
20150709,14555,14780,14765,15325,14705,15205,15005,425,225,7290,12512
20150710,15205,15005,15320,15465,15160,15300,15315,295,310,2464,12968
20150713,15300,15315,15300,15310,15180,15260,15240,-55,-75,1844,13578
20150714,15260,15240,15440,15590,15420,15465,15520,225,280,5762,15592
20150715,15465,15520,15420,15715,15415,15695,15620,175,100,4840,15998
20150716,15695,15620,15790,15800,15610,15760,15710,140,90,5454,16676
20150717,15760,15710,15705,15725,15625,15665,15670,-45,-40,4556,16974
20150720,15665,15670,15635,15715,15485,15540,15580,-130,-90,8280,19408
20150721,15540,15580,15480,15750,15465,15585,15545,5,-35,6036,21156
20150722,15585,15545,15550,15560,15140,15180,15325,-365,-220,13794,25926
20150723,15180,15325,15180,15235,15060,15220,15150,-105,-175,12680,29052
20150724,15220,15150,15195,15220,14925,14960,15050,-190,-100,16332,32966
20150727,14960,15050,14975,14985,14700,14720,14810,-330,-240,17208,37836
20150728,14720,14810,14780,14820,14625,14765,14740,-45,-70,12974,41282
20150729,14765,14740,14885,15180,14865,15060,15050,320,310,21618,41454
20150730,15060,15050,15010,15020,14790,14825,14910,-225,-140,14328,44474
20150731,14825,14910,14795,14940,14715,14840,14835,-70,-75,9882,46154
20150803,14840,14835,14800,14920,14515,14550,14680,-285,-155,23488,52768
20150804,14550,14680,14550,14750,14490,14710,14590,30,-90,21662,58032
20150805,14710,14590,14780,14830,14620,14720,14705,130,115,13912,61264
20150806,14720,14705,14610,14670,14550,14595,14605,-110,-100,19572,66094
20150807,14595,14605,14520,14540,14215,14360,14375,-245,-230,47750,72570
20150810,14360,14375,14270,14505,14215,14460,14365,85,-10,51760,74318
20150811,14460,14365,14470,14695,14460,14610,14600,245,235,66314,72980
20150812,14610,14600,14380,14795,14380,14725,14565,125,-35,81636,71190
20150813,14725,14565,14835,14990,14650,14915,14870,350,305,64320,72950
20150814,14915,14870,14840,14925,14785,14825,14845,-45,-25,26972,74494
20150817,14825,14845,14920,14950,14760,14845,14845,0,0,28888,75448
20150818,14845,14845,14790,14875,14625,14625,14735,-220,-110,34528,78768
20150819,14625,14735,14510,14630,14505,14625,14555,-110,-180,44188,84864
20150820,14625,14555,14600,14740,14580,14680,14670,125,115,40132,84708
20150821,14680,14670,14900,14900,14640,14650,14775,-20,105,41426,87096
20150824,14650,14775,14575,14650,14175,14270,14440,-505,-335,76652,92112
20150825,14270,14440,14225,14435,14185,14315,14325,-125,-115,86040,94258
20150826,14315,14325,14520,14595,14340,14385,14445,60,120,52528,96820
20150827,14385,14445,14255,14405,14220,14385,14315,-60,-130,88358,113584
20150828,14385,14315,14495,14715,14435,14610,14575,295,260,101264,113558
20150831,14610,14575,14720,14835,14650,14655,14730,80,155,78952,118900
20150901,14655,14730,14610,14785,14565,14680,14685,-50,-45,64450,119416
20150902,14680,14685,14690,14815,14670,14810,14740,125,55,71022,120234
20150907,14810,14740,14705,14830,14690,14770,14755,30,15,48202,120588
20150908,14770,14755,14730,14745,14520,14630,14610,-125,-145,122500,125650
20150909,14630,14610,14730,15010,14700,14905,14855,295,245,182242,124424
20150910,14905,14855,14960,14970,14805,14915,14875,60,20,97632,126982
20150911,14915,14875,14870,14940,14825,14935,14880,60,5,120726,133758
20150914,14935,14880,14825,14860,14680,14695,14775,-185,-105,113968,128254
20150915,14695,14775,14605,14615,14370,14380,14475,-395,-300,165008,128432
20150916,14380,14475,14365,14475,14310,14440,14395,-35,-80,146522,130370
20150917,14440,14395,14400,14540,14380,14455,14455,60,60,134736,128664
20150918,14455,14455,14380,14445,14310,14310,14380,-145,-75,117146,135484
20150921,14310,14380,14200,14200,13660,13685,13835,-695,-545,340758,174888
20150922,13685,13835,13720,13750,13480,13530,13605,-305,-230,282430,186796
20150923,13530,13605,13505,13650,13370,13625,13505,20,-100,315708,176042
20150924,13625,13505,13695,14030,13550,13820,13690,315,185,329878,147582
20150925,13820,13690,13780,13960,13640,13705,13800,15,110,381652,127572
20150928,13705,13800,13610,13720,13540,13540,13640,-260,-160,135954,116860
20150929,13540,13640,13535,13600,13405,13525,13495,-115,-145,161704,99880
20150930,13525,13495,13660,13920,13600,13900,13730,405,235,141248,86472
20151008,13900,13730,13995,14000,13700,13700,13825,-30,95,65046,77872
20151009,13700,13825,13740,14450,13680,14400,14110,575,285,137248,68630
20151012,14400,14110,14800,14800,14465,14740,14620,630,510,107326,62686
20151013,14740,14620,14655,14690,14430,14625,14545,5,-75,48788,62126
20151014,14625,14545,14560,14670,14440,14515,14550,-30,5,29134,59662
20151015,14515,14550,14595,14685,14555,14580,14615,30,65,23166,57534
20151016,14580,14615,14590,14645,14435,14440,14540,-175,-75,16858,53150
20151019,14440,14540,14440,14570,14315,14355,14430,-185,-110,19522,46644
20151020,14355,14430,14300,14360,14220,14300,14285,-130,-145,15734,43080
20151021,14300,14285,14335,14440,14265,14305,14315,20,30,12712,39902
20151022,14305,14315,14225,14240,13935,14100,14075,-215,-240,18542,37110
20151023,14100,14075,14225,14345,14055,14260,14210,185,135,15418,33546
20151026,14260,14210,14320,14320,14095,14230,14190,20,-20,10670,29976
20151027,14230,14190,14180,14310,14150,14275,14215,85,25,10982,27170
20151028,14275,14215,14235,14255,14135,14155,14200,-60,-15,6002,24498
20151029,14155,14200,14000,14270,14000,14160,14170,-40,-30,8428,20834
20151030,14160,14170,14090,14125,13760,13790,13920,-380,-250,8444,16500
20151102,13790,13920,13805,13850,13710,13820,13795,-100,-125,5070,13740
20151103,13820,13795,13755,13850,13720,13740,13800,-55,5,1830,12710
20151104,13740,13800,13665,13840,13620,13835,13740,35,-60,1580,11620
20151105,13835,13740,13820,13850,13610,13620,13710,-120,-30,1900,10930
20151106,13620,13710,13585,13620,13500,13620,13550,-90,-160,1610,10160
20151109,13620,13550,13525,13630,13520,13565,13580,15,30,3030,8720
20151110,13565,13580,13600,13600,13130,13250,13320,-330,-260,2770,7080
20151111,13250,13320,13200,13210,12830,12830,12945,-490,-375,2220,6450
20151112,12830,12945,12825,13135,12815,13110,13030,165,85,2650,5810
20151113,13110,13030,12940,13110,12920,12960,13020,-70,-10,2570,5450
20151116,12960,13020,13040,13070,12890,12910,13035,-110,15,1730,4980
zn1512,20150105,16865,16800,16870,17020,16760,16835,16895,35,95,42,62
20150106,16835,16895,16760,16775,16705,16755,16745,-140,-150,24,80
20150107,16755,16745,16740,16740,16660,16665,16695,-80,-50,24,82
20150108,16665,16695,16580,16580,16480,16505,16505,-190,-190,44,92
20150109,16505,16505,16535,16535,16440,16450,16455,-55,-50,24,102
20150112,16450,16455,16530,16530,16530,16530,16530,75,75,2,100
20150113,16530,16530,16335,16370,16235,16235,16305,-295,-225,10,100
20150114,16235,16305,16070,16100,15530,15625,15835,-680,-470,186,168
20150115,15625,15835,15670,15845,15555,15845,15735,10,-100,26,160
20150116,15845,15735,15890,15890,15760,15760,15790,25,55,16,146
20150119,15760,15790,15880,16080,15870,16010,15915,220,125,76,136
20150120,16010,15915,16000,16035,15965,16010,15990,95,75,14,148
20150121,16010,15990,16125,16255,16110,16185,16160,195,170,16,142
20150122,16185,16160,16100,16445,16100,16435,16250,275,90,38,132
20150123,16435,16250,16280,16335,16280,16335,16310,85,60,6,130
20150126,16335,16310,16160,16160,16040,16040,16090,-270,-220,8,128
20150127,16040,16090,16180,16290,16180,16290,16240,200,150,6,128
20150128,16290,16240,,,,16240,16240,0,0,0,128
20150129,16240,16240,,,,16240,16240,0,0,0,128
20150130,16240,16240,16050,16070,16050,16070,16055,-170,-185,14,138
20150202,16070,16055,16175,16175,16175,16175,16175,120,120,4,138
20150203,16175,16175,16235,16290,16235,16290,16250,115,75,8,132
20150204,16290,16250,16345,16390,16345,16345,16365,95,115,22,144
20150205,16345,16365,16305,16305,16265,16265,16285,-100,-80,4,144
20150206,16265,16285,16265,16325,16265,16325,16295,40,10,6,146
20150209,16325,16295,16425,16425,16370,16370,16395,75,100,4,144
20150210,16370,16395,16385,16390,16385,16390,16385,-5,-10,4,146
20150211,16390,16385,16300,16300,16240,16240,16275,-145,-110,6,146
20150212,16240,16275,16205,16205,16205,16205,16205,-70,-70,2,146
20150213,16205,16205,16340,16340,16340,16340,16340,135,135,2,144
20150216,16340,16340,16390,16405,16365,16405,16390,65,50,14,146
20150217,16405,16390,16425,16425,16350,16350,16390,-40,0,10,142
20150225,16350,16390,16080,16175,16000,16095,16080,-295,-310,36,148
20150226,16095,16080,16055,16055,16055,16055,16055,-25,-25,4,148
20150227,16055,16055,16045,16045,16045,16045,16045,-10,-10,2,150
20150302,16045,16045,16075,16080,16075,16080,16075,35,30,4,146
20150303,16080,16075,,,,16075,16075,0,0,0,146
20150304,16075,16075,15965,16015,15930,15930,15970,-145,-105,6,150
20150305,15930,15970,15910,15915,15780,15820,15860,-150,-110,40,144
20150306,15820,15860,15890,15895,15790,15790,15850,-70,-10,16,152
20150309,15790,15850,15755,15755,15755,15755,15755,-95,-95,2,152
20150310,15755,15755,,,,15755,15755,0,0,0,152
20150311,15755,15755,15750,15840,15740,15830,15775,75,20,24,152
20150312,15830,15775,15740,15795,15670,15795,15720,20,-55,22,156
20150313,15795,15720,15775,15810,15775,15795,15785,75,65,32,160
20150316,15795,15785,15875,15890,15860,15860,15870,75,85,16,154
20150317,15860,15870,15760,15790,15760,15790,15780,-80,-90,6,158
20150318,15790,15780,15700,15735,15700,15725,15730,-55,-50,26,176
20150319,15725,15730,15760,15800,15690,15755,15730,25,0,82,234
20150320,15755,15730,15770,15800,15765,15765,15785,35,55,24,240
20150323,15765,15785,15795,16000,15790,16000,15910,215,125,68,244
20150324,16000,15910,16060,16180,16040,16040,16100,130,190,56,278
20150325,16040,16100,16105,16140,16040,16040,16095,-60,-5,80,306
20150326,16040,16095,16110,16150,16110,16150,16130,55,35,20,326
20150327,16150,16130,16200,16200,16055,16060,16105,-70,-25,34,338
20150330,16060,16105,16130,16130,16130,16130,16130,25,25,6,338
20150331,16130,16130,16145,16245,16125,16125,16210,-5,80,106,326
20150401,16125,16210,16095,16100,16085,16100,16095,-110,-115,24,326
20150402,16100,16095,16215,16215,16165,16165,16180,70,85,28,322
20150403,16165,16180,16210,16375,16210,16350,16310,170,130,34,332
20150407,16350,16310,,,,16310,16310,0,0,0,332
20150408,16310,16310,16430,16430,16320,16320,16355,10,45,12,324
20150409,16320,16355,16320,16320,16320,16320,16320,-35,-35,10,330
20150410,16320,16320,16430,16485,16405,16485,16450,165,130,26,340
20150413,16485,16450,16540,16600,16540,16600,16555,150,105,24,342
20150414,16600,16555,16500,16500,16420,16475,16450,-80,-105,38,342
20150415,16475,16450,16535,16625,16490,16625,16565,175,115,62,372
20150416,16625,16565,16710,16745,16710,16715,16725,150,160,16,386
20150417,16715,16725,16860,16860,16810,16830,16830,105,105,18,380
20150420,16830,16830,16730,16770,16650,16650,16730,-180,-100,46,386
20150421,16650,16730,16540,16620,16510,16570,16565,-160,-165,104,368
20150422,16570,16565,16640,16710,16640,16705,16660,140,95,12,362
20150423,16705,16660,16695,16780,16520,16740,16700,80,40,36,374
20150424,16740,16700,16665,16665,16605,16605,16655,-95,-45,12,376
20150427,16605,16655,16785,17010,16785,17010,16945,355,290,56,424
20150428,17010,16945,17060,17190,17015,17050,17065,105,120,398,680
20150429,17050,17065,17110,17115,16910,16955,17045,-110,-20,170,698
20150430,16955,17045,17085,17200,17035,17125,17120,80,75,154,702
20150504,17125,17120,17295,17350,17295,17345,17335,225,215,44,724
20150505,17345,17335,17340,17340,17165,17190,17230,-145,-105,340,784
20150506,17190,17230,17445,17600,17445,17510,17530,280,300,308,786
20150507,17510,17530,17485,17515,17280,17320,17405,-210,-125,136,736
20150508,17320,17405,17415,17415,17200,17200,17305,-205,-100,226,846
20150511,17200,17305,17230,17230,17105,17205,17160,-100,-145,384,1144
20150512,17205,17160,17110,17135,16960,17005,17035,-155,-125,544,1264
20150513,17005,17035,17120,17265,17115,17265,17185,230,150,256,1348
20150514,17265,17185,17260,17260,17050,17170,17115,-15,-70,712,1520
20150515,17170,17115,17115,17170,17000,17035,17040,-80,-75,308,1732
20150518,17035,17040,16970,17025,16890,17025,16960,-15,-80,292,1836
20150519,17025,16960,16950,17040,16920,17000,17005,40,45,240,1822
20150520,17000,17005,16855,16895,16690,16725,16790,-280,-215,356,1804
20150521,16725,16790,16690,16795,16635,16745,16740,-45,-50,596,2180
20150522,16745,16740,16770,16770,16705,16750,16745,10,5,188,2236
20150525,16750,16745,16580,16645,16540,16605,16560,-140,-185,138,2250
20150526,16605,16560,16650,16750,16650,16670,16720,110,160,184,2324
20150527,16670,16720,16670,16720,16650,16685,16695,-35,-25,192,2436
20150528,16685,16695,16595,16915,16595,16915,16805,220,110,338,2518
20150529,16915,16805,16985,17025,16865,16950,16915,145,110,230,2618
20150601,16950,16915,16820,16820,16730,16755,16760,-160,-155,46,2626
20150602,16755,16760,16620,16685,16550,16625,16630,-135,-130,224,2672
20150603,16625,16630,16680,16725,16445,16470,16575,-160,-55,188,2710
20150604,16470,16575,16470,16525,16425,16445,16480,-130,-95,354,2622
20150605,16445,16480,16435,16460,16290,16290,16355,-190,-125,108,2620
20150608,16290,16355,16305,16390,16305,16345,16350,-10,-5,86,2626
20150609,16345,16350,16395,16430,16390,16400,16405,50,55,40,2638
20150610,16400,16405,16495,16550,16485,16520,16520,115,115,524,2888
20150611,16520,16520,16545,16545,16380,16385,16460,-135,-60,50,2892
20150612,16385,16460,16395,16395,16215,16240,16280,-220,-180,346,2960
20150615,16240,16280,16305,16310,16180,16180,16210,-100,-70,252,3018
20150616,16180,16210,16150,16225,16150,16160,16170,-50,-40,140,2998
20150617,16160,16170,16190,16190,15975,15985,16060,-185,-110,444,3120
20150618,15985,16060,15970,15990,15905,15990,15945,-70,-115,38,3116
20150619,15990,15945,15980,15980,15755,15755,15820,-190,-125,562,3216
20150623,15755,15820,15750,15750,15650,15655,15700,-165,-120,1104,3808
20150624,15655,15700,15665,15855,15660,15840,15760,140,60,1150,4058
20150625,15840,15760,15825,15825,15650,15655,15720,-105,-40,380,4068
20150626,15655,15720,15660,15700,15620,15620,15650,-100,-70,268,3988
20150629,15620,15650,15595,15600,15450,15450,15525,-200,-125,534,3980
20150630,15450,15525,15415,15420,15280,15280,15375,-245,-150,462,4076
20150701,15280,15375,15290,15345,15205,15280,15275,-95,-100,444,4242
20150702,15280,15275,15460,15605,15400,15600,15535,325,260,382,4280
20150703,15600,15535,15595,15680,15460,15540,15595,5,60,1446,4928
20150706,15540,15595,15435,15460,15040,15205,15260,-390,-335,1236,5376
20150707,15205,15260,15175,15425,15175,15215,15290,-45,30,366,5468
20150708,15215,15290,15130,15160,14525,14570,14730,-720,-560,1536,5574
20150709,14570,14730,14830,15340,14735,15195,15035,465,305,1256,5734
20150710,15195,15035,15330,15470,15200,15310,15355,275,320,446,5924
20150713,15310,15355,15300,15300,15200,15245,15245,-110,-110,416,6036
20150714,15245,15245,15465,15595,15460,15490,15530,245,285,332,6120
20150715,15490,15530,15475,15710,15475,15700,15630,170,100,1036,6206
20150716,15700,15630,15795,15805,15620,15750,15700,120,70,1176,6022
20150717,15750,15700,15685,15710,15640,15695,15670,-5,-30,252,6026
20150720,15695,15670,15575,15685,15485,15545,15615,-125,-55,992,5868
20150721,15545,15615,15470,15590,15470,15585,15540,-30,-75,712,6270
20150722,15585,15540,15565,15565,15180,15205,15260,-335,-280,2270,7596
20150723,15205,15260,15190,15230,15070,15220,15145,-40,-115,3900,9696
20150724,15220,15145,15185,15215,14930,14950,15035,-195,-110,4088,11482
20150727,14950,15035,14955,14955,14700,14710,14790,-325,-245,5174,13198
20150728,14710,14790,14640,14830,14625,14770,14745,-20,-45,2464,14132
20150729,14770,14745,14890,15175,14870,15050,15020,305,275,6158,15664
20150730,15050,15020,15005,15005,14770,14800,14905,-220,-115,5114,16632
20150731,14800,14905,14765,14925,14690,14825,14825,-80,-80,2434,17594
20150803,14825,14825,14800,14890,14500,14530,14635,-295,-190,6118,19296
20150804,14530,14635,14530,14760,14470,14670,14570,35,-65,5362,20762
20150805,14670,14570,14780,14800,14600,14695,14660,125,90,3298,21636
20150806,14695,14660,14615,14655,14540,14575,14580,-85,-80,6896,23996
20150807,14575,14580,14510,14525,14195,14330,14365,-250,-215,11732,28038
20150810,14330,14365,14260,14470,14205,14440,14335,75,-30,9588,28848
20150811,14440,14335,14455,14650,14445,14560,14555,225,220,13164,29754
20150812,14560,14555,14465,14730,14330,14670,14530,115,-25,17692,31584
20150813,14670,14530,14800,14925,14620,14885,14825,355,295,14104,32370
20150814,14885,14825,14820,14885,14750,14785,14815,-40,-10,6182,32686
20150817,14785,14815,14895,14900,14725,14810,14800,-5,-15,6620,35088
20150818,14810,14800,14750,14830,14590,14605,14685,-195,-115,5930,37436
20150819,14605,14685,14680,14680,14475,14570,14515,-115,-170,10782,41108
20150820,14570,14515,14555,14705,14555,14650,14635,135,120,8388,43144
20150821,14650,14635,14845,14875,14615,14620,14720,-15,85,5854,43426
20150824,14620,14720,14520,14625,14160,14265,14410,-455,-310,23452,44890
20150825,14265,14410,14170,14410,14160,14275,14310,-135,-100,18308,47960
20150826,14275,14310,14500,14570,14315,14355,14415,45,105,13624,48988
20150827,14355,14415,14240,14365,14190,14320,14280,-95,-135,27800,58600
20150828,14320,14280,14450,14680,14405,14600,14535,320,255,23718,56194
20150831,14600,14535,14660,14800,14620,14640,14710,105,175,23264,56178
20150901,14640,14710,14590,14750,14540,14650,14655,-60,-55,12046,56698
20150902,14650,14655,14665,14790,14645,14785,14705,130,50,13176,55810
20150907,14785,14705,14695,14800,14670,14750,14730,45,25,8712,56602
20150908,14750,14730,14705,14725,14505,14605,14585,-125,-145,23624,61330
20150909,14605,14585,14695,14990,14675,14910,14850,325,265,40936,59398
20150910,14910,14850,14960,14960,14800,14905,14865,55,15,20460,60974
20150911,14905,14865,14875,14945,14825,14945,14875,80,10,22798,63324
20150914,14945,14875,14875,14875,14670,14700,14765,-175,-110,27450,67132
20150915,14700,14765,14580,14600,14350,14360,14465,-405,-300,52512,81692
20150916,14360,14465,14345,14445,14285,14425,14370,-40,-95,48838,86666
20150917,14425,14370,14390,14505,14355,14425,14425,55,55,37544,86666
20150918,14425,14425,14350,14420,14260,14260,14345,-165,-80,39822,92888
20150921,14260,14345,14160,14160,13625,13650,13800,-695,-545,122382,117412
20150922,13650,13800,13685,13715,13445,13495,13555,-305,-245,78476,124284
20150923,13495,13555,13500,13600,13315,13565,13465,10,-90,95130,130500
20150924,13565,13465,13620,13865,13505,13745,13640,280,175,115980,135432
20150925,13745,13640,13720,13905,13570,13615,13735,-25,95,165100,142210
20150928,13615,13735,13550,13650,13450,13450,13560,-285,-175,86072,147362
20150929,13450,13560,13300,13500,13270,13435,13400,-125,-160,117632,150868
20150930,13435,13400,13570,13840,13515,13820,13655,420,255,120964,149030
20151008,13820,13655,13970,13980,13620,13625,13735,-30,80,94360,148934
20151009,13625,13735,13650,14400,13585,14295,14080,560,345,520302,162322
20151012,14295,14080,14675,14755,14395,14690,14570,610,490,652134,167588
20151013,14690,14570,14570,14625,14365,14565,14485,-5,-85,459812,168114
20151014,14565,14485,14505,14605,14370,14455,14495,-30,10,415230,164454
20151015,14455,14495,14520,14635,14500,14530,14560,35,65,380976,165868
20151016,14530,14560,14530,14590,14375,14395,14485,-165,-75,299172,166444
20151019,14395,14485,14400,14455,14250,14255,14365,-230,-120,337782,164252
20151020,14255,14365,14230,14290,14150,14230,14210,-135,-155,297862,159876
20151021,14230,14210,14250,14370,14185,14225,14255,15,45,254528,162332
20151022,14225,14255,14150,14170,13845,14020,13985,-235,-270,526520,160266
20151023,14020,13985,14140,14265,13975,14195,14130,210,145,433576,148514
20151026,14195,14130,14215,14230,14020,14170,14130,40,0,327256,153720
20151027,14170,14130,14130,14270,14090,14225,14165,95,35,294908,149242
20151028,14225,14165,14185,14215,14090,14105,14150,-60,-15,210216,130916
20151029,14105,14150,14080,14220,13995,14130,14130,-20,-20,226642,120300
20151030,14130,14130,14010,14085,13755,13765,13905,-365,-225,297248,110930
20151102,13765,13905,13760,13835,13690,13795,13755,-110,-150,122202,93482
20151103,13795,13755,13760,13845,13690,13720,13760,-35,5,63272,89808
20151104,13720,13760,13680,13825,13590,13790,13690,30,-70,58870,83368
20151105,13790,13690,13750,13890,13550,13565,13695,-125,5,53158,78798
20151106,13565,13695,13550,13625,13440,13590,13525,-105,-170,42858,74070
20151109,13590,13525,13530,13620,13475,13550,13550,25,25,32678,70814
20151110,13550,13550,13575,13585,13085,13250,13310,-300,-240,38144,65556
20151111,13250,13310,13230,13240,12805,12835,12955,-475,-355,45442,61676
20151112,12835,12955,12905,13150,12775,13065,12985,110,30,31972,57972
20151113,13065,12985,12920,13150,12820,12990,13005,5,20,27472,55138
20151116,12990,13005,13005,13115,12900,12920,13045,-85,40,19486,53112
20151117,12920,13045,12970,12975,12550,12680,12710,-365,-335,29620,48916
20151118,12680,12710,12745,12840,12400,12525,12535,-185,-175,22090,44898
20151119,12525,12535,12500,12535,12020,12125,12275,-410,-260,24084,42258
20151120,12125,12275,12115,12700,11915,12620,12285,345,10,28690,39194
20151123,12620,12285,12665,12840,12195,12505,12490,220,205,34820,35870
20151124,12505,12490,12480,13015,12380,12935,12665,445,175,25122,30828
20151125,12935,12665,12910,13175,12800,12920,12955,255,290,19584,27274
20151126,12920,12955,12855,13600,12795,13280,13260,325,305,16746,24962
20151127,13280,13260,13305,13475,13000,13110,13230,-150,-30,9308,22654
20151130,13110,13230,12995,13070,12835,13060,12970,-170,-260,4010,20674
zn1601,20150116,15735,15735,15770,16105,15705,15710,15880,-25,145,30,4
20150119,15710,15880,15930,16035,15915,16035,15980,155,100,12,12
20150120,16035,15980,15995,16045,15995,16045,16020,65,40,4,12
20150121,16045,16020,16090,16135,16090,16135,16120,115,100,14,16
20150122,16135,16120,16365,16365,16365,16365,16365,245,245,2,18
20150123,16365,16365,,,,16425,16425,60,60,0,18
20150126,16425,16425,16155,16155,16155,16155,16155,-270,-270,2,20
20150127,16155,16155,,,,16155,16155,0,0,0,20
20150128,16155,16155,,,,16155,16155,0,0,0,20
20150129,16155,16155,16190,16190,16190,16190,16190,35,35,2,22
20150130,16190,16190,16105,16105,16105,16105,16105,-85,-85,2,22
20150202,16105,16105,16190,16190,16190,16190,16190,85,85,2,22
20150203,16190,16190,16220,16300,16220,16300,16270,110,80,6,20
20150204,16300,16270,16365,16555,16365,16415,16435,145,165,14,22
20150205,16415,16435,16330,16340,16330,16340,16330,-95,-105,6,24
20150206,16340,16330,16295,16335,16295,16335,16315,5,-15,4,26
20150209,16335,16315,,,,16315,16315,0,0,0,26
20150210,16315,16315,16400,16450,16400,16400,16415,85,100,6,32
20150211,16400,16415,16265,16265,16250,16250,16255,-165,-160,4,34
20150212,16250,16255,,,,16255,16255,0,0,0,34
20150213,16255,16255,,,,16390,16390,135,135,0,34
20150216,16390,16390,16415,16425,16415,16425,16420,35,30,4,34
20150217,16425,16420,16430,16455,16430,16450,16445,30,25,18,44
20150225,16450,16445,16175,16175,16100,16110,16125,-335,-320,44,56
20150226,16110,16125,16055,16110,16050,16080,16075,-45,-50,58,80
20150227,16080,16075,16110,16110,16055,16090,16070,15,-5,48,112
20150302,16090,16070,16105,16220,16105,16220,16145,150,75,22,116
20150303,16220,16145,16160,16160,16110,16110,16130,-35,-15,14,122
20150304,16110,16130,15970,16000,15920,15960,15960,-170,-170,16,124
20150305,15960,15960,15950,15950,15845,15845,15880,-115,-80,16,122
20150306,15845,15880,15820,15820,15790,15795,15795,-85,-85,14,124
20150309,15795,15795,15800,15800,15770,15785,15780,-10,-15,12,132
20150310,15785,15780,,,,15805,15805,25,25,0,132
20150311,15805,15805,15745,15745,15745,15745,15745,-60,-60,2,134
20150312,15745,15745,15790,15795,15720,15745,15750,0,5,14,146
20150313,15745,15750,15835,15835,15835,15835,15835,85,85,6,146
20150316,15835,15835,15785,15885,15785,15885,15860,50,25,16,148
20150317,15885,15860,15855,15865,15800,15865,15840,5,-20,10,150
20150318,15865,15840,15790,15855,15780,15795,15810,-45,-30,22,166
20150319,15795,15810,15785,15860,15750,15860,15775,50,-35,18,184
20150320,15860,15775,15870,15870,15870,15870,15870,95,95,2,186
20150323,15870,15870,15905,16020,15905,16005,15940,135,70,26,174
20150324,16005,15940,16050,16175,16050,16050,16095,110,155,70,162
20150325,16050,16095,16100,16115,16040,16100,16080,5,-15,30,178
20150326,16100,16080,16170,16210,16165,16165,16190,85,110,12,176
20150327,16165,16190,16210,16210,15990,16155,16120,-35,-70,16,168
20150330,16155,16120,16145,16145,16135,16135,16140,15,20,4,166
20150331,16135,16140,,,,16140,16140,0,0,0,166
20150401,16140,16140,16120,16120,16120,16120,16120,-20,-20,2,168
20150402,16120,16120,,,,16130,16130,10,10,0,168
20150403,16130,16130,,,,16235,16235,105,105,0,168
20150407,16235,16235,16395,16395,16395,16395,16395,160,160,2,166
20150408,16395,16395,,,,16395,16395,0,0,0,166
20150409,16395,16395,16265,16265,16265,16265,16265,-130,-130,2,166
20150410,16265,16265,16430,16520,16425,16520,16455,255,190,6,164
20150413,16520,16455,16610,16610,16585,16610,16595,155,140,8,164
20150414,16610,16595,16480,16480,16465,16465,16475,-130,-120,6,166
20150415,16465,16475,16560,16685,16485,16685,16555,210,80,36,190
20150416,16685,16555,16735,16755,16720,16720,16740,165,185,10,192
20150417,16720,16740,16805,16860,16805,16845,16840,105,100,12,186
20150420,16845,16840,16770,16965,16660,16660,16800,-180,-40,16,186
20150421,16660,16800,16620,16620,16605,16605,16610,-195,-190,18,182
20150422,16605,16610,16745,16775,16660,16775,16720,165,110,34,190
20150423,16775,16720,16780,16840,16700,16795,16780,75,60,16,198
20150424,16795,16780,16750,16750,16695,16695,16730,-85,-50,18,210
20150427,16695,16730,16795,17095,16795,16995,16970,265,240,104,236
20150428,16995,16970,17090,17235,17010,17060,17120,90,150,196,254
20150429,17060,17120,17075,17175,16905,16990,17055,-130,-65,54,256
20150430,16990,17055,17135,17135,17085,17130,17110,75,55,14,262
20150504,17130,17110,17285,17395,17240,17380,17345,270,235,24,256
20150505,17380,17345,17375,17390,17175,17225,17295,-120,-50,252,290
20150506,17225,17295,17450,17660,17450,17580,17575,285,280,62,310
20150507,17580,17575,17540,17605,17325,17380,17420,-195,-155,76,328
20150508,17380,17420,17300,17325,17215,17255,17295,-165,-125,118,390
20150511,17255,17295,17270,17270,17170,17250,17215,-45,-80,70,392
20150512,17250,17215,17110,17180,17010,17035,17080,-180,-135,116,358
20150513,17035,17080,17185,17260,17160,17260,17225,180,145,58,358
20150514,17260,17225,17205,17260,16970,17155,17145,-70,-80,74,338
20150515,17155,17145,17180,17475,16920,17105,17100,-40,-45,52,322
20150518,17105,17100,17035,17035,16940,17015,16995,-85,-105,24,336
20150519,17015,16995,16970,16970,16950,16950,16955,-45,-40,6,336
20150520,16950,16955,16700,16850,16700,16750,16735,-205,-220,56,324
20150521,16750,16735,16715,16760,16655,16730,16720,-5,-15,66,308
20150522,16730,16720,16760,16885,16675,16675,16750,-45,30,70,338
20150525,16675,16750,16620,16695,16575,16645,16615,-105,-135,96,358
20150526,16645,16615,16705,16815,16620,16620,16730,5,115,56,390
20150527,16620,16730,16690,16870,16660,16700,16705,-30,-25,70,370
20150528,16700,16705,16805,16980,16770,16870,16845,165,140,58,360
20150529,16870,16845,16990,17005,16885,16995,16955,150,110,52,364
20150601,16995,16955,16860,16910,16725,16790,16825,-165,-130,64,378
20150602,16790,16825,16695,16700,16455,16660,16635,-165,-190,36,386
20150603,16660,16635,16710,16910,16475,16485,16645,-150,10,176,444
20150604,16485,16645,16580,16580,16480,16540,16540,-105,-105,26,456
20150605,16540,16540,16460,16480,16375,16480,16410,-60,-130,12,452
20150608,16480,16410,16355,16425,16335,16370,16385,-40,-25,88,484
20150609,16370,16385,16425,16460,16425,16460,16435,75,50,24,502
20150610,16460,16435,16585,16585,16510,16550,16540,115,105,60,492
20150611,16550,16540,16595,16595,16375,16410,16465,-130,-75,64,494
20150612,16410,16465,16180,16355,16180,16250,16290,-215,-175,158,454
20150615,16250,16290,16310,16320,16210,16210,16305,-80,15,34,480
20150616,16210,16305,16180,16245,16175,16220,16210,-85,-95,48,478
20150617,16220,16210,16170,16255,15960,15980,16115,-230,-95,1356,510
20150618,15980,16115,16040,16040,15925,16010,15970,-105,-145,72,534
20150619,16010,15970,15980,15995,15785,15785,15860,-185,-110,196,550
20150623,15785,15860,15765,15790,15645,15675,15700,-185,-160,314,632
20150624,15675,15700,15680,15860,15680,15850,15805,150,105,206,692
20150625,15850,15805,15815,15815,15680,15690,15720,-115,-85,214,762
20150626,15690,15720,15665,15730,15320,15690,15655,-30,-65,142,754
20150629,15690,15655,15585,15630,15455,15505,15590,-150,-65,206,882
20150630,15505,15590,15430,15450,15275,15275,15375,-315,-215,116,886
20150701,15275,15375,15265,15380,15200,15315,15295,-60,-80,200,962
20150702,15315,15295,15400,15620,15400,15610,15485,315,190,120,908
20150703,15610,15485,15685,15700,15495,15555,15595,70,110,178,908
20150706,15555,15595,15520,15520,15080,15215,15245,-380,-350,316,988
20150707,15215,15245,15235,15470,15200,15255,15335,10,90,268,906
20150708,15255,15335,15105,15200,14565,14595,14780,-740,-555,1266,1042
20150709,14595,14780,14755,15350,14755,15215,15040,435,260,436,974
20150710,15215,15040,15360,15485,15220,15300,15350,260,310,476,1022
20150713,15300,15350,15305,15305,15200,15230,15220,-120,-130,342,1192
20150714,15230,15220,15490,15595,15435,15475,15520,255,300,1074,1682
20150715,15475,15520,15445,15695,15430,15680,15600,160,80,1684,2324
20150716,15680,15600,15750,15780,15595,15715,15710,115,110,722,2180
20150717,15715,15710,15700,15730,15625,15690,15675,-20,-35,146,2212
20150720,15690,15675,15630,15695,15490,15545,15550,-130,-125,500,2544
20150721,15545,15550,15500,15600,15495,15565,15555,15,5,150,2532
20150722,15565,15555,15545,15545,15180,15220,15370,-335,-185,288,2578
20150723,15220,15370,15225,15225,15070,15195,15145,-175,-225,2630,4074
20150724,15195,15145,15175,15215,14915,14915,15035,-230,-110,1544,4662
20150727,14915,15035,14905,14950,14700,14710,14810,-325,-225,1572,5200
20150728,14710,14810,14610,14815,14610,14755,14745,-55,-65,698,5434
20150729,14755,14745,14895,15130,14855,15025,15020,280,275,2184,5356
20150730,15025,15020,15000,15015,14785,14790,14860,-230,-160,1212,5028
20150731,14790,14860,14730,14910,14720,14795,14805,-65,-55,290,5062
20150803,14795,14805,14815,14860,14495,14530,14655,-275,-150,2208,5184
20150804,14530,14655,14550,14720,14505,14690,14570,35,-85,836,5350
20150805,14690,14570,14795,14800,14595,14690,14685,120,115,1700,6046
20150806,14690,14685,14625,14650,14535,14565,14580,-120,-105,1216,6386
20150807,14565,14580,14480,14510,14190,14315,14345,-265,-235,4314,7878
20150810,14315,14345,14065,14445,14065,14415,14320,70,-25,3068,8784
20150811,14415,14320,14410,14615,14410,14535,14520,215,200,4230,9040
20150812,14535,14520,14380,14705,14295,14635,14465,115,-55,5118,9022
20150813,14635,14465,14765,14890,14595,14860,14800,395,335,3936,8088
20150814,14860,14800,14750,14855,14720,14740,14790,-60,-10,1678,7872
20150817,14740,14790,14830,14865,14685,14775,14770,-15,-20,1128,8064
20150818,14775,14770,14730,14810,14570,14575,14640,-195,-130,1300,8328
20150819,14575,14640,14470,14565,14450,14550,14495,-90,-145,2726,8708
20150820,14550,14495,14550,14670,14535,14615,14605,120,110,1522,8704
20150821,14615,14605,14800,14835,14590,14605,14690,0,85,2186,8710
20150824,14605,14690,14510,14590,14165,14270,14365,-420,-325,5514,9990
20150825,14270,14365,14195,14395,14160,14265,14300,-100,-65,3142,10220
20150826,14265,14300,14500,14540,14300,14330,14375,30,75,3112,11036
20150827,14330,14375,14230,14345,14185,14345,14260,-30,-115,4248,11610
20150828,14345,14260,14440,14645,14390,14565,14525,305,265,7884,12418
20150831,14565,14525,14620,14780,14610,14630,14695,105,170,5060,12658
20150901,14630,14695,14590,14735,14520,14620,14615,-75,-80,3662,12380
20150902,14620,14615,14630,14765,14620,14750,14675,135,60,5110,13096
20150907,14750,14675,14655,14790,14655,14740,14730,65,55,2794,14078
20150908,14740,14730,14680,14705,14495,14585,14570,-145,-160,7990,15744
20150909,14585,14570,14680,14975,14660,14895,14820,325,250,9474,16372
20150910,14895,14820,14935,14935,14790,14895,14855,75,35,4942,17416
20150911,14895,14855,14875,14930,14830,14930,14875,75,20,7298,19042
20150914,14930,14875,14845,14855,14670,14695,14775,-180,-100,7644,20216
20150915,14695,14775,14600,14600,14330,14350,14460,-425,-315,19486,28060
20150916,14350,14460,14350,14410,14250,14385,14335,-75,-125,17450,31690
20150917,14385,14335,14360,14470,14320,14385,14400,50,65,12350,31484
20150918,14385,14400,14310,14375,14230,14230,14300,-170,-100,20212,37556
20150921,14230,14300,14085,14105,13585,13605,13790,-695,-510,44312,44992
20150922,13605,13790,13650,13670,13410,13465,13515,-325,-275,45602,49594
20150923,13465,13515,13455,13565,13285,13535,13420,20,-95,39944,51070
20150924,13535,13420,13635,13820,13470,13705,13600,285,180,46886,51880
20150925,13705,13600,13665,13850,13515,13575,13685,-25,85,58182,52896
20150928,13575,13685,13500,13595,13400,13410,13500,-275,-185,19952,53220
20150929,13410,13500,13380,13440,13280,13375,13345,-125,-155,35696,55100
20150930,13375,13345,13460,13780,13455,13735,13590,390,245,33610,55048
20151008,13735,13590,13800,13880,13545,13545,13665,-45,75,25430,56886
20151009,13545,13665,13615,14340,13515,14260,14020,595,355,104944,60856
20151012,14260,14020,14625,14710,14340,14645,14520,625,500,110788,62202
20151013,14645,14520,14550,14580,14320,14525,14440,5,-80,80100,65666
20151014,14525,14440,14460,14560,14330,14425,14440,-15,0,55230,68632
20151015,14425,14440,14490,14600,14465,14500,14520,60,80,68944,70416
20151016,14500,14520,14510,14555,14350,14355,14450,-165,-70,51728,73342
20151019,14355,14450,14395,14420,14215,14220,14330,-230,-120,79126,79170
20151020,14220,14330,14180,14255,14110,14180,14170,-150,-160,70192,85100
20151021,14180,14170,14180,14315,14140,14190,14210,20,40,62914,90430
20151022,14190,14210,14140,14140,13800,13975,13940,-235,-270,124468,96204
20151023,13975,13940,14105,14225,13930,14140,14075,200,135,118724,101710
20151026,14140,14075,14150,14190,13980,14125,14085,50,10,94300,103018
20151027,14125,14085,14100,14240,14050,14195,14130,110,45,91124,110038
20151028,14195,14130,14160,14175,14050,14060,14110,-70,-20,73350,116318
20151029,14060,14110,14025,14195,13955,14085,14090,-25,-20,107086,123260
20151030,14085,14090,13990,14045,13715,13730,13855,-360,-235,184758,137708
20151102,13730,13855,13705,13805,13650,13765,13720,-90,-135,160314,149246
20151103,13765,13720,13725,13825,13665,13695,13735,-25,15,162486,158394
20151104,13695,13735,13650,13810,13565,13780,13665,45,-70,272078,149070
20151105,13780,13665,13725,13875,13515,13530,13675,-135,10,320090,158342
20151106,13530,13675,13505,13600,13405,13560,13490,-115,-185,360174,158652
20151109,13560,13490,13510,13595,13450,13525,13520,35,30,306784,164682
20151110,13525,13520,13540,13565,13050,13225,13265,-295,-255,436190,184960
20151111,13225,13265,13200,13215,12765,12800,12930,-465,-335,873074,225694
20151112,12800,12930,12860,13120,12735,13030,12930,100,0,734854,222918
20151113,13030,12930,12870,13125,12780,12955,12965,25,35,828736,218960
20151116,12955,12965,12960,13095,12870,12900,13010,-65,45,452030,229132
20151117,12900,13010,12935,12940,12490,12615,12680,-395,-330,789042,231706
20151118,12615,12680,12680,12775,12300,12450,12500,-230,-180,755738,230950
20151119,12450,12500,12430,12430,11920,12040,12190,-460,-310,970718,251596
20151120,12040,12190,12000,12595,11815,12525,12180,335,-10,1584570,252484
20151123,12525,12180,12620,12740,12030,12355,12400,175,220,1844238,257888
20151124,12355,12400,12335,12920,12215,12825,12495,425,95,1719622,221182
20151125,12825,12495,12735,13105,12685,12815,12855,320,360,1425854,163888
20151126,12815,12855,12750,13490,12665,13175,13055,320,200,1322036,139586
20151127,13175,13055,13205,13360,12870,13025,13135,-30,80,1242346,118422
20151130,13025,13135,12870,12960,12725,12875,12855,-260,-280,711374,116486
zn1602,20150216,16390,16390,,,,16420,16420,30,30,0,0
20150217,16420,16420,,,,16445,16445,25,25,0,0
20150225,16445,16445,,,,16125,16125,-320,-320,0,0
20150226,16125,16125,16090,16170,16085,16160,16110,35,-15,18,18
20150227,16160,16110,16115,16170,16090,16170,16110,60,0,54,62
20150302,16170,16110,16095,16130,16095,16130,16110,20,0,4,58
20150303,16130,16110,,,,16110,16110,0,0,0,58
20150304,16110,16110,15970,15975,15930,15965,15955,-145,-155,12,62
20150305,15965,15955,15890,15890,15850,15850,15850,-105,-105,20,52
20150306,15850,15850,15890,15890,15865,15865,15870,15,20,6,58
20150309,15865,15870,15810,15835,15810,15835,15820,-35,-50,4,60
20150310,15835,15820,15880,15880,15880,15880,15880,60,60,2,60
20150311,15880,15880,15750,15825,15750,15825,15800,-55,-80,10,70
20150312,15825,15800,15795,15800,15720,15800,15765,0,-35,22,84
20150313,15800,15765,15860,15860,15860,15860,15860,95,95,2,84
20150316,15860,15860,15910,15910,15905,15905,15905,45,45,4,82
20150317,15905,15905,15875,15875,15870,15870,15870,-35,-35,4,82
20150318,15870,15870,15790,15790,15790,15790,15790,-80,-80,6,86
20150319,15790,15790,15820,15820,15770,15775,15795,-15,5,40,90
20150320,15775,15795,15825,15885,15825,15885,15845,90,50,10,88
20150323,15885,15845,16020,16020,16020,16020,16020,175,175,2,88
20150324,16020,16020,16115,16115,16110,16110,16110,90,90,4,84
20150325,16110,16110,16165,16165,16110,16110,16150,0,40,14,94
20150326,16110,16150,16200,16200,16200,16200,16200,50,50,2,92
20150327,16200,16200,,,,16200,16200,0,0,0,92
20150330,16200,16200,16195,16200,16190,16200,16190,0,-10,8,92
20150331,16200,16190,,,,16190,16190,0,0,0,92
20150401,16190,16190,16150,16190,16150,16190,16165,0,-25,8,92
20150402,16190,16165,16235,16235,16235,16235,16235,70,70,4,92
20150403,16235,16235,16350,16420,16335,16350,16370,115,135,36,94
20150407,16350,16370,,,,16370,16370,0,0,0,94
20150408,16370,16370,,,,16370,16370,0,0,0,94
20150409,16370,16370,16375,16375,16375,16375,16375,5,5,2,94
20150410,16375,16375,,,,16375,16375,0,0,0,94
20150413,16375,16375,16690,16690,16690,16690,16690,315,315,4,98
20150414,16690,16690,16695,16695,16525,16525,16615,-165,-75,16,90
20150415,16525,16615,16610,16720,16610,16720,16640,105,25,14,96
20150416,16720,16640,16660,16790,16660,16790,16705,150,65,10,94
20150417,16790,16705,16890,16900,16875,16900,16885,195,180,6,96
20150420,16900,16885,16700,16700,16700,16700,16700,-185,-185,4,100
20150421,16700,16700,16655,16655,16625,16625,16635,-75,-65,6,100
20150422,16625,16635,,,,16635,16635,0,0,0,100
20150423,16635,16635,16770,16795,16645,16795,16740,160,105,24,110
20150424,16795,16740,16770,16770,16740,16760,16760,20,20,10,108
20150427,16760,16760,16915,17080,16875,17060,16965,300,205,48,122
20150428,17060,16965,17100,17295,17100,17100,17180,135,215,22,128
20150429,17100,17180,17095,17165,17005,17005,17080,-175,-100,44,138
20150430,17005,17080,17170,17265,17155,17155,17175,75,95,20,152
20150504,17155,17175,17230,17375,17230,17365,17340,190,165,10,156
20150505,17365,17340,17305,17325,17305,17325,17315,-15,-25,4,154
20150506,17325,17315,17480,17650,17480,17510,17575,195,260,26,158
20150507,17510,17575,17395,17400,17395,17400,17395,-175,-180,4,160
20150508,17400,17395,17435,17435,17290,17290,17370,-105,-25,26,156
20150511,17290,17370,17265,17265,17210,17250,17225,-120,-145,168,294
20150512,17250,17225,17130,17180,17020,17045,17065,-180,-160,124,358
20150513,17045,17065,17145,17255,17145,17205,17180,140,115,78,428
20150514,17205,17180,17250,17250,17115,17195,17150,15,-30,62,436
20150515,17195,17150,17240,17240,17100,17100,17190,-50,40,24,424
20150518,17100,17190,17000,17115,16980,17005,17020,-185,-170,12,424
20150519,17005,17020,17035,17065,16970,17020,16995,0,-25,102,470
20150520,17020,16995,16885,16915,16810,16810,16855,-185,-140,20,484
20150521,16810,16855,16730,16810,16670,16810,16745,-45,-110,36,480
20150522,16810,16745,16805,16805,16805,16805,16805,60,60,14,476
20150525,16805,16805,16645,16645,16620,16620,16635,-185,-170,14,482
20150526,16620,16635,16830,16840,16710,16715,16785,80,150,82,518
20150527,16715,16785,16680,16780,16680,16710,16725,-75,-60,64,518
20150528,16710,16725,16670,16865,16670,16845,16790,120,65,54,534
20150529,16845,16790,17010,17035,16895,16930,16950,140,160,88,586
20150601,16930,16950,16930,16930,16775,16775,16810,-175,-140,52,616
20150602,16775,16810,16645,16710,16580,16625,16650,-185,-160,38,636
20150603,16625,16650,16780,16780,16480,16480,16700,-170,50,64,662
20150604,16480,16700,16525,16565,16455,16565,16520,-135,-180,32,686
20150605,16565,16520,16475,16475,16410,16410,16445,-110,-75,38,714
20150608,16410,16445,16350,16415,16330,16415,16370,-30,-75,50,746
20150609,16415,16370,16420,16460,16420,16460,16440,90,70,40,784
20150610,16460,16440,16550,16560,16515,16560,16550,120,110,28,774
20150611,16560,16550,16505,16505,16410,16430,16445,-120,-105,6,774
20150612,16430,16445,16385,16385,16295,16295,16325,-150,-120,6,774
20150615,16295,16325,16345,16345,16345,16345,16345,20,20,2,776
20150616,16345,16345,16175,16235,16175,16230,16210,-115,-135,6,780
20150617,16230,16210,16175,16175,16085,16085,16120,-125,-90,22,770
20150618,16085,16120,15970,15970,15970,15970,15970,-150,-150,2,772
20150619,15970,15970,15945,15945,15880,15880,15920,-90,-50,6,772
20150623,15880,15920,15820,15820,15705,15710,15725,-210,-195,22,778
20150624,15710,15725,15805,15860,15795,15860,15830,135,105,44,808
20150625,15860,15830,15830,15830,15680,15680,15755,-150,-75,64,824
20150626,15680,15755,15695,15715,15660,15660,15685,-95,-70,28,828
20150629,15660,15685,15620,15640,15520,15520,15625,-165,-60,170,954
20150630,15520,15625,15440,15455,15360,15360,15405,-265,-220,56,958
20150701,15360,15405,15330,15390,15110,15390,15255,-15,-150,42,938
20150702,15390,15255,15490,15645,15485,15615,15575,360,320,120,926
20150703,15615,15575,15600,15700,15535,15565,15605,-10,30,50,908
20150706,15565,15605,15400,15580,15090,15145,15260,-460,-345,54,900
20150707,15145,15260,15230,15450,15165,15300,15350,40,90,80,892
20150708,15300,15350,15130,15190,14585,14610,14760,-740,-590,198,866
20150709,14610,14760,14885,15290,14270,15195,14990,435,230,294,762
20150710,15195,14990,15265,15370,15265,15370,15300,380,310,20,776
20150713,15370,15300,15285,15285,15200,15200,15210,-100,-90,18,776
20150714,15200,15210,15565,15565,15535,15535,15545,325,335,6,778
20150715,15535,15545,15515,15670,15515,15650,15610,105,65,26,782
20150716,15650,15610,15705,15705,15670,15690,15690,80,80,22,768
20150717,15690,15690,15620,15740,15620,15665,15660,-25,-30,16,766
20150720,15665,15660,15685,15685,15510,15520,15540,-140,-120,36,774
20150721,15520,15540,15545,15595,15520,15520,15550,-20,10,26,790
20150722,15520,15550,15545,15545,15205,15220,15345,-330,-205,8,796
20150723,15220,15345,15200,15210,15055,15210,15145,-135,-200,46,778
20150724,15210,15145,15215,15215,14940,14940,15055,-205,-90,158,792
20150727,14940,15055,14935,14935,14780,14780,14840,-275,-215,10,788
20150728,14780,14840,14700,14835,14700,14795,14775,-45,-65,90,860
20150729,14795,14775,14945,15155,14935,15025,15015,250,240,510,922
20150730,15025,15015,14900,14940,14765,14790,14905,-225,-110,116,972
20150731,14790,14905,14815,14840,14800,14810,14810,-95,-95,332,1182
20150803,14810,14810,14830,14830,14580,14580,14660,-230,-150,162,1204
20150804,14580,14660,14550,14670,14550,14640,14570,-20,-90,66,1226
20150805,14640,14570,14755,14755,14710,14715,14720,145,150,8,1226
20150806,14715,14720,14585,14590,14585,14590,14585,-130,-135,22,1236
20150807,14590,14585,14560,14560,14285,14295,14350,-290,-235,320,1320
20150810,14295,14350,14210,14400,14195,14385,14265,35,-85,240,1440
20150811,14385,14265,14475,14565,14475,14490,14515,225,250,116,1432
20150812,14490,14515,14340,14660,14285,14590,14555,75,40,204,1438
20150813,14590,14555,14885,14885,14660,14770,14755,215,200,590,1524
20150814,14770,14755,14740,14820,14700,14715,14740,-40,-15,218,1460
20150817,14715,14740,14805,14805,14680,14730,14740,-10,0,74,1444
20150818,14730,14740,14700,14720,14580,14580,14630,-160,-110,208,1568
20150819,14580,14630,14480,14560,14440,14505,14465,-125,-165,364,1714
20150820,14505,14465,14565,14620,14530,14620,14565,155,100,42,1710
20150821,14620,14565,14755,14755,14580,14580,14650,15,85,94,1732
20150824,14580,14650,14535,14570,14250,14250,14355,-400,-295,1030,1730
20150825,14250,14355,14210,14390,14180,14290,14325,-65,-30,204,1768
20150826,14290,14325,14520,14535,14325,14345,14380,20,55,154,1818
20150827,14345,14380,14260,14335,14210,14335,14270,-45,-110,510,2072
20150828,14335,14270,14560,14615,14500,14550,14535,280,265,692,2096
20150831,14550,14535,14610,14730,14595,14605,14660,70,125,386,1998
20150901,14605,14660,14695,14710,14585,14610,14630,-50,-30,460,2384
20150902,14610,14630,14595,14735,14595,14735,14650,105,20,338,2582
20150907,14735,14650,14740,14765,14645,14700,14700,50,50,382,2862
20150908,14700,14700,14640,14640,14480,14580,14520,-120,-180,910,3148
20150909,14580,14520,14685,14940,14660,14850,14830,330,310,2226,4158
20150910,14850,14830,14900,14905,14780,14890,14815,60,-15,974,4862
20150911,14890,14815,14815,14905,14815,14900,14870,85,55,410,5016
20150914,14900,14870,14815,14845,14675,14685,14765,-185,-105,700,5072
20150915,14685,14765,14565,14575,14315,14325,14415,-440,-350,5492,8802
20150916,14325,14415,14325,14365,14210,14340,14295,-75,-120,6840,13160
20150917,14340,14295,14300,14435,14300,14360,14365,65,70,2390,13646
20150918,14360,14365,14215,14325,14200,14200,14260,-165,-105,4412,15700
20150921,14200,14260,14085,14085,13545,13575,13715,-685,-545,5910,16002
20150922,13575,13715,13600,13630,13385,13435,13470,-280,-245,4424,17112
20150923,13435,13470,13420,13525,13250,13505,13405,35,-65,4182,17396
20150924,13505,13405,13530,13750,13425,13640,13575,235,170,2370,17220
20150925,13640,13575,13590,13775,13470,13515,13630,-60,55,4244,17142
20150928,13515,13630,13460,13540,13365,13375,13440,-255,-190,2704,17740
20150929,13375,13440,13280,13385,13125,13320,13295,-120,-145,6130,18296
20150930,13320,13295,13400,13730,13400,13675,13530,380,235,3150,18498
20151008,13675,13530,13620,13820,13500,13510,13605,-20,75,3440,19076
20151009,13510,13605,13570,14285,13470,14205,13970,600,365,10820,19226
20151012,14205,13970,14600,14665,14315,14605,14450,635,480,11002,21240
20151013,14605,14450,14505,14535,14285,14475,14410,25,-40,11258,22252
20151014,14475,14410,14410,14505,14295,14375,14400,-35,-10,6320,23280
20151015,14375,14400,14450,14550,14430,14450,14480,50,80,2910,23294
20151016,14450,14480,14440,14515,14320,14320,14415,-160,-65,2806,23522
20151019,14320,14415,14350,14380,14180,14180,14295,-235,-120,4434,23972
20151020,14180,14295,14165,14210,14070,14140,14135,-155,-160,4430,23908
20151021,14140,14135,14170,14275,14100,14140,14165,5,30,3214,24140
20151022,14140,14165,14085,14085,13760,13930,13905,-235,-260,9660,25668
20151023,13930,13905,14090,14185,13905,14105,14035,200,130,9938,27612
20151026,14105,14035,14160,14160,13950,14085,14050,50,15,9290,29160
20151027,14085,14050,14055,14200,14010,14140,14095,90,45,11558,30868
20151028,14140,14095,14135,14145,14030,14050,14085,-45,-10,13596,35616
20151029,14050,14085,14045,14170,13930,14080,14060,-5,-25,14634,38536
20151030,14080,14060,13915,14010,13705,13720,13825,-340,-235,19304,43774
20151102,13720,13825,13620,13790,13620,13760,13730,-65,-95,12668,47604
20151103,13760,13730,13685,13820,13665,13695,13735,-35,5,15128,52068
20151104,13695,13735,13620,13805,13560,13785,13665,50,-70,23624,52816
20151105,13785,13665,13725,13865,13510,13520,13655,-145,-10,31062,56182
20151106,13520,13655,13520,13595,13400,13555,13495,-100,-160,30724,59416
20151109,13555,13495,13480,13595,13445,13525,13520,30,25,29156,62418
20151110,13525,13520,13545,13560,13050,13240,13260,-280,-260,49364,69228
20151111,13240,13260,13200,13215,12775,12800,12925,-460,-335,86182,79870
20151112,12800,12925,12850,13120,12745,13035,12950,110,25,77452,79770
20151113,13035,12950,12895,13210,12790,12975,12970,25,20,91210,76686
20151116,12975,12970,12980,13090,12875,12900,13010,-70,40,53686,78772
20151117,12900,13010,13060,13060,12500,12615,12675,-395,-335,121470,82386
20151118,12615,12675,12675,12770,12285,12410,12460,-265,-215,111042,92958
20151119,12410,12460,12375,12400,11835,12020,12150,-440,-310,155996,100678
20151120,12020,12150,11995,12525,11770,12445,12160,295,10,324802,132672
20151123,12445,12160,12510,12670,11885,12230,12255,70,95,520140,190040
20151124,12230,12255,12200,12850,12080,12745,12440,490,185,569036,202694
20151125,12745,12440,12700,13060,12625,12750,12800,310,360,546680,172532
20151126,12750,12800,12700,13440,12605,13130,13030,330,230,582210,171426
20151127,13130,13030,13160,13305,12805,12960,13045,-70,15,528488,178322
20151130,12960,13045,12795,12890,12645,12800,12785,-245,-260,404718,193590
zn1603,20150317,15905,15905,15900,15920,15900,15920,15910,15,5,4,4
20150318,15920,15910,15855,15855,15795,15795,15815,-115,-95,6,8
20150319,15795,15815,15850,15895,15850,15895,15870,80,55,4,8
20150320,15895,15870,,,,15870,15870,0,0,0,8
20150323,15870,15870,,,,15870,15870,0,0,0,8
20150324,15870,15870,16150,16150,16150,16150,16150,280,280,2,10
20150325,16150,16150,,,,16150,16150,0,0,0,10
20150326,16150,16150,,,,16150,16150,0,0,0,10
20150327,16150,16150,,,,16150,16150,0,0,0,10
20150330,16150,16150,,,,16140,16140,-10,-10,0,10
20150331,16140,16140,16275,16275,16275,16275,16275,135,135,6,16
20150401,16275,16275,16155,16280,16155,16175,16190,-100,-85,36,40
20150402,16175,16190,16205,16250,16205,16250,16235,60,45,6,38
20150403,16250,16235,16420,16420,16400,16400,16410,165,175,14,38
20150407,16400,16410,16480,16480,16480,16480,16480,70,70,2,38
20150408,16480,16480,16525,16640,16480,16480,16525,0,45,18,44
20150409,16480,16525,16515,16515,16335,16415,16415,-110,-110,8,48
20150410,16415,16415,,,,16415,16415,0,0,0,48
20150413,16415,16415,16810,16810,16585,16700,16760,285,345,24,66
20150414,16700,16760,16730,16740,16555,16555,16650,-205,-110,36,76
20150415,16555,16650,16560,16735,16560,16735,16610,85,-40,22,74
20150416,16735,16610,16800,16875,16800,16800,16830,190,220,34,86
20150417,16800,16830,16845,16940,16845,16940,16890,110,60,4,84
20150420,16940,16890,16815,16830,16735,16735,16795,-155,-95,8,82
20150421,16735,16795,16680,16700,16670,16670,16680,-125,-115,14,74
20150422,16670,16680,,,,16680,16680,0,0,0,74
20150423,16680,16680,16890,16935,16735,16815,16825,135,145,132,96
20150424,16815,16825,16850,16850,16740,16750,16760,-75,-65,16,96
20150427,16750,16760,16880,17085,16875,17080,16955,320,195,26,96
20150428,17080,16955,17100,17100,17100,17100,17100,145,145,10,106
20150429,17100,17100,17230,17230,17135,17195,17195,95,95,38,106
20150430,17195,17195,17115,17200,17115,17200,17150,5,-45,6,106
20150504,17200,17150,17425,17440,17400,17400,17425,250,275,10,114
20150505,17400,17425,17345,17425,17145,17350,17355,-75,-70,60,122
20150506,17350,17355,17645,17665,17545,17620,17605,265,250,22,122
20150507,17620,17605,,,,17605,17605,0,0,0,122
20150508,17605,17605,17315,17315,17315,17315,17315,-290,-290,8,122
20150511,17315,17315,17245,17305,17245,17305,17275,-10,-40,6,122
20150512,17305,17275,17160,17160,17065,17065,17135,-210,-140,8,120
20150513,17065,17135,17225,17240,17225,17240,17230,105,95,4,122
20150514,17240,17230,17165,17165,17160,17160,17160,-70,-70,6,122
20150515,17160,17160,17150,17150,17150,17150,17150,-10,-10,2,122
20150518,17150,17150,17040,17050,16895,17045,16980,-105,-170,18,122
20150519,17045,16980,17030,17075,17030,17075,17045,95,65,6,124
20150520,17075,17045,16910,16935,16800,16830,16870,-215,-175,64,124
20150521,16830,16870,17005,17005,16715,16825,16805,-45,-65,82,144
20150522,16825,16805,16810,16825,16795,16820,16805,15,0,16,130
20150525,16820,16805,16675,16690,16665,16690,16670,-115,-135,8,128
20150526,16690,16670,16840,16840,16680,16680,16760,10,90,4,130
20150527,16680,16760,16655,16715,16655,16715,16685,-45,-75,4,128
20150528,16715,16685,16825,16955,16825,16900,16895,215,210,16,120
20150529,16900,16895,17080,17080,16905,16955,16980,60,85,10,122
20150601,16955,16980,16800,16865,16800,16865,16860,-115,-120,32,140
20150602,16865,16860,16710,16715,16625,16675,16680,-185,-180,20,138
20150603,16675,16680,16760,16760,16610,16610,16675,-70,-5,10,138
20150604,16610,16675,16575,16675,16535,16590,16570,-85,-105,24,136
20150605,16590,16570,16510,16510,16415,16415,16460,-155,-110,24,142
20150608,16415,16460,16460,16460,16440,16440,16440,-20,-20,12,148
20150609,16440,16440,16490,16500,16490,16495,16495,55,55,8,146
20150610,16495,16495,16545,16580,16530,16530,16550,35,55,16,140
20150611,16530,16550,16595,16595,16460,16460,16530,-90,-20,6,140
20150612,16460,16530,16330,16330,16330,16330,16330,-200,-200,4,136
20150615,16330,16330,16350,16350,16350,16350,16350,20,20,2,134
20150616,16350,16350,16290,16290,16240,16240,16260,-110,-90,6,130
20150617,16240,16260,16070,16070,16050,16050,16060,-210,-200,14,132
20150618,16050,16060,16005,16005,16005,16005,16005,-55,-55,2,134
20150619,16005,16005,16010,16010,15935,15935,15975,-70,-30,10,142
20150623,15935,15975,15815,15815,15750,15750,15795,-225,-180,16,148
20150624,15750,15795,15775,15870,15775,15870,15835,75,40,22,142
20150625,15870,15835,15850,15865,15760,15760,15825,-75,-10,18,150
20150626,15760,15825,15780,15780,15720,15730,15725,-95,-100,20,140
20150629,15730,15725,15645,15645,15430,15430,15535,-295,-190,4,138
20150630,15430,15535,15485,15485,15385,15385,15455,-150,-80,60,132
20150701,15385,15455,15320,15405,15320,15405,15350,-50,-105,6,130
20150702,15405,15350,15485,15675,15485,15640,15590,290,240,16,134
20150703,15640,15590,15675,15875,15550,15610,15675,20,85,34,136
20150706,15610,15675,15545,15545,15130,15160,15245,-515,-430,52,130
20150707,15160,15245,15340,15480,15295,15295,15360,50,115,18,120
20150708,15295,15360,15240,15250,14600,14630,14985,-730,-375,88,100
20150709,14630,14985,14935,15245,14935,15245,15125,260,140,18,88
20150710,15245,15125,15305,15305,15305,15305,15305,180,180,2,88
20150713,15305,15305,,,,15215,15215,-90,-90,0,88
20150714,15215,15215,,,,15550,15550,335,335,0,88
20150715,15550,15550,,,,15615,15615,65,65,0,88
20150716,15615,15615,,,,15695,15695,80,80,0,88
20150717,15695,15695,,,,15665,15665,-30,-30,0,88
20150720,15665,15665,,,,15545,15545,-120,-120,0,88
20150721,15545,15545,,,,15555,15555,10,10,0,88
20150722,15555,15555,15260,15260,15260,15260,15260,-295,-295,2,86
20150723,15260,15260,,,,15060,15060,-200,-200,0,86
20150724,15060,15060,15045,15060,14930,14930,15020,-130,-40,18,86
20150727,14930,15020,14870,14870,14700,14700,14750,-320,-270,10,84
20150728,14700,14750,14735,14735,14735,14735,14735,-15,-15,2,82
20150729,14735,14735,15020,15020,14960,14960,14990,225,255,4,82
20150730,14960,14990,,,,14880,14880,-110,-110,0,82
20150731,14880,14880,14830,14830,14710,14780,14770,-100,-110,6,80
20150803,14780,14770,14810,14810,14585,14610,14665,-160,-105,10,78
20150804,14610,14665,14590,14685,14590,14685,14635,20,-30,4,74
20150805,14685,14635,14630,14685,14625,14685,14645,50,10,6,76
20150806,14685,14645,,,,14515,14515,-130,-130,0,76
20150807,14515,14515,14340,14340,14340,14340,14340,-175,-175,2,78
20150810,14340,14340,14410,14410,14265,14380,14345,40,5,22,92
20150811,14380,14345,14500,14580,14500,14550,14550,205,205,10,88
20150812,14550,14550,14555,14555,14555,14555,14555,5,5,2,86
20150813,14555,14555,14880,14935,14615,14695,14795,140,240,28,88
20150814,14695,14795,,,,14780,14780,-15,-15,0,88
20150817,14780,14780,14750,14750,14750,14750,14750,-30,-30,2,90
20150818,14750,14750,,,,14750,14750,0,0,0,90
20150819,14750,14750,14470,14470,14470,14470,14470,-280,-280,4,90
20150820,14470,14470,14445,14610,14445,14610,14575,140,105,10,96
20150821,14610,14575,,,,14660,14660,85,85,0,96
20150824,14660,14660,14545,14545,14215,14340,14395,-320,-265,12,102
20150825,14340,14395,,,,14365,14365,-30,-30,0,102
20150826,14365,14365,14495,14495,14495,14495,14495,130,130,4,106
20150827,14495,14495,14270,14390,14245,14330,14325,-165,-170,18,108
20150828,14330,14325,14400,14665,14400,14665,14465,340,140,8,106
20150831,14665,14465,14595,14755,14555,14555,14645,90,180,22,108
20150901,14555,14645,14615,14715,14615,14620,14640,-25,-5,8,110
20150902,14620,14640,14650,14650,14630,14630,14645,-10,5,8,110
20150907,14630,14645,,,,14695,14695,50,50,0,110
20150908,14695,14695,14615,14615,14590,14590,14595,-105,-100,6,110
20150909,14590,14595,14775,14930,14775,14930,14825,335,230,6,112
20150910,14930,14825,14805,14855,14805,14855,14830,30,5,4,114
20150911,14855,14830,14870,14870,14870,14870,14870,40,40,12,126
20150914,14870,14870,14820,14865,14700,14700,14840,-170,-30,20,136
20150915,14700,14840,14550,14550,14360,14360,14435,-480,-405,138,172
20150916,14360,14435,14280,14355,14220,14345,14300,-90,-135,298,404
20150917,14345,14300,14350,14410,14310,14340,14335,40,35,156,400
20150918,14340,14335,14235,14265,14155,14155,14220,-180,-115,394,618
20150921,14155,14220,13960,13980,13505,13535,13635,-685,-585,1362,1424
20150922,13535,13635,13555,13595,13340,13360,13395,-275,-240,3614,3648
20150923,13360,13395,13360,13460,13210,13460,13340,65,-55,1066,4426
20150924,13460,13340,13470,13690,13390,13590,13560,250,220,454,4426
20150925,13590,13560,13590,13720,13425,13480,13550,-80,-10,1254,4374
20150928,13480,13550,13470,13485,13310,13345,13385,-205,-165,520,4408
20150929,13345,13385,13225,13340,13205,13270,13245,-115,-140,664,4560
20150930,13270,13245,13395,13650,13380,13605,13470,360,225,218,4546
20151008,13605,13470,13735,13735,13460,13460,13550,-10,80,478,4688
20151009,13460,13550,13460,14225,13425,14125,13955,575,405,1638,4924
20151012,14125,13955,14540,14595,14290,14550,14490,595,535,3220,5624
20151013,14550,14490,14505,14505,14255,14410,14345,-80,-145,1090,5944
20151014,14410,14345,14405,14465,14260,14330,14345,-15,0,672,5978
20151015,14330,14345,14425,14510,14400,14405,14440,60,95,674,6254
20151016,14405,14440,14400,14470,14275,14275,14375,-165,-65,688,6586
20151019,14275,14375,14330,14340,14165,14165,14255,-210,-120,1280,6996
20151020,14165,14255,14135,14165,14040,14095,14100,-160,-155,896,7162
20151021,14095,14100,14120,14240,14075,14115,14145,15,45,388,7172
20151022,14115,14145,14005,14005,13730,13890,13885,-255,-260,3066,8524
20151023,13890,13885,14050,14155,13875,14060,14045,175,160,2140,9160
20151026,14060,14045,14105,14125,13915,14075,14020,30,-25,1302,9184
20151027,14075,14020,14010,14170,14000,14140,14050,120,30,1190,9278
20151028,14140,14050,14100,14110,14010,14040,14070,-10,20,2006,10332
20151029,14040,14070,13960,14140,13920,14065,14060,-5,-10,3110,11812
20151030,14065,14060,13960,14010,13700,13710,13810,-350,-250,4276,13800
20151102,13710,13810,13650,13785,13630,13770,13725,-40,-85,2968,15014
20151103,13770,13725,13710,13815,13675,13715,13745,-10,20,1856,15622
20151104,13715,13745,13700,13800,13565,13795,13690,50,-55,3058,16164
20151105,13795,13690,13720,13865,13520,13525,13665,-165,-25,4898,15872
20151106,13525,13665,13525,13600,13410,13580,13505,-85,-160,4434,17042
20151109,13580,13505,13560,13600,13460,13540,13535,35,30,3508,18060
20151110,13540,13535,13555,13580,13070,13245,13265,-290,-270,8024,19198
20151111,13245,13265,13210,13220,12800,12830,12925,-435,-340,10838,21690
20151112,12830,12925,12870,13135,12765,13060,12990,135,65,9780,22814
20151113,13060,12990,12860,13140,12360,12990,12995,0,5,11820,24078
20151116,12990,12995,12995,13110,12880,12900,13005,-95,10,12648,26164
20151117,12900,13005,12940,12955,12500,12620,12705,-385,-300,19094,29530
20151118,12620,12705,12675,12770,12290,12410,12445,-295,-260,24432,33712
20151119,12410,12445,12400,12400,11895,12020,12120,-425,-325,37984,41890
20151120,12020,12120,11995,12515,11770,12440,12150,320,30,77214,46380
20151123,12440,12150,12500,12635,11805,12140,12195,-10,45,118532,61128
20151124,12140,12195,12105,12800,11975,12695,12345,500,150,126994,66000
20151125,12695,12345,12600,12960,12585,12710,12750,365,405,117670,60208
20151126,12710,12750,12605,13385,12565,13100,13040,350,290,125862,65302
20151127,13100,13040,13155,13275,12765,12915,13020,-125,-20,102110,71208
20151130,12915,13020,12770,12840,12615,12770,12750,-250,-270,82792,77164
zn1604,20150416,16610,16610,,,,16610,16610,0,0,0,0
20150417,16610,16610,17060,17060,17060,17060,17060,450,450,2,2
20150420,17060,17060,,,,17060,17060,0,0,0,2
20150421,17060,17060,,,,17060,17060,0,0,0,2
20150422,17060,17060,,,,17060,17060,0,0,0,2
20150423,17060,17060,,,,17060,17060,0,0,0,2
20150424,17060,17060,,,,17060,17060,0,0,0,2
20150427,17060,17060,17010,17145,17010,17145,17050,85,-10,14,8
20150428,17145,17050,,,,17050,17050,0,0,0,8
20150429,17050,17050,17175,17175,17150,17150,17165,100,115,8,12
20150430,17150,17165,17195,17195,17195,17195,17195,30,30,2,12
20150504,17195,17195,17430,17430,17390,17390,17410,195,215,4,16
20150505,17390,17410,17405,17410,17370,17370,17385,-40,-25,10,22
20150506,17370,17385,17595,17755,17595,17640,17650,255,265,18,32
20150507,17640,17650,17425,17425,17425,17425,17425,-225,-225,2,32
20150508,17425,17425,17450,17450,17450,17450,17450,25,25,2,32
20150511,17450,17450,,,,17450,17450,0,0,0,32
20150512,17450,17450,17255,17255,17095,17095,17135,-355,-315,8,30
20150513,17095,17135,17270,17270,17270,17270,17270,135,135,2,30
20150514,17270,17270,17340,17340,17265,17270,17280,0,10,10,38
20150515,17270,17280,,,,17280,17280,0,0,0,38
20150518,17280,17280,17160,17160,17160,17160,17160,-120,-120,2,40
20150519,17160,17160,17015,17065,17015,17065,17040,-95,-120,4,38
20150520,17065,17040,16990,16990,16940,16940,16955,-100,-85,8,42
20150521,16940,16955,,,,16955,16955,0,0,0,42
20150522,16955,16955,16890,16890,16865,16865,16880,-90,-75,8,38
20150525,16865,16880,16690,16780,16680,16730,16705,-150,-175,12,46
20150526,16730,16705,16790,16855,16790,16845,16825,140,120,22,44
20150527,16845,16825,16710,16785,16710,16785,16745,-40,-80,8,48
20150528,16785,16745,16925,16925,16925,16925,16925,180,180,2,46
20150529,16925,16925,,,,17005,17005,80,80,0,46
20150601,17005,17005,16880,16880,16840,16840,16860,-165,-145,4,46
20150602,16840,16860,16790,16790,16745,16745,16765,-115,-95,4,44
20150603,16745,16765,16780,16780,16740,16740,16755,-25,-10,6,40
20150604,16740,16755,16585,16585,16555,16555,16560,-200,-195,8,46
20150605,16555,16560,16470,16470,16450,16450,16460,-110,-100,4,46
20150608,16450,16460,16430,16430,16430,16430,16430,-30,-30,2,46
20150609,16430,16430,,,,16430,16430,0,0,0,46
20150610,16430,16430,16565,16565,16565,16565,16565,135,135,2,46
20150611,16565,16565,,,,16545,16545,-20,-20,0,46
20150612,16545,16545,,,,16340,16340,-205,-205,0,46
20150615,16340,16340,,,,16340,16340,0,0,0,46
20150616,16340,16340,,,,16340,16340,0,0,0,46
20150617,16340,16340,,,,16340,16340,0,0,0,46
20150618,16340,16340,16090,16155,15915,16105,16045,-235,-295,42,52
20150619,16105,16045,16030,16030,15885,15965,15960,-80,-85,38,50
20150623,15965,15960,15840,15840,15830,15830,15835,-130,-125,12,50
20150624,15830,15835,15835,15925,15765,15910,15855,75,20,16,56
20150625,15910,15855,15760,15770,15760,15770,15765,-85,-90,4,54
20150626,15770,15765,15750,15765,15725,15730,15740,-35,-25,16,52
20150629,15730,15740,15680,15680,15680,15680,15680,-60,-60,2,50
20150630,15680,15680,15520,15520,15510,15510,15515,-170,-165,4,48
20150701,15510,15515,,,,15405,15405,-110,-110,0,48
20150702,15405,15405,,,,15645,15645,240,240,0,48
20150703,15645,15645,,,,15730,15730,85,85,0,48
20150706,15730,15730,,,,15295,15295,-435,-435,0,48
20150707,15295,15295,15600,15600,15425,15425,15470,130,175,10,56
20150708,15425,15470,15230,15230,14695,14695,14820,-775,-650,10,58
20150709,14695,14820,14955,14955,14955,14955,14955,135,135,2,58
20150710,14955,14955,,,,15130,15130,175,175,0,58
20150713,15130,15130,,,,15040,15040,-90,-90,0,58
20150714,15040,15040,,,,15370,15370,330,330,0,58
20150715,15370,15370,,,,15435,15435,65,65,0,58
20150716,15435,15435,,,,15515,15515,80,80,0,58
20150717,15515,15515,,,,15485,15485,-30,-30,0,58
20150720,15485,15485,,,,15365,15365,-120,-120,0,58
20150721,15365,15365,,,,15375,15375,10,10,0,58
20150722,15375,15375,,,,15080,15080,-295,-295,0,58
20150723,15080,15080,,,,14885,14885,-195,-195,0,58
20150724,14885,14885,,,,14845,14845,-40,-40,0,58
20150727,14845,14845,14890,14890,14890,14890,14890,45,45,2,58
20150728,14890,14890,,,,14870,14870,-20,-20,0,58
20150729,14870,14870,15140,15140,15140,15140,15140,270,270,6,64
20150730,15140,15140,14795,14800,14725,14800,14775,-340,-365,12,58
20150731,14800,14775,14815,14850,14815,14850,14830,75,55,4,56
20150803,14850,14830,14755,14755,14465,14465,14610,-365,-220,4,58
20150804,14465,14610,14545,14570,14540,14570,14550,-40,-60,12,66
20150805,14570,14550,,,,14560,14560,10,10,0,66
20150806,14560,14560,,,,14430,14430,-130,-130,0,66
20150807,14430,14430,,,,14255,14255,-175,-175,0,66
20150810,14255,14255,14305,14305,14300,14300,14300,45,45,4,68
20150811,14300,14300,14535,14540,14535,14540,14535,240,235,4,64
20150812,14540,14535,14400,14400,14355,14355,14375,-180,-160,14,64
20150813,14355,14375,14705,14760,14660,14760,14710,385,335,8,62
20150814,14760,14710,14735,14735,14735,14735,14735,25,25,2,62
20150817,14735,14735,14700,14745,14690,14735,14715,0,-20,10,60
20150818,14735,14715,,,,14715,14715,0,0,0,60
20150819,14715,14715,,,,14530,14530,-185,-185,0,60
20150820,14530,14530,14590,14590,14590,14590,14590,60,60,2,60
20150821,14590,14590,14675,14675,14615,14615,14645,25,55,4,64
20150824,14615,14645,14275,14275,14275,14275,14275,-370,-370,2,64
20150825,14275,14275,,,,14245,14245,-30,-30,0,64
20150826,14245,14245,14450,14480,14430,14430,14450,185,205,66,122
20150827,14430,14450,14250,14340,14250,14320,14295,-130,-155,10,116
20150828,14320,14295,14425,14425,14425,14425,14425,130,130,2,114
20150831,14425,14425,,,,14600,14600,175,175,0,114
20150901,14600,14600,,,,14600,14600,0,0,0,114
20150902,14600,14600,14825,14825,14765,14765,14805,165,205,82,102
20150907,14765,14805,,,,14855,14855,50,50,0,102
20150908,14855,14855,,,,14755,14755,-100,-100,0,102
20150909,14755,14755,14915,14915,14915,14915,14915,160,160,2,102
20150910,14915,14915,,,,14915,14915,0,0,0,102
20150911,14915,14915,14840,14865,14840,14865,14850,-50,-65,4,102
20150914,14865,14850,14830,14830,14750,14750,14780,-100,-70,8,106
20150915,14750,14780,14600,14600,14395,14395,14520,-385,-260,28,128
20150916,14395,14520,14355,14355,14315,14315,14335,-205,-185,4,128
20150917,14315,14335,14395,14405,14280,14280,14335,-55,0,334,386
20150918,14280,14335,14225,14225,14130,14130,14200,-205,-135,8,380
20150921,14130,14200,13925,13925,13490,13570,13775,-630,-425,76,410
20150922,13570,13775,13465,13635,13305,13320,13460,-455,-315,410,642
20150923,13320,13460,13380,13405,13105,13390,13305,-70,-155,30,644
20150924,13390,13305,13435,13595,13360,13580,13445,275,140,32,648
20150925,13580,13445,13575,13650,13500,13580,13585,135,140,56,660
20150928,13580,13585,13410,13410,13300,13300,13320,-285,-265,66,664
20150929,13300,13320,13200,13255,13160,13210,13195,-110,-125,50,662
20150930,13210,13195,13335,13580,13330,13580,13410,385,215,32,668
20151008,13580,13410,13490,13495,13475,13495,13480,85,70,18,668
20151009,13495,13480,13380,14150,13380,14065,13920,585,440,516,708
20151012,14065,13920,14525,14535,14230,14495,14450,575,530,486,780
20151013,14495,14450,14365,14410,14225,14370,14325,-80,-125,122,814
20151014,14370,14325,14340,14375,14265,14265,14290,-60,-35,74,850
20151015,14265,14290,14355,14455,14350,14370,14395,80,105,168,940
20151016,14370,14395,14335,14355,14270,14270,14335,-125,-60,62,964
20151019,14270,14335,14275,14290,14170,14170,14210,-165,-125,144,1004
20151020,14170,14210,14080,14115,14010,14030,14060,-180,-150,166,1020
20151021,14030,14060,14155,14155,14045,14090,14080,30,20,70,978
20151022,14090,14080,13995,13995,13745,13860,13855,-220,-225,194,904
20151023,13860,13855,14065,14100,13890,14010,13960,155,105,180,990
20151026,14010,13960,14010,14100,13940,14030,14010,70,50,300,1088
20151027,14030,14010,13995,14125,13975,14100,14070,90,60,334,1224
20151028,14100,14070,14050,14075,13990,14000,14035,-70,-35,254,1350
20151029,14000,14035,13915,14120,13895,14060,14060,25,25,350,1470
20151030,14060,14060,13935,14000,13690,13690,13790,-370,-270,1468,2456
20151102,13690,13790,13690,13765,13645,13735,13730,-55,-60,792,2856
20151103,13735,13730,13715,13810,13695,13730,13745,0,15,216,2888
20151104,13730,13745,13625,13825,13580,13825,13760,80,15,560,3330
20151105,13825,13760,13755,13870,13550,13550,13595,-210,-165,698,3790
20151106,13550,13595,13520,13610,13430,13600,13510,5,-85,1800,5244
20151109,13600,13510,13565,13610,13495,13550,13565,40,55,480,5508
20151110,13550,13565,13580,13580,13000,13280,13335,-285,-230,2374,6806
20151111,13280,13335,13235,13235,12815,12845,12935,-490,-400,3844,8494
20151112,12845,12935,12890,13160,12800,13060,13040,125,105,2536,9768
20151113,13060,13040,12950,13150,12835,13005,13005,-35,-35,2060,9940
20151116,13005,13005,13030,13120,12900,12915,13005,-90,0,748,10032
20151117,12915,13005,12955,12955,12515,12630,12690,-375,-315,3088,11112
20151118,12630,12690,12675,12780,12305,12430,12490,-260,-200,3916,12098
20151119,12430,12490,12390,12390,11905,12020,12125,-470,-365,6078,13114
20151120,12020,12125,12005,12515,11785,12420,12180,295,55,8416,13718
20151123,12420,12180,12510,12720,11755,12060,12085,-120,-95,19614,17934
20151124,12060,12085,12055,12685,11895,12650,12280,565,195,27720,21274
20151125,12650,12280,12535,12890,12530,12670,12700,390,420,27568,17454
20151126,12670,12700,12700,13335,12530,13080,13040,380,340,34728,15402
20151127,13080,13040,13090,13250,12740,12875,12980,-165,-60,25358,17650
20151130,12875,12980,12680,12815,12505,12745,12725,-235,-255,17308,18044
zn1605,20150518,17280,17280,17260,17260,17260,17260,17260,-20,-20,2,2
20150519,17260,17260,,,,17260,17260,0,0,0,2
20150520,17260,17260,16915,17000,16895,16895,16920,-365,-340,10,8
20150521,16895,16920,,,,16920,16920,0,0,0,8
20150522,16920,16920,,,,16845,16845,-75,-75,0,8
20150525,16845,16845,16755,16755,16750,16750,16750,-95,-95,6,14
20150526,16750,16750,,,,16750,16750,0,0,0,14
20150527,16750,16750,16770,16795,16770,16795,16780,45,30,4,16
20150528,16795,16780,16930,16985,16905,16905,16945,125,165,10,20
20150529,16905,16945,16995,17160,16985,17050,17070,105,125,44,24
20150601,17050,17070,16925,16955,16885,16895,16920,-175,-150,24,40
20150602,16895,16920,16795,16805,16715,16805,16775,-115,-145,14,46
20150603,16805,16775,16865,16865,16650,16730,16740,-45,-35,20,60
20150604,16730,16740,16720,16720,16560,16560,16605,-180,-135,16,64
20150605,16560,16605,16530,16530,16350,16425,16455,-180,-150,8,68
20150608,16425,16455,16500,16500,16480,16480,16480,25,25,22,72
20150609,16480,16480,16535,16605,16505,16505,16550,25,70,24,80
20150610,16505,16550,,,,16550,16550,0,0,0,80
20150611,16550,16550,16700,16700,16495,16515,16535,-35,-15,16,80
20150612,16515,16535,16555,16555,16345,16345,16445,-190,-90,20,88
20150615,16345,16445,,,,16430,16430,-15,-15,0,88
20150616,16430,16430,16325,16325,16325,16325,16325,-105,-105,2,88
20150617,16325,16325,16225,16225,16195,16195,16205,-130,-120,10,88
20150618,16195,16205,16035,16095,16035,16095,16065,-110,-140,6,90
20150619,16095,16065,16035,16035,15885,15900,15965,-165,-100,24,90
20150623,15900,15965,15885,15895,15780,15830,15840,-135,-125,20,96
20150624,15830,15840,15845,15945,15845,15945,15860,105,20,26,108
20150625,15945,15860,15865,15865,15790,15790,15825,-70,-35,10,114
20150626,15790,15825,15785,15820,15760,15760,15770,-65,-55,16,128
20150629,15760,15770,15705,15740,15595,15650,15690,-120,-80,36,138
20150630,15650,15690,15560,15560,15420,15420,15490,-270,-200,44,146
20150701,15420,15490,15390,15430,15315,15430,15385,-60,-105,10,146
20150702,15430,15385,15530,15680,15530,15680,15625,295,240,20,138
20150703,15680,15625,15735,15760,15555,15595,15635,-30,10,52,150
20150706,15595,15635,15520,15520,15195,15285,15345,-350,-290,110,188
20150707,15285,15345,15430,15555,15280,15350,15425,5,80,60,192
20150708,15350,15425,15390,15390,14650,14650,14780,-775,-645,144,176
20150709,14650,14780,14775,15080,14745,15080,14830,300,50,82,176
20150710,15080,14830,15425,15425,15180,15200,15275,370,445,10,178
20150713,15200,15275,15140,15325,15140,15325,15255,50,-20,10,176
20150714,15325,15255,15530,15530,15420,15510,15490,255,235,12,176
20150715,15510,15490,,,,15490,15490,0,0,0,176
20150716,15490,15490,15620,15965,15620,15665,15700,175,210,14,176
20150717,15665,15700,15705,15705,15540,15660,15625,-40,-75,14,180
20150720,15660,15625,15605,15605,15460,15500,15515,-125,-110,18,182
20150721,15500,15515,15560,15560,15560,15560,15560,45,45,2,182
20150722,15560,15560,15520,15520,15310,15310,15440,-250,-120,6,182
20150723,15310,15440,15130,15220,15130,15220,15175,-220,-265,4,186
20150724,15220,15175,15185,15185,15170,15170,15180,-5,5,8,188
20150727,15170,15180,14885,14885,14785,14850,14840,-330,-340,16,186
20150728,14850,14840,14565,14830,14565,14830,14735,-10,-105,18,192
20150729,14830,14735,15000,15135,15000,15135,15060,400,325,6,188
20150730,15135,15060,14905,15075,14905,14925,14970,-135,-90,16,194
20150731,14925,14970,14845,14910,14830,14830,14855,-140,-115,12,200
20150803,14830,14855,14850,14855,14565,14565,14725,-290,-130,40,216
20150804,14565,14725,14580,14695,14570,14695,14625,-30,-100,26,226
20150805,14695,14625,14795,14795,14640,14755,14715,130,90,14,222
20150806,14755,14715,14655,14655,14570,14575,14595,-140,-120,12,230
20150807,14575,14595,14560,14560,14255,14255,14405,-340,-190,38,254
20150810,14255,14405,14260,14460,14260,14460,14400,55,-5,106,270
20150811,14460,14400,14495,14600,14495,14550,14540,150,140,24,274
20150812,14550,14540,14410,14665,14315,14655,14555,115,15,72,258
20150813,14655,14555,14775,14905,14695,14710,14830,155,275,60,276
20150814,14710,14830,14830,14830,14760,14760,14765,-70,-65,18,268
20150817,14760,14765,14785,14785,14695,14750,14755,-15,-10,30,256
20150818,14750,14755,14650,14650,14650,14650,14650,-105,-105,2,256
20150819,14650,14650,14470,14490,14465,14465,14475,-185,-175,10,258
20150820,14465,14475,14590,14630,14550,14625,14605,150,130,34,272
20150821,14625,14605,14885,14885,14710,14715,14845,110,240,22,266
20150824,14715,14845,14455,14455,14250,14270,14390,-575,-455,76,262
20150825,14270,14390,14255,14435,14210,14285,14345,-105,-45,48,248
20150826,14285,14345,14435,14545,14360,14400,14425,55,80,16,244
20150827,14400,14425,14315,14345,14255,14335,14315,-90,-110,44,246
20150828,14335,14315,14445,14645,14365,14555,14500,240,185,36,230
20150831,14555,14500,14775,14775,14650,14650,14710,150,210,4,232
20150901,14650,14710,14620,14725,14620,14655,14680,-55,-30,18,234
20150902,14655,14680,14755,14780,14750,14780,14755,100,75,16,242
20150907,14780,14755,14735,14735,14735,14735,14735,-20,-20,2,242
20150908,14735,14735,14660,14660,14550,14550,14605,-185,-130,8,242
20150909,14550,14605,14740,14920,14740,14870,14865,265,260,66,254
20150910,14870,14865,14845,14845,14825,14825,14835,-40,-30,4,252
20150911,14825,14835,14825,14940,14810,14880,14875,45,40,16,252
20150914,14880,14875,14845,14865,14735,14735,14795,-140,-80,22,244
20150915,14735,14795,14630,14630,14405,14405,14480,-390,-315,50,244
20150916,14405,14480,14330,14440,14260,14430,14340,-50,-140,226,412
20150917,14430,14340,14410,14440,14220,14300,14315,-40,-25,850,846
20150918,14300,14315,14255,14290,14105,14105,14170,-210,-145,296,978
20150921,14105,14170,14055,14055,13460,13525,13570,-645,-600,212,1012
20150922,13525,13570,13520,13520,13255,13320,13375,-250,-195,90,1048
20150923,13320,13375,13260,13370,13150,13295,13250,-80,-125,190,1110
20150924,13295,13250,13330,13560,13330,13520,13410,270,160,136,1104
20150925,13520,13410,13400,13645,13310,13310,13495,-100,85,188,1106
20150928,13310,13495,13305,13370,13260,13260,13275,-235,-220,82,1108
20150929,13260,13275,13120,13315,13115,13170,13175,-105,-100,110,1090
20150930,13170,13175,13290,13545,13290,13545,13415,370,240,86,1086
20151008,13545,13415,13595,13595,13335,13445,13475,30,60,44,1092
20151009,13445,13475,13375,14095,13320,13955,13705,480,230,462,1098
20151012,13955,13705,14205,14390,14145,14380,14295,675,590,378,1104
20151013,14380,14295,14315,14320,14165,14305,14250,10,-45,92,1096
20151014,14305,14250,14330,14350,14150,14280,14225,30,-25,68,1096
20151015,14280,14225,14300,14320,14285,14320,14305,95,80,10,1090
20151016,14320,14305,14360,14445,14165,14165,14260,-140,-45,114,1080
20151019,14165,14260,14255,14255,14110,14150,14150,-110,-110,56,1070
20151020,14150,14150,14055,14055,13970,13990,13995,-160,-155,42,1058
20151021,13990,13995,14020,14100,14020,14030,14090,35,95,118,1082
20151022,14030,14090,13835,13875,13650,13825,13770,-265,-320,316,1062
20151023,13825,13770,13905,14070,13800,13980,13890,210,120,180,1110
20151026,13980,13890,13920,14020,13890,14020,13960,130,70,78,1100
20151027,14020,13960,13985,14020,13940,14020,13980,60,20,52,1112
20151028,14020,13980,13280,14015,13280,13975,13965,-5,-15,142,1074
20151029,13975,13965,14025,14050,13985,14050,14020,85,55,242,1142
20151030,14050,14020,13895,13915,13690,13690,13810,-330,-210,204,1234
20151102,13690,13810,13655,13810,13655,13725,13755,-85,-55,344,1362
20151103,13725,13755,13710,13815,13700,13735,13755,-20,0,202,1448
20151104,13735,13755,13680,13820,13580,13820,13635,65,-120,364,1466
20151105,13820,13635,13810,13870,13570,13570,13670,-65,35,928,2088
20151106,13570,13670,13565,13595,13450,13540,13500,-130,-170,218,2094
20151109,13540,13500,13575,13605,13510,13575,13555,75,55,588,1940
20151110,13575,13555,13555,13570,13095,13260,13420,-295,-135,460,2062
20151111,13260,13420,13220,13230,12835,12835,12950,-585,-470,462,2192
20151112,12835,12950,12895,13170,12810,13095,12995,145,45,396,2200
20151113,13095,12995,12810,13160,12810,13000,13015,5,20,400,2208
20151116,13000,13015,13040,13120,12920,12925,13025,-90,10,288,2270
20151117,12925,13025,12955,12975,12555,12635,12740,-390,-285,996,2542
20151118,12635,12740,12680,12780,12320,12460,12425,-280,-315,2344,4006
20151119,12460,12425,12400,12405,11900,12020,12160,-405,-265,3042,4728
20151120,12020,12160,11995,12510,11800,12400,12170,240,10,4702,5100
20151123,12400,12170,12525,12620,11755,12025,12130,-145,-40,7378,6894
20151124,12025,12130,12130,12720,11865,12620,12280,490,150,10430,8418
20151125,12620,12280,12600,12890,12525,12645,12690,365,410,11714,7078
20151126,12645,12690,12560,13320,12500,13060,13015,370,325,11410,8244
20151127,13060,13015,13190,13230,12730,12865,12985,-150,-30,8974,9026
20151130,12865,12985,12710,12800,12590,12740,12705,-245,-280,4788,9028
zn1606,20150616,16430,16430,,,,16430,16430,0,0,0,0
20150617,16430,16430,,,,16410,16410,-20,-20,0,0
20150618,16410,16410,15955,16230,15955,16230,16090,-180,-320,4,0
20150619,16230,16090,,,,16090,16090,0,0,0,0
20150623,16090,16090,,,,15965,15965,-125,-125,0,0
20150624,15965,15965,,,,15985,15985,20,20,0,0
20150625,15985,15985,16065,16065,15955,15960,15990,-25,5,6,6
20150626,15960,15990,15855,15855,15830,15830,15840,-160,-150,4,8
20150629,15830,15840,15600,15600,15600,15600,15600,-240,-240,2,10
20150630,15600,15600,15580,15580,15500,15500,15540,-100,-60,4,8
20150701,15500,15540,15455,15480,15455,15480,15465,-60,-75,10,8
20150702,15480,15465,15610,15695,15610,15695,15680,230,215,14,14
20150703,15695,15680,,,,15680,15680,0,0,0,14
20150706,15680,15680,15465,15465,15300,15300,15405,-380,-275,6,12
20150707,15300,15405,,,,15405,15405,0,0,0,12
20150708,15405,15405,15275,15275,14675,14695,14890,-710,-515,30,22
20150709,14695,14890,15080,15080,15080,15080,15080,190,190,2,22
20150710,15080,15080,15400,15465,15275,15455,15390,375,310,22,32
20150713,15455,15390,,,,15370,15370,-20,-20,0,32
20150714,15370,15370,15565,15605,15565,15600,15590,230,220,8,38
20150715,15600,15590,15670,15670,15670,15670,15670,80,80,4,38
20150716,15670,15670,15795,15795,15795,15795,15795,125,125,2,40
20150717,15795,15795,,,,15720,15720,-75,-75,0,40
20150720,15720,15720,,,,15610,15610,-110,-110,0,40
20150721,15610,15610,,,,15655,15655,45,45,0,40
20150722,15655,15655,,,,15535,15535,-120,-120,0,40
20150723,15535,15535,15235,15235,15235,15235,15235,-300,-300,2,40
20150724,15235,15235,,,,15240,15240,5,5,0,40
20150727,15240,15240,14850,14925,14850,14925,14885,-315,-355,4,40
20150728,14925,14885,,,,14885,14885,0,0,0,40
20150729,14885,14885,15025,15055,15025,15055,15035,170,150,22,52
20150730,15055,15035,14990,14990,14915,14930,14960,-105,-75,14,62
20150731,14930,14960,14875,14875,14850,14850,14865,-110,-95,6,56
20150803,14850,14865,14955,14955,14955,14955,14955,90,90,2,58
20150804,14955,14955,14700,14700,14700,14700,14700,-255,-255,2,56
20150805,14700,14700,,,,14790,14790,90,90,0,56
20150806,14790,14790,,,,14790,14790,0,0,0,56
20150807,14790,14790,14420,14420,14365,14365,14395,-425,-395,6,60
20150810,14365,14395,14350,14490,14350,14490,14440,95,45,14,58
20150811,14490,14440,14510,14555,14510,14555,14530,115,90,4,54
20150812,14555,14530,14450,14530,14450,14530,14480,0,-50,6,54
20150813,14530,14480,14780,14780,14660,14660,14720,180,240,4,52
20150814,14660,14720,14670,14710,14670,14710,14680,-10,-40,8,52
20150817,14710,14680,14745,14745,14730,14730,14735,50,55,4,50
20150818,14730,14735,,,,14735,14735,0,0,0,50
20150819,14735,14735,,,,14555,14555,-180,-180,0,50
20150820,14555,14555,14545,14680,14545,14645,14655,90,100,48,76
20150821,14645,14655,14700,14700,14685,14685,14685,30,30,28,96
20150824,14685,14685,14435,14435,14320,14365,14360,-320,-325,10,90
20150825,14365,14360,,,,14315,14315,-45,-45,0,90
20150826,14315,14315,,,,14390,14390,75,75,0,90
20150827,14390,14390,14320,14320,14320,14320,14320,-70,-70,2,90
20150828,14320,14320,14530,14645,14530,14645,14585,325,265,4,90
20150831,14645,14585,14710,14730,14710,14730,14720,145,135,4,86
20150901,14730,14720,,,,14690,14690,-30,-30,0,86
20150902,14690,14690,,,,14765,14765,75,75,0,86
20150907,14765,14765,14730,14780,14730,14780,14735,15,-30,20,76
20150908,14780,14735,14530,14530,14530,14530,14530,-205,-205,2,76
20150909,14530,14530,14885,14885,14885,14885,14885,355,355,2,78
20150910,14885,14885,,,,14885,14885,0,0,0,78
20150911,14885,14885,14870,14870,14870,14870,14870,-15,-15,2,76
20150914,14870,14870,14775,14775,14775,14775,14775,-95,-95,2,78
20150915,14775,14775,14590,14590,14440,14440,14530,-335,-245,44,92
20150916,14440,14530,14355,14430,14355,14365,14380,-165,-150,32,104
20150917,14365,14380,14395,14430,14015,14280,14325,-100,-55,1892,1782
20150918,14280,14325,14200,14210,14060,14090,14135,-235,-190,850,2418
20150921,14090,14135,13920,13920,13425,13440,13495,-695,-640,958,2470
20150922,13440,13495,13440,13465,13200,13390,13250,-105,-245,1450,3470
20150923,13390,13250,13200,13295,13075,13200,13185,-50,-65,2138,4828
20150924,13200,13185,13390,13500,13205,13465,13320,280,135,522,4898
20150925,13465,13320,13360,13595,13275,13275,13425,-45,105,780,4894
20150928,13275,13425,13195,13325,13150,13150,13245,-275,-180,256,4910
20150929,13150,13245,13060,13225,13060,13145,13120,-100,-125,284,4910
20150930,13145,13120,13250,13475,13235,13435,13360,315,240,164,4890
20151008,13435,13360,13530,13555,13300,13300,13440,-60,80,280,4894
20151009,13300,13440,13340,14050,13305,13975,13850,535,410,654,4904
20151012,13975,13850,14010,14400,14010,14380,14280,530,430,774,4906
20151013,14380,14280,14260,14260,14080,14260,14170,-20,-110,232,4922
20151014,14260,14170,14200,14310,14105,14145,14175,-25,5,552,4926
20151015,14145,14175,14225,14325,14210,14300,14265,125,90,342,4946
20151016,14300,14265,14240,14300,14135,14135,14235,-130,-30,236,4912
20151019,14135,14235,14185,14195,14005,14005,14155,-230,-80,80,4914
20151020,14005,14155,13985,14050,13930,13950,13985,-205,-170,472,5022
20151021,13950,13985,14035,14105,13950,14020,14030,35,45,162,5010
20151022,14020,14030,13900,13900,13530,13800,13775,-230,-255,488,5118
20151023,13800,13775,13940,14055,13785,13965,13950,190,175,334,5252
20151026,13965,13950,13935,14030,13850,14030,13905,80,-45,186,5294
20151027,14030,13905,13965,14045,13910,14045,13955,140,50,118,5296
20151028,14045,13955,14000,14000,13925,13955,13975,0,20,80,5276
20151029,13955,13975,13865,14030,13865,13990,13985,15,10,210,5376
20151030,13990,13985,13875,13875,13600,13600,13720,-385,-265,960,5316
20151102,13600,13720,13660,13755,13580,13745,13680,25,-40,546,5500
20151103,13745,13680,13705,13830,13665,13720,13755,40,75,222,5554
20151104,13720,13755,13650,13815,13580,13815,13665,60,-90,308,5576
20151105,13815,13665,13680,13800,13555,13555,13660,-110,-5,150,5620
20151106,13555,13660,13570,13625,13460,13580,13530,-80,-130,492,5638
20151109,13580,13530,13560,13610,13500,13595,13565,65,35,224,5650
20151110,13595,13565,13550,13560,13130,13255,13340,-310,-225,424,5750
20151111,13255,13340,13205,13205,12825,12865,12960,-475,-380,456,5794
20151112,12865,12960,12900,13175,12805,13080,13035,120,75,970,6198
20151113,13080,13035,12880,13145,12850,13030,13045,-5,10,648,6324
20151116,13030,13045,13080,13115,12900,12925,13010,-120,-35,398,6246
20151117,12925,13010,12935,12940,12560,12635,12755,-375,-255,556,6292
20151118,12635,12755,12680,12760,12335,12460,12480,-295,-275,990,6548
20151119,12460,12480,12390,12390,11960,12090,12160,-390,-320,1266,6716
20151120,12090,12160,11970,12500,11825,12435,12220,275,60,4122,6994
20151123,12435,12220,12665,12665,11750,12055,12135,-165,-85,4212,6990
20151124,12055,12135,11905,12720,11860,12650,12255,515,120,2298,7328
20151125,12650,12255,12600,12865,12510,12645,12675,390,420,2152,7048
20151126,12645,12675,12510,13305,12510,13025,12920,350,245,1076,7026
20151127,13025,12920,13105,13205,12725,12800,12940,-120,20,560,7042
20151130,12800,12940,12745,12780,12600,12725,12705,-215,-235,476,6958
zn1607,20150716,15670,15670,,,,15795,15795,125,125,0,0
20150717,15795,15795,,,,15720,15720,-75,-75,0,0
20150720,15720,15720,15445,15445,15445,15445,15445,-275,-275,4,4
20150721,15445,15445,,,,15485,15485,40,40,0,4
20150722,15485,15485,15390,15390,15240,15240,15325,-245,-160,8,6
20150723,15240,15325,,,,15025,15025,-300,-300,0,6
20150724,15025,15025,15175,15175,15175,15175,15175,150,150,4,6
20150727,15175,15175,,,,14820,14820,-355,-355,0,6
20150728,14820,14820,,,,14715,14715,-105,-105,0,6
20150729,14715,14715,15130,15180,15130,15180,15155,465,440,4,8
20150730,15180,15155,,,,15080,15080,-75,-75,0,8
20150731,15080,15080,,,,14985,14985,-95,-95,0,8
20150803,14985,14985,,,,15075,15075,90,90,0,8
20150804,15075,15075,,,,14815,14815,-260,-260,0,8
20150805,14815,14815,14890,14890,14850,14850,14870,35,55,4,10
20150806,14850,14870,,,,14750,14750,-120,-120,0,10
20150807,14750,14750,14495,14495,14385,14385,14440,-365,-310,4,10
20150810,14385,14440,14305,14475,14305,14475,14360,35,-80,6,16
20150811,14475,14360,14635,14635,14600,14600,14620,240,260,6,20
20150812,14600,14620,14425,14585,14425,14585,14505,-35,-115,4,16
20150813,14585,14505,14905,14920,14875,14920,14890,415,385,8,24
20150814,14920,14890,,,,14845,14845,-45,-45,0,24
20150817,14845,14845,14755,14775,14755,14775,14765,-70,-80,4,28
20150818,14775,14765,,,,14765,14765,0,0,0,28
20150819,14765,14765,,,,14585,14585,-180,-180,0,28
20150820,14585,14585,,,,14685,14685,100,100,0,28
20150821,14685,14685,14710,14710,14705,14705,14705,20,20,4,26
20150824,14705,14705,14380,14385,14305,14305,14355,-400,-350,6,22
20150825,14305,14355,14285,14285,14285,14285,14285,-70,-70,2,20
20150826,14285,14285,14495,14495,14435,14435,14455,150,170,6,26
20150827,14435,14455,,,,14455,14455,0,0,0,26
20150828,14455,14455,,,,14725,14725,270,270,0,26
20150831,14725,14725,14830,14830,14830,14830,14830,105,105,2,28
20150901,14830,14830,14785,14815,14560,14815,14770,-15,-60,14,36
20150902,14815,14770,,,,14845,14845,75,75,0,36
20150907,14845,14845,14830,14830,14830,14830,14830,-15,-15,4,36
20150908,14830,14830,,,,14620,14620,-210,-210,0,36
20150909,14620,14620,14845,14875,14845,14875,14865,255,245,6,36
20150910,14875,14865,14930,14930,14830,14835,14865,-30,0,6,42
20150911,14835,14865,14960,14965,14960,14965,14960,100,95,6,42
20150914,14965,14960,14905,14905,14640,14750,14720,-210,-240,18,50
20150915,14750,14720,14630,14630,14525,14550,14605,-170,-115,18,52
20150916,14550,14605,,,,14455,14455,-150,-150,0,52
20150917,14455,14455,14390,14410,14285,14335,14370,-120,-85,58,74
20150918,14335,14370,14205,14205,13970,14000,14060,-370,-310,42,82
20150921,14000,14060,13640,13735,13360,13395,13485,-665,-575,46,96
20150922,13395,13485,13415,13415,13185,13220,13210,-265,-275,224,302
20150923,13220,13210,13130,13230,13125,13180,13155,-30,-55,40,330
20150924,13180,13155,13215,13380,13215,13380,13335,225,180,8,330
20150925,13380,13335,13395,13515,13395,13515,13455,180,120,32,320
20150928,13515,13455,13185,13275,13170,13275,13255,-180,-200,22,332
20150929,13275,13255,13105,13180,13045,13045,13110,-210,-145,46,354
20150930,13045,13110,13225,13455,13200,13455,13260,345,150,48,378
20151008,13455,13260,13370,13400,13345,13345,13370,85,110,8,382
20151009,13345,13370,13700,14000,13700,13895,13885,525,515,72,374
20151012,13895,13885,14245,14365,14070,14320,14240,435,355,52,388
20151013,14320,14240,14225,14225,14075,14075,14185,-165,-55,16,390
20151014,14075,14185,14210,14235,14065,14195,14175,10,-10,24,380
20151015,14195,14175,14205,14285,14205,14275,14250,100,75,30,372
20151016,14275,14250,14195,14195,14170,14170,14180,-80,-70,6,370
20151019,14170,14180,14165,14180,14025,14025,14145,-155,-35,22,370
20151020,14025,14145,14010,14010,14010,14010,14010,-135,-135,2,370
20151021,14010,14010,14005,14120,13965,13965,13995,-45,-15,28,392
20151022,13965,13995,13750,13820,13735,13775,13780,-220,-215,28,402
20151023,13775,13780,13950,13950,13895,13895,13905,115,125,48,432
20151026,13895,13905,13910,13910,13900,13900,13900,-5,-5,8,424
20151027,13900,13900,13935,13955,13920,13950,13930,50,30,14,424
20151028,13950,13930,13945,13950,13945,13950,13945,20,15,4,420
20151029,13950,13945,13840,13990,13840,13960,13940,15,-5,32,420
20151030,13960,13940,13845,13875,13600,13600,13760,-340,-180,74,468
20151102,13600,13760,13625,13745,13625,13730,13705,-30,-55,42,498
20151103,13730,13705,13710,13840,13665,13725,13740,20,35,92,550
20151104,13725,13740,13600,13725,13600,13705,13670,-35,-70,12,550
20151105,13705,13670,13825,13825,13560,13600,13690,-70,20,94,570
20151106,13600,13690,13545,13545,13515,13515,13530,-175,-160,4,568
20151109,13515,13530,13100,13625,13100,13620,13475,90,-55,10,570
20151110,13620,13475,13415,13415,13360,13360,13385,-115,-90,4,566
20151111,13360,13385,,,,13025,13025,-360,-360,0,566
20151112,13025,13025,12910,13130,12910,13130,13060,105,35,8,572
20151113,13130,13060,13035,13140,13035,13140,13080,80,20,8,570
20151116,13140,13080,12970,12970,12940,12940,12950,-140,-130,24,570
20151117,12940,12950,12970,12970,12630,12645,12825,-305,-125,34,582
20151118,12645,12825,12745,12825,12350,12350,12535,-475,-290,18,584
20151119,12350,12535,12380,12380,11965,12050,12300,-485,-235,180,646
20151120,12050,12300,11990,12515,11855,12400,12345,100,45,242,706
20151123,12400,12345,12610,12615,11770,11985,12015,-360,-330,646,752
20151124,11985,12015,11945,12610,11895,12610,12170,595,155,258,736
20151125,12610,12170,12600,12775,12570,12625,12670,455,500,266,766
20151126,12625,12670,12540,13280,12530,13110,13030,440,360,118,740
20151127,13110,13030,13000,13170,12700,12920,12885,-110,-145,272,782
20151130,12920,12885,12675,12770,12600,12715,12645,-170,-240,64,792
zn1608,20150818,14765,14765,,,,14765,14765,0,0,0,0
20150819,14765,14765,,,,14585,14585,-180,-180,0,0
20150820,14585,14585,,,,14685,14685,100,100,0,0
20150821,14685,14685,,,,14705,14705,20,20,0,0
20150824,14705,14705,,,,14355,14355,-350,-350,0,0
20150825,14355,14355,,,,14355,14355,0,0,0,0
20150826,14355,14355,,,,14525,14525,170,170,0,0
20150827,14525,14525,,,,14525,14525,0,0,0,0
20150828,14525,14525,,,,14795,14795,270,270,0,0
20150831,14795,14795,,,,14900,14900,105,105,0,0
20150901,14900,14900,,,,14840,14840,-60,-60,0,0
20150902,14840,14840,,,,14915,14915,75,75,0,0
20150907,14915,14915,,,,14895,14895,-20,-20,0,0
20150908,14895,14895,,,,14685,14685,-210,-210,0,0
20150909,14685,14685,,,,14685,14685,0,0,0,0
20150910,14685,14685,,,,14685,14685,0,0,0,0
20150911,14685,14685,,,,14780,14780,95,95,0,0
20150914,14780,14780,,,,14545,14545,-235,-235,0,0
20150915,14545,14545,,,,14435,14435,-110,-110,0,0
20150916,14435,14435,14400,14400,14345,14345,14380,-90,-55,6,4
20150917,14345,14380,14400,14450,14355,14375,14395,-5,15,44,32
20150918,14375,14395,14190,14200,14000,14000,14100,-395,-295,256,224
20150921,14000,14100,13830,13855,13395,13395,13530,-705,-570,94,236
20150922,13395,13530,13425,13425,13080,13205,13255,-325,-275,238,360
20150923,13205,13255,13065,13305,13060,13200,13125,-55,-130,22,358
20150924,13200,13125,13280,13400,13210,13380,13260,255,135,38,366
20150925,13380,13260,13405,13490,13245,13245,13410,-15,150,10,364
20150928,13245,13410,13270,13270,13135,13195,13185,-215,-225,38,364
20150929,13195,13185,13050,13140,13000,13070,13055,-115,-130,78,364
20150930,13070,13055,13185,13410,13185,13395,13330,340,275,14,364
20151008,13395,13330,13685,13685,13300,13300,13465,-30,135,38,370
20151009,13300,13465,13400,14130,13400,13860,13680,395,215,78,356
20151012,13860,13680,14110,14300,14025,14280,14135,600,455,76,354
20151013,14280,14135,14130,14155,14100,14100,14125,-35,-10,12,354
20151014,14100,14125,14150,14215,14000,14065,14065,-60,-60,96,354
20151015,14065,14065,14130,14205,14130,14205,14190,140,125,14,348
20151016,14205,14190,14210,14210,14115,14120,14150,-70,-40,26,350
20151019,14120,14150,14150,14150,14025,14025,14110,-125,-40,22,356
20151020,14025,14110,13905,13965,13885,13955,13915,-155,-195,18,362
20151021,13955,13915,13990,14010,13990,14010,14000,95,85,4,362
20151022,14010,14000,13790,13800,13605,13760,13750,-240,-250,54,374
20151023,13760,13750,13930,14070,13745,13745,13890,-5,140,46,364
20151026,13745,13890,,,,13885,13885,-5,-5,0,364
20151027,13885,13885,13940,13955,13940,13955,13945,70,60,12,352
20151028,13955,13945,13940,13950,13925,13950,13935,5,-10,28,360
20151029,13950,13935,,,,13935,13935,0,0,0,360
20151030,13935,13935,13710,13790,13710,13780,13745,-155,-190,16,372
20151102,13780,13745,13690,13820,13690,13750,13735,5,-10,14,374
20151103,13750,13735,13860,13865,13525,13720,13710,-15,-25,24,370
20151104,13720,13710,13600,13620,13600,13600,13605,-110,-105,6,370
20151105,13600,13605,,,,13625,13625,20,20,0,370
20151106,13625,13625,,,,13625,13625,0,0,0,370
20151109,13625,13625,,,,13625,13625,0,0,0,370
20151110,13625,13625,13170,13170,13170,13170,13170,-455,-455,2,370
20151111,13170,13170,,,,13015,13015,-155,-155,0,370
20151112,13015,13015,12910,13180,12910,13180,13095,165,80,8,372
20151113,13180,13095,,,,13095,13095,0,0,0,372
20151116,13095,13095,12945,12945,12945,12945,12945,-150,-150,2,372
20151117,12945,12945,,,,12820,12820,-125,-125,0,372
20151118,12820,12820,12695,12695,12435,12460,12490,-360,-330,10,376
20151119,12460,12490,,,,12350,12350,-140,-140,0,376
20151120,12350,12350,12065,12490,12060,12430,12335,80,-15,28,378
20151123,12430,12335,12575,12575,11745,11950,11985,-385,-350,128,438
20151124,11950,11985,11920,12580,11920,12580,12265,595,280,108,498
20151125,12580,12265,12690,12870,12590,12735,12790,470,525,54,502
20151126,12735,12790,12830,13365,12830,13035,12995,245,205,24,500
20151127,13035,12995,13070,13070,12650,12820,12745,-175,-250,154,494
20151130,12820,12745,12685,12725,12570,12715,12640,-30,-105,44,496
zn1609,20150916,14435,14435,14580,14580,14245,14350,14390,-85,-45,6,4
20150917,14350,14390,14450,14450,14420,14420,14435,30,45,10,10
20150918,14420,14435,14250,14250,14145,14150,14175,-285,-260,20,28
20150921,14150,14175,13485,13525,13465,13510,13470,-665,-705,40,60
20150922,13510,13470,13415,13585,13210,13290,13330,-180,-140,40,90
20150923,13290,13330,13120,13260,12905,13260,13150,-70,-180,112,138
20150924,13260,13150,13500,13500,13195,13435,13295,285,145,62,164
20150925,13435,13295,13385,13460,13220,13220,13370,-75,75,80,188
20150928,13220,13370,13290,13290,13150,13160,13180,-210,-190,98,214
20150929,13160,13180,13095,13150,12940,12950,13040,-230,-140,106,230
20150930,12950,13040,13100,13400,13100,13390,13175,350,135,56,202
20151008,13390,13175,13325,13380,13250,13250,13340,75,165,52,192
20151009,13250,13340,13250,13970,13215,13815,13580,475,240,98,186
20151012,13815,13580,14240,14250,13965,14250,14120,670,540,90,174
20151013,14250,14120,14100,14170,14000,14170,14055,50,-65,26,178
20151014,14170,14055,14140,14225,14005,14005,14045,-50,-10,32,186
20151015,14005,14045,14230,14320,14125,14320,14190,275,145,50,218
20151016,14320,14190,14175,14195,14085,14090,14150,-100,-40,68,262
20151019,14090,14150,14150,14150,13960,14030,14075,-120,-75,36,290
20151020,14030,14075,13930,13950,13835,13835,13920,-240,-155,26,308
20151021,13835,13920,13985,13985,13985,13985,13985,65,65,2,310
20151022,13985,13985,13785,13785,13515,13720,13650,-265,-335,76,288
20151023,13720,13650,13780,13925,13685,13725,13840,75,190,122,226
20151026,13725,13840,,,,13835,13835,-5,-5,0,226
20151027,13835,13835,13850,13935,13810,13935,13835,100,0,32,244
20151028,13935,13835,13945,13945,13880,13910,13910,75,75,26,242
20151029,13910,13910,,,,13910,13910,0,0,0,242
20151030,13910,13910,13675,13700,13665,13700,13680,-210,-230,24,236
20151102,13700,13680,13575,13750,13575,13750,13680,70,0,18,234
20151103,13750,13680,13625,13830,13625,13830,13730,150,50,12,228
20151104,13830,13730,13600,13850,13600,13730,13725,0,-5,6,226
20151105,13730,13725,13830,13830,13685,13685,13695,-40,-30,60,222
20151106,13685,13695,13720,13720,13720,13720,13720,25,25,2,222
20151109,13720,13720,13640,13640,13600,13600,13620,-120,-100,4,222
20151110,13600,13620,13240,13285,13180,13285,13235,-335,-385,6,226
20151111,13285,13235,13210,13210,12925,12925,12985,-310,-250,16,238
20151112,12925,12985,12975,13085,12840,13085,12990,100,5,18,228
20151113,13085,12990,,,,12990,12990,0,0,0,228
20151116,12990,12990,13110,13110,12890,12890,13005,-100,15,24,230
20151117,12890,13005,12745,12745,12650,12650,12725,-355,-280,12,232
20151118,12650,12725,12630,12630,12450,12480,12505,-245,-220,32,244
20151119,12480,12505,12425,12425,12040,12065,12240,-440,-265,38,254
20151120,12065,12240,11905,12500,11850,12450,12185,210,-55,250,258
20151123,12450,12185,12570,12675,11850,12000,12160,-185,-25,168,346
20151124,12000,12160,11995,12600,11930,12600,12340,440,180,48,348
20151125,12600,12340,12590,12955,12540,12730,12735,390,395,60,346
20151126,12730,12735,12505,13320,12505,13110,12960,375,225,58,318
20151127,13110,12960,13105,13105,12840,12855,12920,-105,-40,56,330
20151130,12855,12920,12750,12770,12575,12665,12665,-255,-255,62,336
zn1610,20151016,14190,14190,14170,14170,14170,14170,14170,-20,-20,2,2
20151019,14170,14170,,,,14095,14095,-75,-75,0,2
20151020,14095,14095,14065,14065,13635,13875,13845,-220,-250,58,52
20151021,13875,13845,,,,13905,13905,60,60,0,52
20151022,13905,13905,,,,13905,13905,0,0,0,52
20151023,13905,13905,13855,13895,13770,13775,13820,-130,-85,16,50
20151026,13775,13820,14035,14035,13865,13865,13920,45,100,6,52
20151027,13865,13920,13850,13935,13850,13935,13905,15,-15,6,48
20151028,13935,13905,13885,13885,13885,13885,13885,-20,-20,2,50
20151029,13885,13885,,,,13885,13885,0,0,0,50
20151030,13885,13885,13680,13715,13680,13715,13700,-170,-185,10,48
20151102,13715,13700,13535,13700,13535,13695,13665,-5,-35,10,54
20151103,13695,13665,13585,13895,13585,13895,13785,230,120,8,58
20151104,13895,13785,13600,13645,13600,13645,13615,-140,-170,12,54
20151105,13645,13615,,,,13585,13585,-30,-30,0,54
20151106,13585,13585,13585,13630,13585,13630,13605,45,20,4,54
20151109,13630,13605,13635,13730,13545,13730,13635,125,30,6,58
20151110,13730,13635,13265,13265,13265,13265,13265,-370,-370,2,56
20151111,13265,13265,13020,13020,12880,12880,12910,-385,-355,10,56
20151112,12880,12910,12955,13000,12955,13000,12975,90,65,4,56
20151113,13000,12975,,,,12975,12975,0,0,0,56
20151116,12975,12975,13005,13105,13005,13005,13025,30,50,16,54
20151117,13005,13025,12900,12900,12655,12655,12815,-370,-210,6,58
20151118,12655,12815,12775,12775,12395,12600,12510,-215,-305,42,62
20151119,12600,12510,,,,12240,12240,-270,-270,0,62
20151120,12240,12240,12035,12500,12035,12475,12220,235,-20,16,64
20151123,12475,12220,12245,12320,11900,11900,12230,-320,10,118,142
20151124,11900,12230,12310,12430,12310,12360,12360,130,130,50,140
20151125,12360,12360,12550,12970,12550,12625,12690,265,330,30,140
20151126,12625,12690,12705,13305,12685,13115,13035,425,345,22,136
20151127,13115,13035,13000,13000,12740,12740,12880,-295,-155,24,138
20151130,12740,12880,12625,12750,12590,12750,12645,-130,-235,22,136
zn1611,20151117,13025,13025,12750,12750,12725,12725,12740,-300,-285,6,6
20151118,12725,12740,12100,13000,12100,12705,12700,-35,-40,10,10
20151119,12705,12700,12070,12315,12070,12120,12115,-580,-585,24,12
20151120,12120,12115,11965,12470,11940,12470,12070,355,-45,16,10
20151123,12470,12070,12670,12670,11850,11850,12405,-220,335,42,28
20151124,11850,12405,12180,12815,11865,12815,12175,410,-230,50,38
20151125,12815,12175,12635,12775,12635,12775,12745,600,570,28,38
20151126,12775,12745,12830,13345,12830,13150,13175,405,430,58,64
20151127,13150,13175,12980,13105,12790,12790,12925,-385,-250,36,72
20151130,12790,12925,12745,12745,12745,12745,12745,-180,-180,4,74
